,LC5601SC0001,LC5601SC0002,LC5601SC0003,LC5601SC0004,LC5601SC0005,LC5601SC0006,LC5601SC0007,LC5601SC0008,LC5601SC0009,LC5601SC0010,LC5601SC0011,LC5601SC0012,LC5601SC0013,LC5601SC0014,LC5601SC0015,LC5601SC0016,LC5601SC0017,LC5601SC0018,LC5601SC0019,LC5601SC0020,LC5601SC0021,LC5601SC0022,LC5601SC0023,LC5601SC0024,LC5601SC0025,LC5601SC0026,LC5601SC0027,LC5601SC0028,LC5601SC0029,LC5601SC0030,LC5601SC0031,LC5601SC0032,LC5601SC0033,LC5601SC0034,LC5601SC0035,LC5601SC0036
S92000003,4379072,2750136,2222098,305722,222316,1628936,1173116,407991,301770,55327,50894,765125,1010875,700347,547330,71240,81777,310528,627423,452462,371854,44381,36227,174961,424996,334956,281159,32374,21423,90040,1142662,854380,719985,102400,31995,288282
S01006506,749,527,427,82,18,222,115,34,24,7,3,81,143,101,80,16,5,42,94,77,66,7,4,17,77,64,57,7,0,13,320,251,200,45,6,69
S01006507,696,471,406,57,8,225,207,80,67,11,2,127,166,119,99,17,3,47,83,70,62,6,2,13,60,48,45,3,0,12,180,154,133,20,1,26
S01006508,552,435,377,48,10,117,53,26,22,2,2,27,126,103,81,20,2,23,69,52,42,6,4,17,87,69,63,5,1,18,217,185,169,15,1,32
S01006509,479,320,270,35,15,159,127,45,37,8,0,82,113,80,66,5,9,33,58,49,39,8,2,9,52,43,37,5,1,9,129,103,91,9,3,26
S01006510,549,305,258,33,14,244,174,38,26,7,5,136,118,75,64,6,5,43,81,60,52,6,2,21,38,31,27,4,0,7,138,101,89,10,2,37
S01006511,633,371,308,46,17,262,112,28,16,12,0,84,138,78,65,5,8,60,90,62,52,7,3,28,60,43,37,3,3,17,233,160,138,19,3,73
S01006512,360,256,198,54,4,104,46,17,13,4,0,29,64,51,38,11,2,13,48,33,25,7,1,15,20,16,12,4,0,4,182,139,110,28,1,43
S01006513,529,280,241,36,3,249,102,15,14,1,0,87,74,37,31,5,1,37,53,36,32,4,0,17,62,42,34,8,0,20,238,150,130,18,2,88
S01006514,809,490,395,85,10,319,102,15,12,3,0,87,97,48,37,10,1,49,102,76,63,11,2,26,65,45,33,10,2,20,443,306,250,51,5,137
S01006515,569,378,306,66,6,191,38,13,5,7,1,25,84,40,30,7,3,44,84,60,50,9,1,24,61,43,35,7,1,18,302,222,186,36,0,80
S01006516,452,280,187,90,3,172,44,11,8,3,0,33,59,36,27,8,1,23,68,38,30,8,0,30,36,29,15,14,0,7,245,166,107,57,2,79
S01006517,808,532,433,85,14,276,81,28,24,4,0,53,117,67,47,20,0,50,124,79,65,9,5,45,67,45,33,11,1,22,419,313,264,41,8,106
S01006518,514,317,249,58,10,197,24,6,2,4,0,18,77,45,33,10,2,32,55,34,26,5,3,21,30,21,17,4,0,9,328,211,171,35,5,117
S01006519,675,438,348,82,8,237,74,25,14,10,1,49,100,58,48,7,3,42,76,49,44,4,1,27,70,52,42,10,0,18,355,254,200,51,3,101
S01006520,505,351,294,50,7,154,12,3,2,1,0,9,65,26,22,2,2,39,54,39,37,1,1,15,42,29,25,4,0,13,332,254,208,42,4,78
S01006521,513,349,265,73,11,164,29,16,9,7,0,13,51,27,19,4,4,24,70,43,32,9,2,27,41,30,22,8,0,11,322,233,183,45,5,89
S01006522,438,304,250,45,9,134,26,10,8,2,0,16,44,26,22,3,1,18,39,27,18,6,3,12,32,26,24,2,0,6,297,215,178,32,5,82
S01006523,766,471,404,53,14,295,69,16,12,2,2,53,110,59,45,6,8,51,75,43,38,5,0,32,58,41,33,6,2,17,454,312,276,34,2,142
S01006524,772,400,292,90,18,372,166,19,12,6,1,147,105,50,38,8,4,55,69,38,28,8,2,31,59,43,30,11,2,16,373,250,184,57,9,123
S01006525,650,389,314,62,13,261,71,14,12,2,0,57,97,53,44,7,2,44,84,58,48,8,2,26,60,44,37,4,3,16,338,220,173,41,6,118
S01006526,784,488,416,26,46,296,209,67,53,4,10,142,190,137,111,8,18,53,118,79,68,3,8,39,82,58,51,2,5,24,185,147,133,9,5,38
S01006527,559,346,295,24,27,213,176,82,70,7,5,94,156,101,86,8,7,55,63,46,41,0,5,17,37,32,26,3,3,5,127,85,72,6,7,42
S01006528,876,535,470,20,45,341,205,69,61,4,4,136,191,126,112,6,8,65,122,92,78,4,10,30,84,63,54,2,7,21,274,185,165,4,16,89
S01006529,790,511,438,34,39,279,172,61,50,7,4,111,149,100,81,9,10,49,121,84,75,1,8,37,79,59,52,4,3,20,269,207,180,13,14,62
S01006530,671,433,366,31,36,238,200,79,65,5,9,121,149,110,98,3,9,39,94,75,62,6,7,19,57,45,39,4,2,12,171,124,102,13,9,47
S01006531,811,484,416,21,47,327,253,92,78,5,9,161,208,145,123,5,17,63,100,70,59,4,7,30,91,66,55,3,8,25,159,111,101,4,6,48
S01006532,644,374,316,42,16,270,113,19,13,6,0,94,117,71,53,11,7,46,95,58,51,4,3,37,65,47,43,2,2,18,254,179,156,19,4,75
S01006533,594,411,344,59,8,183,51,13,9,4,0,38,83,51,32,17,2,32,85,57,47,8,2,28,43,33,31,1,1,10,332,257,225,29,3,75
S01006534,729,504,434,62,8,225,59,15,12,2,1,44,97,56,45,8,3,41,86,70,64,6,0,16,70,49,40,8,1,21,417,314,273,38,3,103
S01006535,912,718,612,67,39,194,59,19,16,2,1,40,126,88,66,8,14,38,124,99,82,9,8,25,111,99,88,4,7,12,492,413,360,44,9,79
S01006536,920,760,678,55,27,160,57,31,23,5,3,26,126,100,88,7,5,26,145,117,106,7,4,28,114,102,92,8,2,12,478,410,369,28,13,68
S01006537,638,369,314,48,7,269,86,17,13,4,0,69,109,58,49,7,2,51,84,54,46,6,2,30,66,47,41,6,0,19,293,193,165,25,3,100
S01006538,480,304,252,42,10,176,52,15,11,4,0,37,73,44,34,8,2,29,68,47,42,3,2,21,57,37,33,2,2,20,230,161,132,25,4,69
S01006539,626,378,333,39,6,248,94,17,15,2,0,77,91,50,40,7,3,41,90,64,61,2,1,26,56,43,35,7,1,13,295,204,182,21,1,91
S01006540,825,555,494,46,15,270,92,22,17,3,2,70,123,71,62,8,1,52,121,89,87,1,1,32,92,72,58,10,4,20,397,301,270,24,7,96
S01006541,680,377,326,42,9,303,121,17,12,3,2,104,108,55,44,8,3,53,89,61,57,4,0,28,65,46,40,5,1,19,297,198,173,22,3,99
S01006542,874,481,420,53,8,393,136,25,22,3,0,111,145,70,54,10,6,75,106,66,56,9,1,40,72,50,43,7,0,22,415,270,245,24,1,145
S01006543,678,386,329,45,12,292,99,18,10,7,1,81,128,78,67,10,1,50,95,61,50,9,2,34,66,41,36,5,0,25,290,188,166,14,8,102
S01006544,930,663,543,102,18,267,108,42,25,16,1,66,114,79,61,16,2,35,115,80,66,10,4,35,72,56,43,13,0,16,521,406,348,47,11,115
S01006545,935,582,478,85,19,353,144,29,22,6,1,115,134,69,56,11,2,65,113,78,54,18,6,35,91,72,65,7,0,19,453,334,281,43,10,119
S01006546,526,325,277,41,7,201,44,13,13,0,0,31,89,50,41,7,2,39,82,56,49,5,2,26,50,35,27,6,2,15,261,171,147,23,1,90
S01006547,769,443,374,44,25,326,185,43,33,6,4,142,157,93,76,8,9,64,92,62,52,8,2,30,64,52,45,3,4,12,271,193,168,19,6,78
S01006548,618,349,300,42,7,269,60,5,2,3,0,55,102,60,45,12,3,42,81,54,50,3,1,27,77,58,49,7,2,19,298,172,154,17,1,126
S01006549,699,417,337,62,18,282,62,25,17,5,3,37,122,64,58,3,3,58,90,60,43,13,4,30,63,44,37,6,1,19,362,224,182,35,7,138
S01006550,821,445,382,52,11,376,99,17,12,4,1,82,113,60,51,7,2,53,122,78,68,8,2,44,73,46,38,6,2,27,414,244,213,27,4,170
S01006551,591,337,273,46,18,254,198,60,47,10,3,138,125,83,68,7,8,42,61,37,31,3,3,24,47,35,29,4,2,12,160,122,98,22,2,38
S01006552,753,540,458,66,16,213,80,31,25,6,0,49,137,97,83,10,4,40,109,85,76,5,4,24,74,60,53,6,1,14,353,267,221,39,7,86
S01006553,726,369,304,46,19,357,216,43,35,4,4,173,139,82,65,11,6,57,84,55,45,7,3,29,73,58,47,9,2,15,214,131,112,15,4,83
S01006554,615,403,344,33,26,212,151,56,49,5,2,95,147,109,94,4,11,38,67,50,39,5,6,17,53,41,36,4,1,12,197,147,126,15,6,50
S01006555,656,475,429,27,19,181,158,70,61,5,4,88,190,139,122,9,8,51,76,56,52,0,4,20,42,38,36,2,0,4,190,172,158,11,3,18
S01006556,707,413,351,37,25,294,225,61,47,9,5,164,229,156,132,13,11,73,79,58,49,7,2,21,60,51,42,5,4,9,114,87,81,3,3,27
S01006557,581,385,337,23,25,196,174,65,54,6,5,109,192,148,129,7,12,44,64,57,52,2,3,7,47,40,34,2,4,7,104,75,68,6,1,29
S01006558,563,414,377,34,3,149,52,17,12,5,0,35,68,42,39,2,1,26,73,50,48,2,0,23,46,35,34,1,0,11,324,270,244,24,2,54
S01006559,513,337,278,48,11,176,27,7,6,0,1,20,64,33,24,5,4,31,80,40,39,0,1,40,29,23,19,3,1,6,313,234,190,40,4,79
S01006560,847,534,442,76,16,313,122,12,7,4,1,110,113,59,47,6,6,54,78,50,45,4,1,28,76,52,37,15,0,24,458,361,306,47,8,97
S01006561,615,413,346,54,13,202,49,14,9,5,0,35,76,42,35,4,3,34,77,54,42,8,4,23,70,56,43,11,2,14,343,247,217,26,4,96
S01006562,608,367,305,50,12,241,109,24,20,2,2,85,120,69,55,10,4,51,59,42,35,5,2,17,55,42,38,4,0,13,265,190,157,29,4,75
S01006563,671,432,372,40,20,239,89,26,23,3,0,63,112,61,53,4,4,51,73,45,35,5,5,28,46,38,29,7,2,8,351,262,232,21,9,89
S01006564,891,623,547,39,37,268,150,57,51,4,2,93,163,106,86,10,10,57,119,78,71,1,6,41,84,69,63,2,4,15,375,313,276,22,15,62
S01006565,953,659,577,34,48,294,109,38,32,1,5,71,149,103,84,8,11,46,184,110,93,3,14,74,105,84,73,7,4,21,406,324,295,15,14,82
S01006566,684,505,452,33,20,179,57,23,22,1,0,34,71,49,44,5,0,22,95,63,57,3,3,32,73,57,51,3,3,16,388,313,278,21,14,75
S01006567,789,548,478,22,48,241,116,35,30,1,4,81,106,75,52,5,18,31,133,81,76,0,5,52,68,52,44,1,7,16,366,305,276,15,14,61
S01006568,876,739,665,41,33,137,36,18,13,4,1,18,89,78,66,3,9,11,140,104,90,6,8,36,91,85,80,2,3,6,520,454,416,26,12,66
S01006569,495,367,322,29,16,128,37,13,9,2,2,24,69,44,41,1,2,25,58,43,39,1,3,15,40,38,31,2,5,2,291,229,202,23,4,62
S01006570,657,464,389,56,19,193,65,19,16,2,1,46,61,32,25,5,2,29,89,57,49,7,1,32,60,50,40,6,4,10,382,306,259,36,11,76
S01006571,748,554,472,62,20,194,42,13,10,1,2,29,62,40,32,5,3,22,100,73,60,9,4,27,76,63,56,5,2,13,468,365,314,42,9,103
S01006572,718,470,379,80,11,248,57,14,9,5,0,43,93,53,40,8,5,40,76,46,34,8,4,30,55,39,34,4,1,16,437,318,262,55,1,119
S01006573,566,406,335,58,13,160,29,11,10,0,1,18,52,29,25,3,1,23,63,45,36,7,2,18,32,18,14,2,2,14,390,303,250,46,7,87
S01006574,809,537,435,80,22,272,49,12,8,2,2,37,90,45,34,6,5,45,110,67,53,11,3,43,68,55,43,8,4,13,492,358,297,53,8,134
S01006575,768,564,453,80,31,204,60,18,12,2,4,42,102,61,46,10,5,41,113,77,58,8,11,36,61,52,43,8,1,9,432,356,294,52,10,76
S01006576,577,451,377,58,16,126,24,10,7,3,0,14,72,47,37,4,6,25,66,46,39,5,2,20,54,45,34,8,3,9,361,303,260,38,5,58
S01006577,682,540,456,58,26,142,34,13,10,2,1,21,85,60,50,5,5,25,74,53,45,6,2,21,54,44,41,1,2,10,435,370,310,44,16,65
S01006578,1025,782,707,37,38,243,116,36,32,1,3,80,146,98,85,4,9,48,152,117,105,4,8,35,94,77,66,5,6,17,517,454,419,23,12,63
S01006579,914,741,672,39,30,173,52,18,12,2,4,34,92,70,64,4,2,22,125,91,83,2,6,34,105,97,89,3,5,8,540,465,424,28,13,75
S01006580,643,512,455,37,20,131,45,15,12,2,1,30,80,65,55,8,2,15,79,63,57,4,2,16,64,51,46,4,1,13,375,318,285,19,14,57
S01006581,745,493,401,78,14,252,61,15,13,2,0,46,101,52,40,9,3,49,96,64,58,4,2,32,73,55,42,8,5,18,414,307,248,55,4,107
S01006582,817,660,547,64,49,157,70,37,15,7,15,33,122,96,75,9,12,26,97,70,61,5,4,27,86,73,64,7,2,13,442,384,332,36,16,58
S01006583,678,548,486,22,40,130,37,14,11,2,1,23,69,50,43,0,7,19,151,104,91,3,10,47,83,72,62,6,4,11,338,308,279,11,18,30
S01006584,573,466,408,33,25,107,41,26,21,2,3,15,59,45,42,0,3,14,114,84,70,6,8,30,48,38,35,3,0,10,311,273,240,22,11,38
S01006585,734,515,431,42,42,219,161,69,50,11,8,92,138,96,77,8,11,42,109,72,58,4,10,37,79,69,58,5,6,10,247,209,188,14,7,38
S01006586,991,683,613,37,33,308,170,67,60,5,2,103,134,89,76,4,9,45,171,116,104,4,8,55,109,88,75,7,6,21,407,323,298,17,8,84
S01006587,504,406,347,24,35,98,53,31,26,3,2,22,66,60,51,2,7,6,89,58,46,3,9,31,60,53,42,6,5,7,236,204,182,10,12,32
S01006588,551,458,405,19,34,93,23,16,14,1,1,7,70,51,41,5,5,19,106,81,70,2,9,25,88,79,74,4,1,9,264,231,206,7,18,33
S01006589,630,484,405,33,46,146,72,38,30,3,5,34,109,78,64,5,9,31,103,68,53,5,10,35,85,71,65,2,4,14,261,229,193,18,18,32
S01006590,656,521,432,50,39,135,59,17,10,5,2,42,105,82,62,9,11,23,90,64,51,9,4,26,75,63,52,6,5,12,327,295,257,21,17,32
S01006591,654,555,489,42,24,99,49,29,22,4,3,20,109,91,80,5,6,18,85,63,51,7,5,22,71,64,55,6,3,7,340,308,281,20,7,32
S01006592,607,521,462,50,9,86,20,12,8,4,0,8,87,70,61,8,1,17,75,65,57,6,2,10,92,71,68,2,1,21,333,303,268,30,5,30
S01006593,707,572,508,42,22,135,49,16,13,2,1,33,83,67,56,9,2,16,99,69,58,3,8,30,87,72,62,8,2,15,389,348,319,20,9,41
S01006594,508,349,313,26,10,159,73,22,22,0,0,51,82,49,44,2,3,33,70,57,49,5,3,13,78,51,45,5,1,27,205,170,153,14,3,35
S01006595,852,710,629,58,23,142,66,26,22,3,1,40,117,97,82,7,8,20,114,88,79,5,4,26,87,81,74,6,1,6,468,418,372,37,9,50
S01006596,639,524,442,66,16,115,61,29,23,6,0,32,69,56,44,9,3,13,72,62,51,9,2,10,68,58,52,5,1,10,369,319,272,37,10,50
S01006597,498,420,382,26,12,78,31,10,8,2,0,21,71,55,49,4,2,16,82,69,59,7,3,13,68,61,57,3,1,7,246,225,209,10,6,21
S01006598,805,589,509,66,14,216,65,28,19,8,1,37,97,52,46,6,0,45,97,76,64,7,5,21,80,61,50,11,0,19,466,372,330,34,8,94
S01006599,751,477,415,37,25,274,182,50,46,2,2,132,130,78,65,6,7,52,116,86,74,7,5,30,81,66,57,1,8,15,242,197,173,21,3,45
S01006600,978,624,539,66,19,354,186,26,22,4,0,160,169,105,89,13,3,64,112,74,63,8,3,38,105,88,77,9,2,17,406,331,288,32,11,75
S01006601,899,681,591,53,37,218,97,34,30,3,1,63,156,105,89,10,6,51,119,90,73,6,11,29,110,94,75,12,7,16,417,358,324,22,12,59
S01006602,737,448,364,70,14,289,108,9,6,2,1,99,97,47,38,7,2,50,70,45,35,6,4,25,78,64,48,12,4,14,384,283,237,43,3,101
S01006603,704,428,371,23,34,276,263,96,83,1,12,167,200,146,123,10,13,54,90,74,62,7,5,16,49,44,44,0,0,5,102,68,59,5,4,34
S01006604,587,379,323,32,24,208,178,58,49,6,3,120,202,147,119,17,11,55,74,62,52,5,5,12,53,47,41,3,3,6,80,65,62,1,2,15
S01006605,658,399,341,23,35,259,241,76,69,2,5,165,219,171,142,11,18,48,54,41,35,2,4,13,53,38,32,2,4,15,91,73,63,6,4,18
S01006606,732,425,356,50,19,307,199,63,50,11,2,136,183,109,91,9,9,74,88,68,60,6,2,20,62,48,39,5,4,14,200,137,116,19,2,63
S01006607,769,518,456,40,22,251,239,111,98,9,4,128,266,197,170,17,10,69,92,69,59,5,5,23,64,52,48,3,1,12,108,89,81,6,2,19
S01006608,598,409,332,61,16,189,111,45,28,14,3,66,171,125,106,14,5,46,75,58,46,8,4,17,62,43,34,8,1,19,179,138,118,17,3,41
S01006609,886,556,489,46,21,330,306,101,88,9,4,205,285,210,187,13,10,75,93,78,69,6,3,15,79,63,56,5,2,16,123,104,89,13,2,19
S01006610,386,242,219,12,11,144,133,39,30,5,4,94,127,96,87,5,4,31,48,44,43,1,0,4,32,24,22,0,2,8,46,39,37,1,1,7
S01006611,772,476,406,32,38,296,258,88,75,4,9,170,263,187,149,16,22,76,72,57,47,6,4,15,50,43,41,2,0,7,129,101,94,4,3,28
S01006612,741,521,457,35,29,220,207,80,69,6,5,127,178,138,120,10,8,40,113,96,82,8,6,17,74,67,61,3,3,7,169,140,125,8,7,29
S01006613,493,412,366,36,10,81,54,27,25,2,0,27,170,143,128,11,4,27,82,72,66,4,2,10,58,51,46,4,1,7,129,119,101,15,3,10
S01006614,491,425,378,32,15,66,50,30,25,3,2,20,132,115,93,14,8,17,81,72,59,9,4,9,66,61,59,2,0,5,162,147,142,4,1,15
S01006615,563,464,407,46,11,99,51,28,23,5,0,23,150,121,106,12,3,29,79,64,57,6,1,15,87,74,64,9,1,13,196,177,157,14,6,19
S01006616,665,587,526,47,14,78,80,50,41,7,2,30,199,174,150,17,7,25,131,125,122,2,1,6,98,91,79,9,3,7,157,147,134,12,1,10
S01006617,574,418,361,39,18,156,142,52,45,5,2,90,173,139,119,11,9,34,88,80,66,12,2,8,50,41,37,4,0,9,121,106,94,7,5,15
S01006618,469,342,302,32,8,127,90,41,36,5,0,49,165,131,116,12,3,34,60,49,43,4,2,11,58,49,45,3,1,9,96,72,62,8,2,24
S01006619,744,549,470,64,15,195,165,83,69,12,2,82,214,155,129,20,6,59,108,87,71,10,6,21,78,72,63,8,1,6,179,152,138,14,0,27
S01006620,738,563,512,35,16,175,193,86,71,11,4,107,230,189,176,11,2,41,100,94,88,2,4,6,62,60,55,3,2,2,153,134,122,8,4,19
S01006621,428,327,291,24,12,101,100,50,43,4,3,50,132,108,96,8,4,24,50,43,40,3,0,7,46,41,38,1,2,5,100,85,74,8,3,15
S01006622,549,472,424,39,9,77,65,37,32,5,0,28,183,158,143,12,3,25,95,86,76,6,4,9,57,55,50,5,0,2,149,136,123,11,2,13
S01006623,670,441,391,28,22,229,214,77,66,4,7,137,190,151,134,9,8,39,87,68,62,3,3,19,60,48,40,5,3,12,119,97,89,7,1,22
S01006624,891,582,509,32,41,309,223,82,73,4,5,141,245,168,135,11,22,77,102,72,65,4,3,30,109,77,70,3,4,32,212,183,166,10,7,29
S01006625,547,392,337,32,23,155,152,69,53,11,5,83,143,112,102,3,7,31,73,59,50,5,4,14,55,44,39,4,1,11,124,108,93,9,6,16
S01006626,614,417,364,22,31,197,224,106,94,3,9,118,193,144,124,8,12,49,56,43,41,1,1,13,42,38,34,3,1,4,99,86,71,7,8,13
S01006627,773,615,532,32,51,158,161,92,77,6,9,69,205,163,134,9,20,42,76,63,56,2,5,13,98,85,75,1,9,13,233,212,190,14,8,21
S01006628,978,808,699,32,77,170,178,122,102,4,16,56,227,182,152,6,24,45,110,86,76,1,9,24,133,114,94,10,10,19,330,304,275,11,18,26
S01006629,650,409,342,19,48,241,227,91,77,3,11,136,206,155,127,6,22,51,70,42,35,4,3,28,46,37,29,1,7,9,101,84,74,5,5,17
S01006630,489,309,263,20,26,180,225,105,91,8,6,120,146,105,89,5,11,41,45,34,30,3,1,11,35,33,26,2,5,2,38,32,27,2,3,6
S01006631,805,533,468,27,38,272,296,119,106,3,10,177,223,160,140,7,13,63,68,63,55,1,7,5,70,62,52,6,4,8,148,129,115,10,4,19
S01006632,658,452,385,23,44,206,234,104,84,6,14,130,177,137,119,3,15,40,64,53,44,1,8,11,62,56,45,5,6,6,121,102,93,8,1,19
S01006633,529,339,298,11,30,190,200,85,78,2,5,115,178,130,109,4,17,48,42,37,33,1,3,5,40,31,28,1,2,9,69,56,50,3,3,13
S01006634,465,304,262,9,33,161,166,75,66,1,8,91,151,110,94,1,15,41,44,32,27,0,5,12,36,29,27,1,1,7,68,58,48,6,4,10
S01006635,522,360,304,25,31,162,172,81,74,2,5,91,174,127,102,9,16,47,43,34,28,4,2,9,43,36,30,4,2,7,90,82,70,6,6,8
S01006636,641,429,352,22,55,212,247,124,103,4,17,123,211,154,124,5,25,57,50,41,36,3,2,9,52,41,33,3,5,11,81,69,56,7,6,12
S01006637,699,457,387,40,30,242,157,38,31,4,3,119,127,86,65,9,12,41,83,56,48,5,3,27,58,47,46,0,1,11,274,230,197,22,11,44
S01006638,795,560,506,16,38,235,125,46,37,1,8,79,130,99,83,3,13,31,148,81,73,0,8,67,80,69,63,4,2,11,312,265,250,8,7,47
S01006639,900,578,498,30,50,322,199,51,42,2,7,148,148,98,85,3,10,50,159,96,83,3,10,63,66,54,46,3,5,12,328,279,242,19,18,49
S01006640,684,506,449,27,30,178,34,20,15,1,4,14,74,49,46,2,1,25,171,92,79,2,11,79,79,63,55,4,4,16,326,282,254,18,10,44
S01006641,980,723,636,39,48,257,121,51,36,7,8,70,165,113,95,5,13,52,199,138,121,4,13,61,97,87,81,4,2,10,398,334,303,19,12,64
S01006642,1332,773,613,25,135,559,67,24,22,0,2,43,169,90,67,8,15,79,525,275,201,6,68,250,144,105,85,4,16,39,427,279,238,7,34,148
S01006643,709,529,467,31,31,180,34,12,9,1,2,22,77,49,42,4,3,28,201,133,116,5,12,68,81,75,68,3,4,6,316,260,232,18,10,56
S01006644,915,642,564,33,45,273,99,38,36,0,2,61,117,83,72,2,9,34,234,144,116,8,20,90,114,98,92,3,3,16,351,279,248,20,11,72
S01006645,577,390,333,17,40,187,148,60,53,1,6,88,144,103,85,4,14,41,75,51,45,3,3,24,53,46,40,3,3,7,157,130,110,6,14,27
S01006646,979,568,424,9,135,411,70,16,14,1,1,54,135,83,55,0,28,52,374,182,124,0,58,192,83,60,53,2,5,23,317,227,178,6,43,90
S01006647,550,384,326,19,39,166,126,52,41,5,6,74,124,97,75,6,16,27,90,63,53,3,7,27,63,52,45,3,4,11,147,120,112,2,6,27
S01006648,1730,1096,891,39,166,634,103,48,38,4,6,55,197,138,109,5,24,59,603,332,248,2,82,271,232,166,139,8,19,66,595,412,357,20,35,183
S01006649,892,673,591,33,49,219,109,60,45,9,6,49,158,114,93,4,17,44,158,103,90,5,8,55,96,81,74,3,4,15,371,315,289,12,14,56
S01006650,813,580,495,38,47,233,78,40,31,4,5,38,117,78,61,11,6,39,193,112,93,3,16,81,74,69,61,2,6,5,351,281,249,18,14,70
S01006651,612,383,326,13,44,229,109,31,26,0,5,78,82,60,47,1,12,22,117,67,56,2,9,50,70,57,49,1,7,13,234,168,148,9,11,66
S01006652,516,391,337,29,25,125,55,23,15,5,3,32,64,48,35,6,7,16,121,84,75,4,5,37,61,50,47,1,2,11,215,186,165,13,8,29
S01006653,513,375,335,22,18,138,26,13,10,2,1,13,81,53,48,4,1,28,104,58,44,4,10,46,53,41,37,4,0,12,249,210,196,8,6,39
S01006654,798,510,438,28,44,288,213,64,53,4,7,149,189,131,109,7,15,58,123,82,68,7,7,41,61,49,42,2,5,12,212,184,166,8,10,28
S01006655,650,396,348,30,18,254,129,34,29,3,2,95,80,47,41,4,2,33,95,59,48,4,7,36,49,36,31,3,2,13,297,220,199,16,5,77
S01006656,858,650,575,35,40,208,87,33,25,5,3,54,124,82,65,4,13,42,155,112,98,5,9,43,97,82,75,3,4,15,395,341,312,18,11,54
S01006657,482,350,309,18,23,132,50,26,23,2,1,24,97,72,66,2,4,25,89,58,47,2,9,31,62,51,44,2,5,11,184,143,129,10,4,41
S01006658,878,615,523,28,64,263,126,66,53,5,8,60,152,98,82,3,13,54,187,118,101,3,14,69,101,90,73,5,12,11,312,243,214,12,17,69
S01006659,594,357,308,25,24,237,56,18,12,4,2,38,68,43,37,4,2,25,194,93,77,4,12,101,37,29,27,0,2,8,239,174,155,13,6,65
S01006660,425,286,240,16,30,139,50,25,18,3,4,25,79,57,49,3,5,22,98,55,46,1,8,43,40,36,28,1,7,4,158,113,99,8,6,45
S01006661,590,363,318,16,29,227,56,24,19,5,0,32,73,33,27,1,5,40,159,86,73,1,12,73,53,40,36,1,3,13,249,180,163,8,9,69
S01006662,738,403,309,24,70,335,98,63,53,3,7,35,106,67,52,6,9,39,228,100,65,4,31,128,47,36,31,1,4,11,259,137,108,10,19,122
S01006663,522,315,264,22,29,207,32,15,13,1,1,17,56,36,29,4,3,20,183,86,72,3,11,97,44,29,26,1,2,15,207,149,124,13,12,58
S01006664,471,311,278,12,21,160,50,20,15,2,3,30,52,33,29,0,4,19,124,66,59,3,4,58,53,43,38,2,3,10,192,149,137,5,7,43
S01006665,681,407,346,22,39,274,68,23,17,3,3,45,82,54,49,1,4,28,242,117,93,6,18,125,51,40,33,3,4,11,238,173,154,9,10,65
S01006666,742,424,340,28,56,318,307,94,72,6,16,213,173,124,87,10,27,49,75,48,42,3,3,27,47,43,40,1,2,4,140,115,99,8,8,25
S01006667,653,405,321,21,63,248,207,79,61,4,14,128,146,99,78,5,16,47,89,51,38,2,11,38,69,57,45,4,8,12,142,119,99,6,14,23
S01006668,858,550,468,19,63,308,68,21,17,2,2,47,109,75,63,3,9,34,290,151,114,4,33,139,91,66,59,1,6,25,300,237,215,9,13,63
S01006669,1161,522,394,28,100,639,200,55,48,4,3,145,179,85,63,5,17,94,340,135,80,3,52,205,59,35,25,2,8,24,383,212,178,14,20,171
S01006670,901,549,450,20,79,352,121,29,25,3,1,92,117,67,47,7,13,50,324,204,172,4,28,120,76,58,49,1,8,18,263,191,157,5,29,72
S01006671,2355,988,580,26,382,1367,82,26,18,3,5,56,316,131,79,4,48,185,1088,494,266,5,223,594,196,84,50,3,31,112,673,253,167,11,75,420
S01006672,685,422,358,19,45,263,162,76,65,3,8,86,134,89,68,7,14,45,127,65,55,2,8,62,70,48,45,0,3,22,192,144,125,7,12,48
S01006673,760,499,392,43,64,261,131,67,52,9,6,64,137,100,74,10,16,37,146,81,66,3,12,65,78,63,49,7,7,15,268,188,151,14,23,80
S01006674,779,453,368,33,52,326,285,97,75,7,15,188,196,135,104,9,22,61,63,47,43,1,3,16,81,55,48,3,4,26,154,119,98,13,8,35
S01006675,530,387,317,16,54,143,118,61,50,2,9,57,153,107,84,6,17,46,54,32,26,0,6,22,65,59,49,4,6,6,140,128,108,4,16,12
S01006676,606,386,322,21,43,220,186,75,61,6,8,111,148,95,76,5,14,53,87,60,51,2,7,27,64,55,44,5,6,9,121,101,90,3,8,20
S01006677,621,417,339,26,52,204,172,87,72,5,10,85,165,124,92,8,24,41,83,51,43,3,5,32,56,41,35,3,3,15,145,114,97,7,10,31
S01006678,935,627,523,25,79,308,299,150,118,5,27,149,311,227,189,4,34,84,87,62,54,2,6,25,84,67,58,5,4,17,154,121,104,9,8,33
S01006679,581,398,361,21,16,183,161,63,58,4,1,98,126,96,82,6,8,30,86,67,60,3,4,19,54,46,42,4,0,8,154,126,119,4,3,28
S01006680,668,471,391,26,54,197,209,110,88,10,12,99,199,148,121,4,23,51,47,33,29,2,2,14,87,71,59,3,9,16,126,109,94,7,8,17
S01006681,765,497,444,24,29,268,306,117,112,1,4,189,170,138,114,6,18,32,86,74,62,6,6,12,63,54,52,1,1,9,140,114,104,10,0,26
S01006682,662,459,374,28,57,203,186,84,57,7,20,102,187,147,126,6,15,40,72,53,42,1,10,19,71,64,54,6,4,7,146,111,95,8,8,35
S01006683,697,509,431,24,54,188,134,69,54,6,9,65,170,138,114,2,22,32,119,80,67,6,7,39,74,58,50,1,7,16,200,164,146,9,9,36
S01006684,605,429,366,17,46,176,143,71,62,1,8,72,171,119,93,3,23,52,91,72,62,3,7,19,46,40,36,3,1,6,154,127,113,7,7,27
S01006685,638,457,388,21,48,181,178,81,65,5,11,97,172,131,104,7,20,41,76,59,53,0,6,17,74,62,55,1,6,12,138,124,111,8,5,14
S01006686,521,348,305,22,21,173,166,60,50,5,5,106,165,131,115,11,5,34,55,44,37,0,7,11,41,33,29,3,1,8,94,80,74,3,3,14
S01006687,719,475,422,18,35,244,217,82,72,5,5,135,173,121,102,4,15,52,103,76,70,1,5,27,58,52,44,4,4,6,168,144,134,4,6,24
S01006688,851,430,366,46,18,421,273,57,49,4,4,216,210,128,109,17,2,82,113,69,55,10,4,44,64,43,38,3,2,21,191,133,115,12,6,58
S01006689,546,405,341,47,17,141,44,19,16,3,0,25,77,57,47,10,0,20,98,60,44,8,8,38,63,43,36,5,2,20,264,226,198,21,7,38
S01006690,533,348,305,18,25,185,102,31,24,1,6,71,100,70,61,3,6,30,102,57,45,5,7,45,48,36,33,2,1,12,181,154,142,7,5,27
S01006691,497,350,311,26,13,147,70,28,22,5,1,42,101,72,59,8,5,29,78,43,38,2,3,35,46,41,38,1,2,5,202,166,154,10,2,36
S01006692,669,396,350,32,14,273,127,47,39,7,1,80,115,65,54,9,2,50,126,61,56,2,3,65,51,35,30,2,3,16,250,188,171,12,5,62
S01006693,834,609,531,35,43,225,137,54,44,4,6,83,199,153,124,14,15,46,130,97,87,6,4,33,78,61,54,3,4,17,290,244,222,8,14,46
S01006694,735,354,304,26,24,381,340,83,73,5,5,257,212,129,111,8,10,83,49,36,26,4,6,13,43,37,32,4,1,6,91,69,62,5,2,22
S01006695,608,376,335,29,12,232,187,67,54,10,3,120,175,117,108,6,3,58,67,50,46,3,1,17,70,57,51,5,1,13,109,85,76,5,4,24
S01006696,695,437,377,20,40,258,210,68,54,3,11,142,201,146,125,8,13,55,84,63,59,2,2,21,68,57,50,1,6,11,132,103,89,6,8,29
S01006697,772,499,441,36,22,273,228,89,73,11,5,139,243,164,147,12,5,79,94,77,69,5,3,17,54,46,39,3,4,8,153,123,113,5,5,30
S01006698,608,339,313,8,18,269,218,54,49,4,1,164,145,104,100,0,4,41,76,52,46,2,4,24,51,37,36,0,1,14,118,92,82,2,8,26
S01006699,410,288,252,17,19,122,88,47,40,5,2,41,117,90,77,4,9,27,34,21,18,1,2,13,30,27,24,3,0,3,141,103,93,4,6,38
S01006700,754,450,386,34,30,304,184,54,38,6,10,130,183,113,95,10,8,70,93,57,47,4,6,36,68,53,50,1,2,15,226,173,156,13,4,53
S01006701,554,376,319,15,42,178,186,87,71,3,13,99,209,161,131,7,23,48,57,44,40,1,3,13,42,37,33,2,2,5,60,47,44,2,1,13
S01006702,635,433,370,34,29,202,245,116,99,7,10,129,207,167,142,13,12,40,65,55,46,8,1,10,57,45,41,2,2,12,61,50,42,4,4,11
S01006703,522,356,303,19,34,166,179,81,71,5,5,98,175,136,110,7,19,39,52,44,41,2,1,8,37,30,27,1,2,7,79,65,54,4,7,14
S01006704,481,297,261,11,25,184,175,66,54,4,8,109,169,131,114,3,14,38,42,22,19,2,1,20,43,35,33,0,2,8,52,43,41,2,0,9
S01006705,627,373,328,27,18,254,248,89,78,8,3,159,226,158,139,11,8,68,52,44,39,5,0,8,41,37,35,1,1,4,60,45,37,2,6,15
S01006706,495,343,296,27,20,152,153,60,58,1,1,93,159,128,107,15,6,31,63,52,39,3,10,11,40,33,31,2,0,7,80,70,61,6,3,10
S01006707,543,363,310,23,30,180,190,93,74,10,9,97,171,113,90,9,14,58,54,45,40,3,2,9,40,35,32,0,3,5,88,77,74,1,2,11
S01006708,668,405,359,27,19,263,222,64,53,8,3,158,218,163,139,11,13,55,57,42,39,3,0,15,56,46,42,4,0,10,115,90,86,1,3,25
S01006709,678,443,379,33,31,235,218,90,71,11,8,128,245,188,161,12,15,57,73,54,50,2,2,19,60,52,46,4,2,8,82,59,51,4,4,23
S01006710,753,464,418,31,15,289,301,108,87,17,4,193,212,158,144,6,8,54,93,81,77,3,1,12,54,39,35,3,1,15,93,78,75,2,1,15
S01006711,807,508,424,53,31,299,295,112,91,16,5,183,245,183,152,16,15,62,99,80,68,8,4,19,55,45,42,1,2,10,113,88,71,12,5,25
S01006712,454,266,240,13,13,188,178,56,47,5,4,122,147,108,102,2,4,39,45,37,36,0,1,8,32,22,19,0,3,10,52,43,36,6,1,9
S01006713,788,488,437,30,21,300,310,129,115,10,4,181,263,192,169,11,12,71,84,67,59,5,3,17,49,41,39,1,1,8,82,59,55,3,1,23
S01006714,589,367,328,16,23,222,227,93,77,8,8,134,168,124,108,6,10,44,61,47,44,1,2,14,50,43,42,0,1,7,83,60,57,1,2,23
S01006715,439,295,252,15,28,144,154,77,62,4,11,77,160,111,98,3,10,49,39,33,30,2,1,6,28,24,19,1,4,4,58,50,43,5,2,8
S01006716,496,344,289,30,25,152,160,82,63,10,9,78,188,139,118,12,9,49,56,43,36,2,5,13,37,30,29,0,1,7,55,50,43,6,1,5
S01006717,819,516,453,27,36,303,324,122,109,8,5,202,248,189,162,10,17,59,83,72,61,3,8,11,60,51,45,2,4,9,104,82,76,4,2,22
S01006718,519,345,284,27,34,174,190,101,81,11,9,89,192,133,109,7,17,59,50,41,30,4,7,9,31,24,23,1,0,7,56,46,41,4,1,10
S01006719,724,491,419,40,32,233,243,110,93,7,10,133,239,188,152,18,18,51,89,67,61,4,2,22,58,46,43,1,2,12,95,80,70,10,0,15
S01006720,477,339,291,20,28,138,168,81,71,5,5,87,159,135,108,8,19,24,44,35,34,1,0,9,40,36,34,1,1,4,66,52,44,5,3,14
S01006721,735,489,424,27,38,246,265,117,102,9,6,148,271,205,176,8,21,66,62,51,46,4,1,11,49,42,37,2,3,7,88,74,63,4,7,14
S01006722,619,406,353,19,34,213,205,90,79,3,8,115,223,162,138,10,14,61,53,42,37,2,3,11,46,42,40,0,2,4,92,70,59,4,7,22
S01006723,553,354,303,26,25,199,191,76,59,8,9,115,179,136,122,8,6,43,72,53,44,6,3,19,31,27,25,1,1,4,80,62,53,3,6,18
S01006724,687,470,375,28,67,217,225,120,95,7,18,105,281,208,162,10,36,73,60,45,36,1,8,15,36,32,27,3,2,4,85,65,55,7,3,20
S01006725,532,352,315,19,18,180,196,88,80,2,6,108,179,139,121,11,7,40,61,46,41,2,3,15,46,39,35,2,2,7,50,40,38,2,0,10
S01006726,985,717,584,33,100,268,297,164,127,8,29,133,327,240,186,6,48,87,97,84,70,2,12,13,97,82,71,8,3,15,167,147,130,9,8,20
S01006727,784,483,392,23,68,301,294,105,83,6,16,189,262,197,153,9,35,65,76,58,48,2,8,18,60,45,41,2,2,15,92,78,67,4,7,14
S01006728,588,399,351,16,32,189,193,88,76,4,8,105,190,146,128,3,15,44,52,38,35,1,2,14,55,43,41,2,0,12,98,84,71,6,7,14
S01006729,639,410,347,14,49,229,249,106,88,6,12,143,200,145,123,2,20,55,55,43,32,1,10,12,43,38,34,2,2,5,92,78,70,3,5,14
S01006730,579,417,374,16,27,162,181,97,86,7,4,84,189,146,132,2,12,43,70,58,58,0,0,12,42,38,32,2,4,4,97,78,66,5,7,19
S01006731,482,313,273,18,22,169,190,89,70,7,12,101,168,127,116,3,8,41,51,36,31,3,2,15,26,21,18,3,0,5,47,40,38,2,0,7
S01006732,858,573,463,84,26,285,130,48,30,16,2,82,167,113,87,15,11,54,129,93,75,12,6,36,118,77,68,7,2,41,314,242,203,34,5,72
S01006733,646,482,402,63,17,164,43,13,10,2,1,30,136,99,79,15,5,37,93,71,61,7,3,22,78,66,60,5,1,12,296,233,192,34,7,63
S01006734,756,545,449,79,17,211,118,26,16,9,1,92,148,107,83,16,8,41,92,77,67,9,1,15,78,68,57,9,2,10,320,267,226,36,5,53
S01006735,501,297,260,29,8,204,72,18,17,1,0,54,80,38,35,2,1,42,73,50,39,7,4,23,42,28,27,0,1,14,234,163,142,19,2,71
S01006736,772,675,578,76,21,97,40,24,17,6,1,16,147,124,110,11,3,23,118,100,93,3,4,18,113,104,87,13,4,9,354,323,271,43,9,31
S01006737,544,352,293,45,14,192,80,28,15,12,1,52,116,71,54,10,7,45,75,54,50,2,2,21,63,47,40,6,1,16,210,152,134,15,3,58
S01006738,714,608,542,41,25,106,119,78,68,5,5,41,203,181,163,11,7,22,102,88,73,11,4,14,92,86,79,4,3,6,198,175,159,10,6,23
S01006739,529,427,375,35,17,102,103,52,40,8,4,51,142,118,103,8,7,24,84,75,66,7,2,9,64,57,54,3,0,7,136,125,112,9,4,11
S01006740,637,420,373,22,25,217,208,75,65,5,5,133,190,156,137,5,14,34,72,54,48,2,4,18,64,50,44,5,1,14,103,85,79,5,1,18
S01006741,596,325,294,26,5,271,253,76,72,4,0,177,164,120,109,11,0,44,45,33,30,2,1,12,43,33,29,2,2,10,91,63,54,7,2,28
S01006742,388,218,191,18,9,170,149,39,32,5,2,110,115,78,66,8,4,37,38,30,28,0,2,8,22,20,19,1,0,2,64,51,46,4,1,13
S01006743,481,326,297,25,4,155,127,40,35,3,2,87,133,93,85,7,1,40,73,65,56,8,1,8,47,42,40,2,0,5,101,86,81,5,0,15
S01006744,524,401,350,34,17,123,123,57,51,5,1,66,139,112,95,8,9,27,72,63,52,10,1,9,64,63,58,2,3,1,126,106,94,9,3,20
S01006745,707,429,374,35,20,278,249,95,75,13,7,154,216,141,125,8,8,75,73,60,52,5,3,13,67,57,54,2,1,10,102,76,68,7,1,26
S01006746,712,455,401,29,25,257,230,66,56,6,4,164,246,199,174,12,13,47,80,68,62,2,4,12,65,53,47,4,2,12,91,69,62,5,2,22
S01006747,728,425,380,30,15,303,160,52,49,1,2,108,177,109,96,8,5,68,103,78,68,7,3,25,85,59,53,5,1,26,203,127,114,9,4,76
S01006748,772,500,431,52,17,272,156,40,28,10,2,116,212,152,132,12,8,60,108,91,81,7,3,17,80,55,46,7,2,25,216,162,144,16,2,54
S01006749,773,536,483,31,22,237,236,91,82,4,5,145,254,206,185,11,10,48,86,73,66,5,2,13,65,54,51,2,1,11,132,112,99,9,4,20
S01006750,627,374,329,26,19,253,234,84,72,8,4,150,178,128,111,7,10,50,74,49,45,3,1,25,45,41,37,2,2,4,96,72,64,6,2,24
S01006751,436,258,234,19,5,178,156,43,36,7,0,113,109,83,72,7,4,26,57,45,44,1,0,12,35,31,30,1,0,4,79,56,52,3,1,23
S01006752,596,366,338,13,15,230,213,66,60,3,3,147,162,123,112,6,5,39,66,53,51,0,2,13,64,48,45,2,1,16,91,76,70,2,4,15
S01006753,779,507,447,52,8,272,177,61,54,5,2,116,198,137,121,11,5,61,105,80,69,11,0,25,95,77,70,7,0,18,204,152,133,18,1,52
S01006754,808,511,462,34,15,297,163,46,42,3,1,117,234,162,140,10,12,72,112,87,84,3,0,25,89,67,58,8,1,22,210,149,138,10,1,61
S01006755,574,451,377,66,8,123,73,36,26,8,2,37,160,126,106,17,3,34,80,61,51,8,2,19,74,64,51,13,0,10,187,164,143,20,1,23
S01006756,616,444,390,41,13,172,106,12,10,2,0,94,92,74,60,7,7,18,86,65,55,7,3,21,78,72,67,4,1,6,254,221,198,21,2,33
S01006757,749,521,468,34,19,228,182,50,39,5,6,132,180,142,122,14,6,38,116,97,91,3,3,19,77,63,58,3,2,14,194,169,158,9,2,25
S01006758,599,470,427,33,10,129,78,35,32,3,0,43,173,137,126,8,3,36,93,74,68,4,2,19,70,63,57,4,2,7,185,161,144,14,3,24
S01006759,492,363,322,30,11,129,87,32,27,5,0,55,139,103,87,10,6,36,84,69,64,2,3,15,58,50,44,5,1,8,124,109,100,8,1,15
S01006760,421,340,306,22,12,81,62,22,19,3,0,40,121,103,89,6,8,18,68,60,58,1,1,8,57,55,52,3,0,2,113,100,88,9,3,13
S01006761,629,458,397,44,17,171,140,59,46,9,4,81,177,138,121,14,3,39,87,74,65,2,7,13,65,55,50,4,1,10,160,132,115,15,2,28
S01006762,718,397,340,45,12,321,232,54,40,12,2,178,154,111,97,10,4,43,99,68,60,6,2,31,57,44,38,5,1,13,176,120,105,12,3,56
S01006763,667,590,529,41,20,77,49,36,28,7,1,13,210,178,157,11,10,32,111,102,91,8,3,9,88,79,72,6,1,9,209,195,181,9,5,14
S01006764,665,560,521,23,16,105,71,38,35,2,1,33,208,176,157,11,8,32,114,102,96,4,2,12,76,71,69,2,0,5,196,173,164,4,5,23
S01006765,500,414,381,23,10,86,58,38,36,2,0,20,166,141,125,11,5,25,84,73,68,3,2,11,56,50,48,2,0,6,136,112,104,5,3,24
S01006766,505,397,353,34,10,108,44,21,19,2,0,23,129,98,81,12,5,31,102,86,79,6,1,16,59,53,47,4,2,6,171,139,127,10,2,32
S01006767,591,438,393,32,13,153,156,69,65,4,0,87,169,132,120,8,4,37,104,95,85,6,4,9,48,44,40,2,2,4,114,98,83,12,3,16
S01006768,507,388,342,41,5,119,58,31,23,8,0,27,117,84,74,10,0,33,94,73,65,6,2,21,63,54,46,7,1,9,175,146,134,10,2,29
S01006769,793,580,522,47,11,213,199,87,74,12,1,112,221,175,157,11,7,46,97,85,79,4,2,12,77,68,63,4,1,9,199,165,149,16,0,34
S01006770,567,406,367,33,6,161,122,51,46,5,0,71,146,102,94,7,1,44,87,77,69,6,2,10,56,43,39,4,0,13,156,133,119,11,3,23
S01006771,378,297,260,29,8,81,41,20,14,6,0,21,112,86,77,5,4,26,70,56,47,7,2,14,45,40,36,4,0,5,110,95,86,7,2,15
S01006772,728,561,489,57,15,167,143,78,67,9,2,65,210,160,127,28,5,50,112,96,87,7,2,16,81,68,64,2,2,13,182,159,144,11,4,23
S01006773,604,408,356,43,9,196,149,42,30,12,0,107,141,101,88,12,1,40,101,87,80,6,1,14,56,45,41,4,0,11,157,133,117,9,7,24
S01006774,540,432,382,38,12,108,82,50,44,6,0,32,144,122,113,5,4,22,108,88,72,13,3,20,59,53,49,2,2,6,147,119,104,12,3,28
S01006775,549,392,348,29,15,157,138,53,44,7,2,85,168,133,117,10,6,35,81,66,61,3,2,15,52,45,40,3,2,7,110,95,86,6,3,15
S01006776,447,264,231,21,12,183,192,59,52,7,0,133,113,90,79,5,6,23,43,34,32,2,0,9,36,30,24,5,1,6,63,51,44,2,5,12
S01006777,553,391,354,35,2,162,98,52,43,9,0,46,159,115,107,8,0,44,95,75,67,7,1,20,71,53,52,0,1,18,130,96,85,11,0,34
S01006778,566,385,350,20,15,181,146,49,41,6,2,97,163,121,107,5,9,42,86,77,72,4,1,9,59,46,45,0,1,13,112,92,85,5,2,20
S01006779,527,335,296,19,20,192,220,80,71,5,4,140,118,92,82,7,3,26,53,41,35,4,2,12,43,41,33,2,6,2,93,81,75,1,5,12
S01006780,498,335,274,42,19,163,129,41,33,6,2,88,124,93,70,15,8,31,74,59,50,6,3,15,55,46,38,4,4,9,116,96,83,11,2,20
S01006781,607,379,320,44,15,228,146,49,38,9,2,97,168,117,97,11,9,51,109,82,73,8,1,27,48,32,27,4,1,16,136,99,85,12,2,37
S01006782,624,463,406,47,10,161,120,50,43,7,0,70,177,132,118,10,4,45,85,75,64,7,4,10,67,63,54,9,0,4,175,143,127,14,2,32
S01006783,585,340,296,26,18,245,166,52,46,5,1,114,157,101,89,8,4,56,72,59,51,2,6,13,54,37,35,2,0,17,136,91,75,9,7,45
S01006784,548,399,338,38,23,149,87,29,19,8,2,58,115,91,73,10,8,24,80,61,50,5,6,19,66,58,52,4,2,8,200,160,144,11,5,40
S01006785,495,390,354,27,9,105,67,34,32,2,0,33,143,111,101,8,2,32,83,71,63,5,3,12,60,57,47,10,0,3,142,117,111,2,4,25
S01006786,672,497,428,54,15,175,107,44,37,5,2,63,148,106,85,12,9,42,113,84,75,7,2,29,84,73,62,9,2,11,220,190,169,21,0,30
S01006787,569,376,312,49,15,193,142,50,41,8,1,92,138,104,86,14,4,34,73,61,53,5,3,12,71,53,45,6,2,18,145,108,87,16,5,37
S01006788,662,491,424,54,13,171,143,49,33,12,4,94,163,132,116,12,4,31,110,91,80,9,2,19,69,58,51,7,0,11,177,161,144,14,3,16
S01006789,552,325,259,56,10,227,124,45,33,10,2,79,138,101,83,15,3,37,51,33,24,7,2,18,49,42,34,8,0,7,190,104,85,16,3,86
S01006790,766,426,341,68,17,340,183,66,54,9,3,117,202,148,123,18,7,54,112,77,66,7,4,35,43,27,22,4,1,16,226,108,76,30,2,118
S01006791,446,293,189,89,15,153,108,52,23,25,4,56,92,68,46,18,4,24,61,49,38,9,2,12,44,29,19,10,0,15,141,95,63,27,5,46
S01006792,416,279,202,68,9,137,73,44,32,11,1,29,96,64,54,9,1,32,62,46,25,17,4,16,47,37,29,7,1,10,138,88,62,24,2,50
S01006793,478,322,247,71,4,156,117,59,48,11,0,58,116,79,63,14,2,37,53,47,37,9,1,6,44,37,28,8,1,7,148,100,71,29,0,48
S01006794,499,287,233,43,11,212,130,44,33,9,2,86,122,88,72,10,6,34,55,42,34,5,3,13,33,22,18,4,0,11,159,91,76,15,0,68
S01006795,587,349,273,67,9,238,81,24,19,5,0,57,106,72,58,9,5,34,66,47,40,6,1,19,50,35,27,7,1,15,284,171,129,40,2,113
S01006796,436,291,232,51,8,145,50,22,13,6,3,28,85,57,49,6,2,28,67,50,40,9,1,17,49,40,35,5,0,9,185,122,95,25,2,63
S01006797,500,360,258,92,10,140,64,28,21,6,1,36,101,71,51,18,2,30,67,54,41,11,2,13,50,41,26,14,1,9,218,166,119,43,4,52
S01006798,493,369,265,97,7,124,81,46,24,21,1,35,122,99,71,26,2,23,62,45,33,12,0,17,55,46,34,12,0,9,173,133,103,26,4,40
S01006799,745,466,389,62,15,279,186,53,40,10,3,133,194,145,121,20,4,49,94,79,70,6,3,15,71,59,55,3,1,12,200,130,103,23,4,70
S01006800,687,450,358,80,12,237,99,42,32,9,1,57,112,84,62,19,3,28,112,79,63,13,3,33,68,43,32,8,3,25,296,202,169,31,2,94
S01006801,796,495,384,96,15,301,213,60,37,21,2,153,166,111,91,16,4,55,112,85,72,9,4,27,70,53,39,13,1,17,235,186,145,37,4,49
S01006802,556,376,280,75,21,180,141,57,43,12,2,84,134,102,75,17,10,32,74,59,41,16,2,15,51,40,30,10,0,11,156,118,91,20,7,38
S01006803,571,360,308,37,15,211,195,60,50,7,3,135,156,123,108,8,7,33,67,56,47,6,3,11,54,44,41,2,1,10,99,77,62,14,1,22
S01006804,578,422,367,42,13,156,116,49,37,9,3,67,145,108,93,11,4,37,80,65,55,8,2,15,63,52,44,7,1,11,174,148,138,7,3,26
S01006805,894,644,521,100,23,250,185,81,52,25,4,104,250,196,156,26,14,54,131,101,88,11,2,30,93,75,65,8,2,18,235,191,160,30,1,44
S01006806,849,603,464,123,16,246,172,75,49,24,2,97,191,147,117,27,3,44,134,98,73,21,4,36,107,89,67,21,1,18,245,194,158,30,6,51
S01006807,484,369,276,70,23,115,78,45,33,8,4,33,120,83,65,11,7,37,86,72,53,16,3,14,47,41,30,11,0,6,153,128,95,24,9,25
S01006808,507,339,260,70,9,168,78,35,26,9,0,43,127,84,67,14,3,43,72,47,37,8,2,25,55,40,31,9,0,15,175,133,99,30,4,42
S01006809,656,397,318,57,22,259,175,68,56,10,2,107,180,122,94,16,12,58,81,52,46,3,3,29,74,60,48,9,3,14,146,95,74,19,2,51
S01006810,704,468,341,101,26,236,159,62,39,18,5,97,164,110,76,24,10,54,79,61,45,11,5,18,67,51,37,12,2,16,235,184,144,36,4,51
S01006811,841,608,485,102,21,233,143,66,51,13,2,77,169,116,89,18,9,53,111,84,61,20,3,27,108,92,71,17,4,16,310,250,213,34,3,60
S01006812,601,452,367,74,11,149,122,65,53,9,3,57,149,114,91,19,4,35,80,61,50,10,1,19,51,47,41,4,2,4,199,165,132,32,1,34
S01006813,626,436,353,67,16,190,175,72,49,22,1,103,186,151,129,17,5,35,82,71,58,9,4,11,55,46,38,6,2,9,128,96,79,13,4,32
S01006814,624,425,375,44,6,199,84,29,21,8,0,55,161,113,98,13,2,48,121,87,74,11,2,34,57,46,42,3,1,11,201,150,140,9,1,51
S01006815,485,308,272,19,17,177,189,70,59,5,6,119,125,96,86,5,5,29,55,49,47,1,1,6,44,43,36,3,4,1,72,50,44,5,1,22
S01006816,586,380,325,48,7,206,136,47,39,8,0,89,141,97,84,10,3,44,88,67,54,11,2,21,63,48,43,3,2,15,158,121,105,16,0,37
S01006817,517,377,307,58,12,140,114,54,44,7,3,60,127,93,74,15,4,34,54,42,35,4,3,12,66,55,45,9,1,11,156,133,109,23,1,23
S01006818,580,429,343,74,12,151,103,46,30,15,1,57,132,102,79,19,4,30,81,66,50,15,1,15,63,52,44,6,2,11,201,163,140,19,4,38
S01006819,655,509,378,123,8,146,94,50,33,17,0,44,124,99,67,28,4,25,104,77,59,16,2,27,75,61,42,19,0,14,258,222,177,43,2,36
S01006820,383,269,234,25,10,114,48,16,16,0,0,32,90,64,50,7,7,26,48,32,28,4,0,16,33,29,27,2,0,4,164,128,113,12,3,36
S01006821,484,375,282,80,13,109,57,32,17,14,1,25,97,75,51,20,4,22,77,63,51,10,2,14,63,56,45,9,2,7,190,149,118,27,4,41
S01006822,609,469,339,115,15,140,92,47,21,25,1,45,144,117,74,36,7,27,99,74,63,11,0,25,72,66,56,9,1,6,202,165,125,34,6,37
S01006823,613,382,319,51,12,231,101,20,17,1,2,81,110,73,59,10,4,37,92,60,52,7,1,32,68,50,42,5,3,18,242,179,149,28,2,63
S01006824,652,444,388,29,27,208,206,87,75,8,4,119,222,168,142,9,17,54,71,60,58,1,1,11,56,46,42,1,3,10,97,83,71,10,2,14
S01006825,678,493,441,35,17,185,166,76,63,12,1,90,186,146,130,6,10,40,99,82,78,3,1,17,57,53,48,4,1,4,170,136,122,10,4,34
S01006826,785,503,429,65,9,282,190,43,34,7,2,147,151,109,90,15,4,42,123,101,86,14,1,22,90,71,60,9,2,19,231,179,159,20,0,52
S01006827,735,482,425,35,22,253,199,70,62,5,3,129,161,108,95,4,9,53,95,75,65,7,3,20,81,67,59,5,3,14,199,162,144,14,4,37
S01006828,799,534,449,59,26,265,152,46,36,10,0,106,199,148,120,17,11,51,120,88,74,6,8,32,83,72,61,6,5,11,245,180,158,20,2,65
S01006829,291,244,213,25,6,47,19,9,7,2,0,10,46,38,31,4,3,8,43,39,34,4,1,4,35,29,25,4,0,6,148,129,116,11,2,19
S01006830,627,416,352,51,13,211,148,54,44,9,1,94,172,128,106,15,7,44,87,70,63,7,0,17,83,62,56,4,2,21,137,102,83,16,3,35
S01006831,452,278,244,23,11,174,77,24,18,4,2,53,87,53,44,7,2,34,65,51,48,2,1,14,56,47,46,1,0,9,167,103,88,9,6,64
S01006832,862,548,462,67,19,314,137,34,26,6,2,103,172,106,86,11,9,66,144,109,91,14,4,35,101,76,66,10,0,25,308,223,193,26,4,85
S01006833,373,225,179,41,5,148,55,9,3,6,0,46,66,40,31,8,1,26,39,27,21,4,2,12,35,26,23,3,0,9,178,123,101,20,2,55
S01006834,375,315,277,28,10,60,29,14,9,3,2,15,94,74,59,10,5,20,69,58,55,1,2,11,49,43,39,3,1,6,134,126,115,11,0,8
S01006835,745,422,345,62,15,323,214,40,26,10,4,174,134,74,66,4,4,60,102,78,68,10,0,24,68,57,33,22,2,11,227,173,152,16,5,54
S01006836,372,308,257,38,13,64,40,21,11,5,5,19,67,52,44,5,3,15,59,50,44,3,3,9,62,59,51,7,1,3,144,126,107,18,1,18
S01006837,466,317,268,46,3,149,73,26,18,7,1,47,116,84,74,9,1,32,77,57,47,9,1,20,48,39,32,7,0,9,152,111,97,14,0,41
S01006838,510,376,331,39,6,134,77,30,26,4,0,47,120,90,80,8,2,30,86,64,57,4,3,22,58,53,45,8,0,5,169,139,123,15,1,30
S01006839,864,613,534,57,22,251,173,63,54,6,3,110,205,162,148,8,6,43,122,107,89,12,6,15,92,81,71,7,3,11,272,200,172,24,4,72
S01006840,793,575,502,57,16,218,90,29,22,6,1,61,195,148,131,10,7,47,124,93,85,5,3,31,116,88,76,10,2,28,268,217,188,26,3,51
S01006841,729,580,498,59,23,149,101,51,36,14,1,50,162,120,108,6,6,42,124,109,94,7,8,15,87,81,72,5,4,6,255,219,188,27,4,36
S01006842,680,508,453,45,10,172,91,41,35,4,2,50,221,168,149,18,1,53,116,100,90,7,3,16,79,64,60,3,1,15,173,135,119,13,3,38
S01006843,669,527,463,51,13,142,120,62,52,7,3,58,209,172,149,17,6,37,114,97,88,8,1,17,91,81,70,9,2,10,135,115,104,10,1,20
S01006844,587,467,416,42,9,120,103,45,37,8,0,58,164,133,123,9,1,31,93,85,77,7,1,8,92,85,72,8,5,7,135,119,107,10,2,16
S01006845,778,622,564,43,15,156,99,49,40,8,1,50,229,179,163,10,6,50,140,122,111,9,2,18,111,99,93,5,1,12,199,173,157,11,5,26
S01006846,474,357,319,28,10,117,100,46,41,5,0,54,147,113,98,12,3,34,84,75,66,5,4,9,45,41,38,1,2,4,98,82,76,5,1,16
S01006847,583,421,380,33,8,162,110,33,24,9,0,77,188,148,131,12,5,40,94,79,73,4,2,15,62,53,51,2,0,9,129,108,101,6,1,21
S01006848,787,513,394,97,22,274,181,64,44,15,5,117,175,118,97,15,6,57,97,71,49,17,5,26,68,59,51,7,1,9,266,201,153,43,5,65
S01006849,700,610,543,41,26,90,61,42,35,7,0,19,204,170,142,12,16,34,95,86,74,7,5,9,105,94,90,3,1,11,235,218,202,12,4,17
S01006850,767,628,561,41,26,139,142,85,68,12,5,57,262,213,186,15,12,49,112,107,100,3,4,5,96,86,78,6,2,10,155,137,129,5,3,18
S01006851,651,447,388,37,22,204,168,51,47,3,1,117,210,162,136,14,12,48,97,83,75,4,4,14,73,61,51,7,3,12,103,90,79,9,2,13
S01006852,492,355,284,55,16,137,83,33,20,11,2,50,125,92,73,14,5,33,76,68,53,10,5,8,49,41,36,4,1,8,159,121,102,16,3,38
S01006853,666,487,363,114,10,179,62,29,19,10,0,33,121,85,64,20,1,36,93,64,44,17,3,29,62,45,30,13,2,17,328,264,206,54,4,64
S01006854,707,456,371,65,20,251,140,54,41,8,5,86,169,119,89,24,6,50,82,55,48,6,1,27,75,57,50,6,1,18,241,171,143,21,7,70
S01006855,622,443,328,108,7,179,103,49,25,22,2,54,99,71,48,22,1,28,86,65,50,13,2,21,56,43,32,11,0,13,278,215,173,40,2,63
S01006856,518,387,301,75,11,131,84,38,30,7,1,46,110,83,64,15,4,27,77,63,46,16,1,14,45,39,29,9,1,6,202,164,132,28,4,38
S01006857,809,601,430,157,14,208,156,82,45,36,1,74,176,139,100,37,2,37,118,99,68,27,4,19,79,59,44,14,1,20,280,222,173,43,6,58
S01006858,518,362,251,104,7,156,82,35,15,20,0,47,102,77,52,24,1,25,67,54,39,14,1,13,42,31,24,7,0,11,225,165,121,39,5,60
S01006859,861,587,497,74,16,274,87,22,17,2,3,65,167,98,79,15,4,69,112,83,67,15,1,29,84,66,58,8,0,18,411,318,276,34,8,93
S01006860,465,306,267,28,11,159,146,62,54,7,1,84,119,87,73,5,9,32,55,46,41,4,1,9,47,40,32,8,0,7,98,71,67,4,0,27
S01006861,413,331,278,42,11,82,26,14,11,3,0,12,80,65,51,13,1,15,68,54,40,8,6,14,40,31,28,2,1,9,199,167,148,16,3,32
S01006862,575,378,313,53,12,197,135,50,35,12,3,85,133,100,89,5,6,33,81,60,52,6,2,21,57,40,36,4,0,17,169,128,101,26,1,41
S01006863,560,360,306,42,12,200,134,37,30,6,1,97,170,125,102,18,5,45,73,61,54,4,3,12,48,37,34,1,2,11,135,100,86,13,1,35
S01006864,311,241,210,20,11,70,39,20,18,2,0,19,89,69,52,10,7,20,48,36,30,2,4,12,45,41,39,2,0,4,90,75,71,4,0,15
S01006865,802,516,422,84,10,286,109,44,34,10,0,65,168,107,85,17,5,61,110,80,58,19,3,30,86,58,48,9,1,28,329,227,197,29,1,102
S01006866,455,259,222,33,4,196,49,15,13,1,1,34,97,58,49,8,1,39,64,43,37,5,1,21,40,25,25,0,0,15,205,118,98,19,1,87
S01006867,614,352,265,69,18,262,79,14,11,2,1,65,90,54,43,9,2,36,87,50,35,12,3,37,49,33,26,4,3,16,309,201,150,42,9,108
S01006868,709,455,395,52,8,254,189,75,66,9,0,114,166,115,102,11,2,51,90,65,57,6,2,25,57,40,36,2,2,17,207,160,134,24,2,47
S01006869,405,282,212,52,18,123,68,34,22,10,2,34,99,74,54,15,5,25,50,35,27,1,7,15,58,47,42,5,0,11,130,92,67,21,4,38
S01006870,397,258,194,51,13,139,69,21,16,4,1,48,64,48,32,9,7,16,59,47,38,8,1,12,37,27,25,2,0,10,168,115,83,28,4,53
S01006871,571,354,302,39,13,217,128,31,23,7,1,97,118,81,66,7,8,37,53,37,33,3,1,16,45,36,28,6,2,9,227,169,152,16,1,58
S01006872,537,381,288,88,5,156,77,38,20,18,0,39,103,74,55,16,3,29,61,44,37,6,1,17,43,36,31,5,0,7,253,189,145,43,1,64
S01006873,833,417,303,103,11,416,152,47,28,18,1,105,137,75,48,22,5,62,94,47,38,7,2,47,64,35,25,9,1,29,386,213,164,47,2,173
S01006874,490,343,264,73,6,147,90,37,20,15,2,53,85,65,47,16,2,20,73,53,44,8,1,20,56,47,39,8,0,9,186,141,114,26,1,45
S01006875,569,351,253,70,28,218,170,65,43,17,5,105,145,104,77,16,11,41,55,48,36,8,4,7,41,29,21,6,2,12,158,105,76,23,6,53
S01006876,795,562,424,123,15,233,172,67,45,20,2,105,199,149,108,38,3,50,113,99,77,17,5,14,72,58,42,16,0,14,239,189,152,32,5,50
S01006877,780,561,402,141,18,219,130,59,27,32,0,71,173,132,91,37,4,41,119,95,68,21,6,24,80,68,55,9,4,12,278,207,161,42,4,71
S01006878,587,402,253,133,16,185,163,70,35,29,6,93,152,124,78,44,2,28,74,57,35,17,5,17,39,32,22,10,0,7,159,119,83,33,3,40
S01006879,659,444,303,127,14,215,133,57,30,26,1,76,154,111,83,19,9,43,73,57,34,22,1,16,65,48,38,10,0,17,234,171,118,50,3,63
S01006880,470,361,298,57,6,109,45,19,14,5,0,26,109,82,67,13,2,27,69,61,50,8,3,8,62,51,40,10,1,11,185,148,127,21,0,37
S01006881,461,334,252,76,6,127,85,43,29,14,0,42,124,87,64,21,2,37,51,44,34,10,0,7,39,37,32,3,2,2,162,123,93,28,2,39
S01006882,336,189,164,16,9,147,127,38,29,8,1,89,99,67,59,3,5,32,39,30,28,1,1,9,17,16,15,0,1,1,54,38,33,4,1,16
S01006883,381,251,210,31,10,130,88,28,21,5,2,60,92,68,58,6,4,24,63,51,41,9,1,12,31,27,25,1,1,4,107,77,65,10,2,30
S01006884,727,471,406,55,10,256,169,45,35,9,1,124,175,125,115,6,4,50,114,88,77,8,3,26,75,64,53,9,2,11,194,149,126,23,0,45
S01006885,448,275,211,63,1,173,86,22,11,11,0,64,103,73,61,12,0,30,60,43,33,10,0,17,31,24,19,4,1,7,168,113,87,26,0,55
S01006886,617,430,322,89,19,187,112,56,35,18,3,56,115,82,58,19,5,33,80,58,41,12,5,22,47,35,30,4,1,12,263,199,158,36,5,64
S01006887,434,328,259,57,12,106,60,23,16,6,1,37,102,83,62,16,5,19,63,49,43,5,1,14,44,36,27,8,1,8,165,137,111,22,4,28
S01006888,624,456,336,104,16,168,91,41,27,12,2,50,152,108,80,26,2,44,90,71,53,17,1,19,58,43,29,11,3,15,233,193,147,38,8,40
S01006889,659,443,383,31,29,216,210,117,104,7,6,93,212,152,132,9,11,60,79,59,47,6,6,20,49,36,31,3,2,13,109,79,69,6,4,30
S01006890,521,380,319,42,19,141,65,25,18,4,3,40,143,97,79,11,7,46,83,70,58,8,4,13,63,53,45,5,3,10,167,135,119,14,2,32
S01006891,797,532,469,51,12,265,162,55,46,7,2,107,216,157,141,11,5,59,100,82,73,8,1,18,86,71,65,5,1,15,233,167,144,20,3,66
S01006892,493,341,304,25,12,152,117,38,32,5,1,79,168,128,114,9,5,40,75,64,58,4,2,11,41,38,35,1,2,3,92,73,65,6,2,19
S01006893,417,286,245,28,13,131,103,55,47,5,3,48,132,96,84,7,5,36,70,52,43,7,2,18,28,23,21,1,1,5,84,60,50,8,2,24
S01006894,820,492,438,40,14,328,247,73,63,7,3,174,205,145,126,15,4,60,125,97,87,7,3,28,61,51,46,3,2,10,182,126,116,8,2,56
S01006895,450,326,290,23,13,124,115,46,37,6,3,69,138,107,96,6,5,31,44,41,39,1,1,3,66,59,54,3,2,7,87,73,64,7,2,14
S01006896,681,460,417,31,12,221,161,53,47,3,3,108,179,144,125,13,6,35,106,86,81,4,1,20,75,61,58,2,1,14,160,116,106,9,1,44
S01006897,604,444,394,36,14,160,95,41,35,5,1,54,162,127,113,8,6,35,106,88,79,5,4,18,79,64,59,5,0,15,162,124,108,13,3,38
S01006898,613,443,396,34,13,170,152,66,59,6,1,86,173,136,118,13,5,37,84,72,67,1,4,12,48,44,38,5,1,4,156,125,114,9,2,31
S01006899,490,397,358,30,9,93,77,34,28,4,2,43,118,98,92,3,3,20,93,84,78,4,2,9,51,47,42,5,0,4,151,134,118,14,2,17
S01006900,504,379,353,20,6,125,107,38,37,1,0,69,152,124,114,6,4,28,77,64,58,5,1,13,59,54,49,4,1,5,109,99,95,4,0,10
S01006901,517,364,331,17,16,153,166,74,62,8,4,92,152,125,117,3,5,27,59,49,45,1,3,10,46,39,35,3,1,7,94,77,72,2,3,17
S01006902,540,388,348,27,13,152,143,72,63,5,4,71,150,121,109,8,4,29,79,64,59,2,3,15,41,36,33,3,0,5,127,95,84,9,2,32
S01006903,672,448,393,36,19,224,212,72,60,7,5,140,184,148,126,11,11,36,90,80,74,6,0,10,54,48,46,1,1,6,132,100,87,11,2,32
S01006904,604,379,330,34,15,225,153,34,27,5,2,119,174,132,114,13,5,42,78,58,49,5,4,20,48,42,41,1,0,6,151,113,99,10,4,38
S01006905,763,451,386,55,10,312,187,53,44,6,3,134,186,117,100,15,2,69,108,85,73,11,1,23,56,45,37,7,1,11,226,151,132,16,3,75
S01006906,732,412,355,35,22,320,296,91,80,6,5,205,205,150,127,12,11,55,91,66,58,5,3,25,51,44,40,4,0,7,89,61,50,8,3,28
S01006907,534,386,334,41,11,148,140,75,62,8,5,65,122,102,84,15,3,20,81,59,52,5,2,22,62,49,47,1,1,13,129,101,89,12,0,28
S01006908,713,471,417,32,22,242,189,61,50,4,7,128,185,133,121,5,7,52,83,69,65,1,3,14,97,83,77,4,2,14,159,125,104,18,3,34
S01006909,578,452,389,54,9,126,53,18,14,3,1,35,141,117,106,10,1,24,90,72,62,5,5,18,69,62,54,8,0,7,225,183,153,28,2,42
S01006910,701,541,430,99,12,160,84,45,29,15,1,39,151,111,83,24,4,40,96,77,59,17,1,19,74,60,52,8,0,14,296,248,207,35,6,48
S01006911,451,397,353,35,9,54,30,20,15,4,1,10,93,76,66,7,3,17,70,58,54,4,0,12,56,51,43,5,3,5,202,192,175,15,2,10
S01006912,378,285,214,59,12,93,53,26,15,10,1,27,101,82,59,18,5,19,42,28,19,7,2,14,39,34,29,5,0,5,143,115,92,19,4,28
S01006913,385,328,277,45,6,57,34,25,20,4,1,9,82,69,60,8,1,13,63,51,45,6,0,12,57,52,40,10,2,5,149,131,112,17,2,18
S01006914,590,466,370,88,8,124,68,37,21,14,2,31,145,115,86,25,4,30,97,81,70,11,0,16,61,48,40,7,1,13,219,185,153,31,1,34
S01006915,640,484,395,81,8,156,105,55,37,16,2,50,149,119,98,19,2,30,115,92,78,11,3,23,66,56,49,7,0,10,205,162,133,28,1,43
S01006916,397,307,272,25,10,90,47,21,19,2,0,26,105,82,70,8,4,23,58,48,46,2,0,10,56,49,44,1,4,7,131,107,93,12,2,24
S01006917,643,564,487,65,12,79,37,21,15,3,3,16,155,127,104,21,2,28,105,93,78,13,2,12,85,75,64,8,3,10,261,248,226,20,2,13
S01006918,376,269,231,30,8,107,61,21,18,1,2,40,103,71,56,11,4,32,49,35,28,5,2,14,30,27,24,3,0,3,133,115,105,10,0,18
S01006919,418,265,229,32,4,153,79,19,15,4,0,60,100,71,60,9,2,29,62,49,45,2,2,13,34,28,21,7,0,6,143,98,88,10,0,45
S01006920,409,272,240,26,6,137,95,28,19,4,5,67,99,70,60,9,1,29,63,50,45,5,0,13,33,29,26,3,0,4,119,95,90,5,0,24
S01006921,560,474,431,37,6,86,56,33,29,4,0,23,137,114,102,7,5,23,86,75,70,5,0,11,60,52,44,8,0,8,221,200,186,13,1,21
S01006922,407,278,225,46,7,129,91,39,29,9,1,52,104,70,57,13,0,34,54,38,33,4,1,16,35,34,27,6,1,1,123,97,79,14,4,26
S01006923,667,414,326,74,14,253,170,58,39,19,0,112,141,90,75,8,7,51,90,76,57,16,3,14,64,46,38,7,1,18,202,144,117,24,3,58
S01006924,439,348,257,83,8,91,49,21,11,10,0,28,102,78,49,27,2,24,51,44,36,5,3,7,35,32,24,8,0,3,202,173,137,33,3,29
S01006925,410,283,253,24,6,127,75,25,20,5,0,50,118,94,81,8,5,24,58,49,47,2,0,9,38,28,25,3,0,10,121,87,80,6,1,34
S01006926,538,444,387,40,17,94,50,18,14,3,1,32,143,131,109,15,7,12,80,64,56,5,3,16,65,61,57,3,1,4,200,170,151,14,5,30
S01006927,707,633,563,51,19,74,32,18,12,3,3,14,153,128,106,14,8,25,89,84,73,10,1,5,121,111,99,11,1,10,312,292,273,13,6,20
S01006928,825,637,553,71,13,188,145,63,48,13,2,82,227,182,160,16,6,45,127,106,93,12,1,21,103,92,81,10,1,11,223,194,171,20,3,29
S01006929,647,480,410,58,12,167,29,7,5,2,0,22,111,65,56,9,0,46,104,87,77,5,5,17,70,54,43,9,2,16,333,267,229,33,5,66
S01006930,762,546,462,67,17,216,75,19,14,5,0,56,146,99,87,9,3,47,145,116,100,14,2,29,95,82,72,7,3,13,301,230,189,32,9,71
S01006931,318,229,177,46,6,89,55,26,14,11,1,29,63,43,34,7,2,20,50,34,27,6,1,16,20,19,16,3,0,1,130,107,86,19,2,23
S01006932,433,354,297,42,15,79,26,12,7,4,1,14,119,91,76,12,3,28,67,49,38,5,6,18,55,48,40,7,1,7,166,154,136,14,4,12
S01006933,481,394,360,28,6,87,32,19,14,4,1,13,110,87,82,5,0,23,95,83,74,7,2,12,59,48,46,2,0,11,185,157,144,10,3,28
S01006934,527,324,252,64,8,203,149,35,28,6,1,114,115,78,54,21,3,37,65,46,37,7,2,19,47,38,32,6,0,9,151,127,101,24,2,24
S01006935,598,402,352,42,8,196,78,25,21,3,1,53,122,75,67,7,1,47,98,81,71,8,2,17,67,48,44,3,1,19,233,173,149,21,3,60
S01006936,521,358,311,32,15,163,81,31,21,8,2,50,121,80,69,8,3,41,86,64,53,6,5,22,71,56,55,0,1,15,162,127,113,10,4,35
S01006937,613,459,400,42,17,154,64,25,20,5,0,39,139,102,90,8,4,37,110,92,80,8,4,18,76,67,59,6,2,9,224,173,151,15,7,51
S01006938,456,311,276,26,9,145,96,28,24,4,0,68,98,70,60,9,1,28,81,62,52,5,5,19,38,34,32,1,1,4,143,117,108,7,2,26
S01006939,512,372,335,30,7,140,56,27,23,4,0,29,110,80,70,8,2,30,91,77,72,4,1,14,60,49,45,3,1,11,195,139,125,11,3,56
S01006940,787,568,494,61,13,219,88,39,31,8,0,49,182,123,108,11,4,59,125,91,82,6,3,34,79,65,58,6,1,14,313,250,215,30,5,63
S01006941,490,348,305,32,11,142,78,32,27,5,0,46,121,88,76,9,3,33,84,69,60,7,2,15,53,42,34,5,3,11,154,117,108,6,3,37
S01006942,842,618,531,77,10,224,107,28,23,3,2,79,190,144,117,23,4,46,141,113,105,8,0,28,110,90,76,12,2,20,294,243,210,31,2,51
S01006943,442,374,326,34,14,68,13,9,8,1,0,4,65,48,38,7,3,17,80,67,56,6,5,13,45,39,35,2,2,6,239,211,189,18,4,28
S01006944,621,546,488,49,9,75,30,18,12,4,2,12,149,130,122,5,3,19,113,97,91,5,1,16,88,81,68,11,2,7,241,220,195,24,1,21
S01006945,427,307,261,38,8,120,57,22,17,3,2,35,91,59,52,6,1,32,64,53,41,9,3,11,53,46,36,8,2,7,162,127,115,12,0,35
S01006946,650,505,437,56,12,145,90,40,33,5,2,50,157,125,107,13,5,32,101,81,69,11,1,20,89,74,62,11,1,15,213,185,166,16,3,28
S01006947,621,544,491,39,14,77,71,40,34,3,3,31,162,144,127,10,7,18,93,83,78,5,0,10,91,86,79,4,3,5,204,191,173,17,1,13
S01006948,732,490,403,79,8,242,154,61,47,14,0,93,156,102,86,13,3,54,101,83,68,14,1,18,80,68,62,5,1,12,241,176,140,33,3,65
S01006949,505,386,310,68,8,119,67,34,20,13,1,33,100,72,55,14,3,28,70,53,43,9,1,17,60,48,36,12,0,12,208,179,156,20,3,29
S01006950,382,336,307,24,5,46,20,10,9,1,0,10,104,91,80,9,2,13,55,51,45,4,2,4,60,54,46,7,1,6,143,130,127,3,0,13
S01006951,384,303,272,20,11,81,70,27,24,3,0,43,99,82,72,7,3,17,72,67,61,5,1,5,37,32,27,1,4,5,106,95,88,4,3,11
S01006952,712,489,397,78,14,223,153,67,50,16,1,86,188,133,100,25,8,55,100,72,64,8,0,28,75,66,59,6,1,9,196,151,124,23,4,45
S01006953,629,495,418,65,12,134,92,42,28,12,2,50,143,112,89,18,5,31,106,94,82,11,1,12,77,64,57,5,2,13,211,183,162,19,2,28
S01006954,665,506,431,63,12,159,119,46,40,6,0,73,170,138,114,21,3,32,101,87,74,9,4,14,66,59,56,3,0,7,209,176,147,24,5,33
S01006955,484,360,324,27,9,124,88,32,29,1,2,56,138,101,89,9,3,37,85,77,68,7,2,8,59,53,48,4,1,6,114,97,90,6,1,17
S01006956,815,675,596,58,21,140,75,44,37,6,1,31,189,150,121,20,9,39,123,104,93,7,4,19,124,110,100,6,4,14,304,267,245,19,3,37
S01006957,847,649,515,112,22,198,132,58,36,22,0,74,197,142,108,26,8,55,143,117,95,19,3,26,70,60,47,9,4,10,305,272,229,36,7,33
S01006958,790,458,395,52,11,332,184,47,32,14,1,137,177,102,86,11,5,75,106,82,72,9,1,24,92,75,70,3,2,17,231,152,135,15,2,79
S01006959,625,339,289,33,17,286,215,56,45,7,4,159,137,87,74,8,5,50,88,67,57,6,4,21,54,42,38,3,1,12,131,87,75,9,3,44
S01006960,677,571,492,64,15,106,47,27,17,8,2,20,172,143,122,17,4,29,112,98,85,8,5,14,94,77,71,5,1,17,252,226,197,26,3,26
S01006961,673,575,511,53,11,98,41,23,18,5,0,18,155,121,104,14,3,34,115,99,88,9,2,16,102,94,82,9,3,8,260,238,219,16,3,22
S01006962,778,502,450,35,17,276,206,61,57,4,0,145,195,145,126,13,6,50,117,95,88,3,4,22,73,60,54,3,3,13,187,141,125,12,4,46
S01006963,572,402,347,32,23,170,95,44,34,7,3,51,160,115,91,13,11,45,110,82,73,5,4,28,55,48,43,2,3,7,152,113,106,5,2,39
S01006964,638,499,448,37,14,139,110,58,51,6,1,52,184,152,138,10,4,32,122,108,97,10,1,14,62,54,47,4,3,8,160,127,115,7,5,33
S01006965,434,271,235,27,9,163,93,21,15,5,1,72,107,77,70,5,2,30,56,43,35,7,1,13,39,29,26,2,1,10,139,101,89,8,4,38
S01006966,489,347,302,22,23,142,126,55,50,1,4,71,149,115,96,7,12,34,78,66,58,6,2,12,46,41,36,2,3,5,90,70,62,6,2,20
S01006967,507,395,352,34,9,112,77,34,30,2,2,43,143,118,105,10,3,25,103,91,81,8,2,12,47,38,33,5,0,9,137,114,103,9,2,23
S01006968,434,312,283,25,4,122,122,57,55,2,0,65,122,94,83,9,2,28,62,54,50,3,1,8,40,35,30,5,0,5,88,72,65,6,1,16
S01006969,826,532,464,44,24,294,232,61,54,5,2,171,217,165,134,20,11,52,122,106,98,3,5,16,81,69,62,5,2,12,174,131,116,11,4,43
S01006970,568,422,387,28,7,146,62,18,15,3,0,44,139,103,99,3,1,36,109,88,82,3,3,21,77,64,59,4,1,13,181,149,132,15,2,32
S01006971,453,269,236,20,13,184,149,45,39,3,3,104,127,85,74,5,6,42,60,53,48,3,2,7,31,28,23,4,1,3,86,58,52,5,1,28
S01006972,422,322,245,65,12,100,72,42,29,10,3,30,107,88,63,22,3,19,58,43,38,3,2,15,38,32,24,8,0,6,147,117,91,22,4,30
S01006973,461,318,271,37,10,143,92,38,27,10,1,54,88,62,53,6,3,26,67,62,57,4,1,5,43,34,26,7,1,9,171,122,108,10,4,49
S01006974,814,621,514,84,23,193,91,40,29,9,2,51,165,125,106,13,6,40,121,101,86,12,3,20,83,71,63,5,3,12,354,284,230,45,9,70
S01006975,777,607,475,115,17,170,123,64,41,21,2,59,203,170,121,42,7,33,111,92,75,13,4,19,90,79,66,13,0,11,250,202,172,26,4,48
S01006976,375,285,216,63,6,90,69,41,28,11,2,28,84,64,49,13,2,20,54,41,33,8,0,13,45,38,27,9,2,7,123,101,79,22,0,22
S01006977,652,504,381,108,15,148,109,65,38,26,1,44,178,141,105,30,6,37,106,83,62,18,3,23,67,59,47,11,1,8,192,156,129,23,4,36
S01006978,718,492,399,77,16,226,154,68,51,15,2,86,159,103,79,19,5,56,114,90,78,6,6,24,61,50,40,9,1,11,230,181,151,28,2,49
S01006979,699,465,361,84,20,234,165,58,40,14,4,107,173,125,97,23,5,48,107,82,67,12,3,25,53,44,35,8,1,9,201,156,122,27,7,45
S01006980,687,503,409,76,18,184,115,55,43,12,0,60,162,118,94,18,6,44,114,87,70,13,4,27,74,64,54,7,3,10,222,179,148,26,5,43
S01006981,649,501,412,76,13,148,123,68,58,7,3,55,144,111,79,27,5,33,89,75,64,9,2,14,65,54,42,12,0,11,228,193,169,21,3,35
S01006982,683,527,449,61,17,156,131,61,50,8,3,70,165,125,109,11,5,40,115,101,85,13,3,14,84,79,68,9,2,5,188,161,137,20,4,27
S01006983,581,442,362,65,15,139,90,44,31,11,2,46,161,124,100,20,4,37,89,70,60,8,2,19,74,62,50,9,3,12,167,142,121,17,4,25
S01006984,566,436,338,89,9,130,74,27,13,14,0,47,117,83,64,16,3,34,77,64,52,12,0,13,68,61,50,10,1,7,230,201,159,37,5,29
S01006985,839,574,477,79,18,265,206,81,64,13,4,125,222,165,136,21,8,57,127,104,88,14,2,23,77,63,53,9,1,14,207,161,136,22,3,46
S01006986,514,379,332,32,15,135,91,36,27,7,2,55,131,92,81,7,4,39,78,65,62,1,2,13,56,50,43,3,4,6,158,136,119,14,3,22
S01006987,546,355,309,29,17,191,130,52,47,4,1,78,129,98,79,7,12,31,61,44,43,1,0,17,54,44,38,3,3,10,172,117,102,14,1,55
S01006988,455,362,284,63,15,93,73,39,27,8,4,34,101,84,69,11,4,17,74,58,48,8,2,16,51,44,30,10,4,7,156,137,110,26,1,19
S01006989,794,605,478,113,14,189,103,62,40,22,0,41,185,135,103,25,7,50,120,103,86,14,3,17,73,57,46,9,2,16,313,248,203,43,2,65
S01006990,657,540,439,83,18,117,49,22,11,7,4,27,158,128,103,21,4,30,107,86,75,10,1,21,71,70,54,14,2,1,272,234,196,31,7,38
S01006991,371,212,174,32,6,159,125,41,31,9,1,84,106,72,60,9,3,34,35,22,19,3,0,13,26,20,19,1,0,6,79,57,45,10,2,22
S01006992,501,368,276,83,9,133,91,52,29,23,0,39,111,81,61,18,2,30,60,39,31,5,3,21,60,44,33,11,0,16,179,152,122,26,4,27
S01006993,433,319,240,75,4,114,102,62,39,22,1,40,106,87,65,19,3,19,77,50,40,10,0,27,39,36,28,8,0,3,109,84,68,16,0,25
S01006994,495,361,293,58,10,134,93,43,33,10,0,50,126,102,80,16,6,24,71,56,47,7,2,15,48,39,33,6,0,9,157,121,100,19,2,36
S01006995,673,526,392,121,13,147,136,86,56,29,1,50,170,126,89,29,8,44,82,76,65,11,0,6,72,60,44,15,1,12,213,178,138,37,3,35
S01006996,604,442,364,64,14,162,152,65,50,10,5,87,185,151,125,20,6,34,78,64,57,6,1,14,56,51,43,8,0,5,133,111,89,20,2,22
S01006997,603,477,377,89,11,126,91,40,25,15,0,51,125,104,79,20,5,21,104,86,69,15,2,18,60,52,42,7,3,8,223,195,162,32,1,28
S01006998,899,670,528,126,16,229,172,79,47,32,0,93,212,156,121,29,6,56,128,109,91,13,5,19,89,79,60,16,3,10,298,247,209,36,2,51
S01006999,724,522,370,143,9,202,182,92,45,47,0,90,198,153,114,37,2,45,101,79,57,18,4,22,67,53,42,11,0,14,176,145,112,30,3,31
S01007000,766,526,443,62,21,240,189,65,50,9,6,124,201,159,129,19,11,42,96,79,68,11,0,17,73,60,54,5,1,13,207,163,142,18,3,44
S01007001,775,485,394,72,19,290,170,49,34,8,7,121,213,144,118,19,7,69,98,76,62,10,4,22,69,56,51,5,0,13,225,160,129,30,1,65
S01007002,450,315,248,55,12,135,110,55,36,18,1,55,123,83,58,18,7,40,48,38,34,2,2,10,42,34,29,5,0,8,127,105,91,12,2,22
S01007003,425,317,217,91,9,108,100,54,21,32,1,46,119,99,68,28,3,20,56,41,33,8,0,15,26,22,15,6,1,4,124,101,80,17,4,23
S01007004,588,419,320,96,3,169,119,63,31,32,0,56,165,118,95,23,0,47,70,50,42,7,1,20,57,50,36,12,2,7,177,138,116,22,0,39
S01007005,729,537,404,114,19,192,119,56,35,16,5,63,188,149,109,31,9,39,105,85,61,23,1,20,57,46,40,5,1,11,260,201,159,39,3,59
S01007006,735,483,363,93,27,252,197,86,58,22,6,111,203,150,119,24,7,53,90,66,42,17,7,24,60,47,41,6,0,13,185,134,103,24,7,51
S01007007,672,478,312,142,24,194,154,81,50,29,2,73,191,150,104,36,10,41,86,67,42,20,5,19,53,43,30,13,0,10,188,137,86,44,7,51
S01007008,870,529,455,56,18,341,290,88,76,9,3,202,240,183,155,20,8,57,118,88,77,9,2,30,69,59,49,8,2,10,153,111,98,10,3,42
S01007009,874,547,456,63,28,327,277,98,73,17,8,179,241,180,154,12,14,61,97,82,68,12,2,15,62,53,47,5,1,9,197,134,114,17,3,63
S01007010,720,381,306,51,24,339,222,48,39,7,2,174,151,107,80,15,12,44,94,73,62,5,6,21,50,36,32,2,2,14,203,117,93,22,2,86
S01007011,730,447,363,45,39,283,271,79,59,10,10,192,193,155,121,14,20,38,97,89,76,11,2,8,68,57,50,5,2,11,101,67,57,5,5,34
S01007012,571,341,292,14,35,230,250,101,89,4,8,149,178,133,108,9,16,45,54,44,40,0,4,10,49,37,32,1,4,12,40,26,23,0,3,14
S01007013,458,327,222,98,7,131,123,67,39,28,0,56,125,97,71,23,3,28,65,50,31,18,1,15,41,36,19,15,2,5,104,77,62,14,1,27
S01007014,806,604,466,118,20,202,158,81,52,27,2,77,239,182,143,28,11,57,112,90,73,16,1,22,92,78,61,14,3,14,205,173,137,33,3,32
S01007015,505,369,255,106,8,136,108,54,27,26,1,54,147,118,85,31,2,29,73,56,41,14,1,17,57,48,37,10,1,9,120,93,65,25,3,27
S01007016,478,368,275,79,14,110,84,55,36,17,2,29,159,128,100,24,4,31,71,57,39,15,3,14,44,35,25,8,2,9,120,93,75,15,3,27
S01007017,829,525,449,49,27,304,314,118,105,11,2,196,257,200,172,19,9,57,90,71,58,7,6,19,53,46,39,3,4,7,115,90,75,9,6,25
S01007018,793,503,431,54,18,290,237,78,67,7,4,159,248,185,162,15,8,63,98,76,64,9,3,22,74,59,50,7,2,15,136,105,88,16,1,31
S01007019,574,352,300,33,19,222,214,86,72,10,4,128,164,129,111,10,8,35,59,38,29,5,4,21,44,36,34,0,2,8,93,63,54,8,1,30
S01007020,675,409,340,48,21,266,209,64,52,8,4,145,175,119,96,15,8,56,76,53,44,4,5,23,78,71,62,8,1,7,137,102,86,13,3,35
S01007021,774,456,400,40,16,318,286,88,74,10,4,198,209,157,136,14,7,52,96,76,66,8,2,20,69,63,59,2,2,6,114,72,65,6,1,42
S01007022,391,231,186,32,13,160,115,40,32,5,3,75,115,83,62,13,8,32,34,25,20,5,0,9,46,34,27,5,2,12,81,49,45,4,0,32
S01007023,394,246,161,71,14,148,117,37,21,13,3,80,116,83,55,25,3,33,53,45,36,6,3,8,38,32,18,12,2,6,70,49,31,15,3,21
S01007024,877,540,376,145,19,337,270,107,64,40,3,163,215,158,106,42,10,57,109,78,56,20,2,31,78,64,51,11,2,14,205,133,99,32,2,72
S01007025,708,425,350,52,23,283,270,99,88,6,5,171,197,144,122,14,8,53,87,70,56,10,4,17,47,38,24,10,4,9,107,74,60,12,2,33
S01007026,774,407,327,61,19,367,292,86,68,13,5,206,168,114,92,17,5,54,97,66,54,10,2,31,64,55,49,3,3,9,153,86,64,18,4,67
S01007027,880,528,418,84,26,352,298,97,73,17,7,201,188,146,111,28,7,42,94,68,57,6,5,26,93,72,61,8,3,21,207,145,116,25,4,62
S01007028,614,404,282,108,14,210,155,56,38,16,2,99,161,118,78,33,7,43,89,68,50,16,2,21,53,46,31,13,2,7,156,116,85,30,1,40
S01007029,458,310,192,104,14,148,109,51,19,31,1,58,166,122,78,38,6,44,49,38,27,10,1,11,35,31,20,7,4,4,99,68,48,18,2,31
S01007030,663,417,340,58,19,246,226,95,73,19,3,131,218,162,127,25,10,56,68,52,45,4,3,16,46,36,31,4,1,10,105,72,64,6,2,33
S01007031,517,317,243,53,21,200,164,67,48,14,5,97,148,106,80,18,8,42,65,46,35,7,4,19,33,25,21,3,1,8,107,73,59,11,3,34
S01007032,833,488,383,57,48,345,271,81,60,7,14,190,214,157,121,17,19,57,106,73,60,7,6,33,55,46,33,10,3,9,187,131,109,16,6,56
S01007033,603,381,342,15,24,222,193,88,76,4,8,105,189,135,118,5,12,54,86,64,58,4,2,22,45,35,34,1,0,10,90,59,56,1,2,31
S01007034,494,324,271,32,21,170,122,47,33,7,7,75,145,104,89,9,6,41,63,47,37,6,4,16,53,44,38,4,2,9,111,82,74,6,2,29
S01007035,643,374,317,33,24,269,265,102,86,8,8,163,191,134,111,10,13,57,58,45,40,4,1,13,43,34,28,5,1,9,86,59,52,6,1,27
S01007036,800,452,364,74,14,348,260,85,69,13,3,175,187,130,99,25,6,57,88,57,50,6,1,31,58,43,39,2,2,15,207,137,107,28,2,70
S01007037,830,528,455,49,24,302,309,122,107,9,6,187,248,198,165,19,14,50,103,77,68,8,1,26,54,41,34,7,0,13,116,90,81,6,3,26
S01007038,613,418,340,54,24,195,172,73,56,15,2,99,184,142,107,22,13,42,77,62,54,4,4,15,55,48,43,4,1,7,125,93,80,9,4,32
S01007039,685,435,360,42,33,250,223,85,66,12,7,138,217,162,131,13,18,55,79,59,47,10,2,20,68,57,53,2,2,11,98,72,63,5,4,26
S01007040,537,324,269,31,24,213,192,76,67,7,2,116,166,124,98,10,16,42,67,49,39,7,3,18,30,19,16,3,0,11,82,56,49,4,3,26
S01007041,628,406,324,50,32,222,196,73,49,15,9,123,184,137,105,15,17,47,95,74,65,9,0,21,51,45,40,4,1,6,102,77,65,7,5,25
S01007042,598,374,287,60,27,224,189,69,53,11,5,120,183,138,101,22,15,45,68,53,41,11,1,15,46,35,30,4,1,11,112,79,62,12,5,33
S01007043,835,600,425,160,15,235,234,118,77,39,2,116,192,146,108,32,6,46,111,87,56,28,3,24,80,71,57,12,2,9,218,178,127,49,2,40
S01007044,581,321,229,82,10,260,179,49,32,16,1,130,159,108,70,34,4,51,70,45,36,6,3,25,45,28,21,7,0,17,128,91,70,19,2,37
S01007045,683,454,284,144,26,229,209,100,51,43,6,109,176,135,76,45,14,41,94,67,45,19,3,27,59,49,36,12,1,10,145,103,76,25,2,42
S01007046,509,328,267,58,3,181,170,65,43,21,1,105,141,111,90,20,1,30,60,45,43,2,0,15,47,38,32,5,1,9,91,69,59,10,0,22
S01007047,550,377,265,97,15,173,167,91,50,37,4,76,153,111,83,24,4,42,49,39,26,11,2,10,51,38,32,4,2,13,130,98,74,21,3,32
S01007048,775,532,380,128,24,243,232,113,69,37,7,119,212,149,106,35,8,63,102,82,59,18,5,20,66,52,43,9,0,14,163,136,103,29,4,27
S01007049,767,493,413,52,28,274,295,129,100,17,12,166,219,160,139,13,8,59,87,70,63,5,2,17,70,60,49,9,2,10,96,74,62,8,4,22
S01007050,547,334,258,61,15,213,171,50,36,13,1,121,160,114,85,24,5,46,71,58,44,9,5,13,39,31,27,3,1,8,106,81,66,12,3,25
S01007051,614,435,376,47,12,179,167,56,43,13,0,111,169,146,124,16,6,23,95,82,77,5,0,13,61,53,48,3,2,8,122,98,84,10,4,24
S01007052,473,320,255,50,15,153,142,68,50,14,4,74,120,91,76,13,2,29,74,58,45,10,3,16,54,43,36,6,1,11,83,60,48,7,5,23
S01007053,402,278,202,63,13,124,79,37,19,17,1,42,95,65,48,12,5,30,68,54,40,10,4,14,52,39,27,11,1,13,108,83,68,13,2,25
S01007054,803,506,430,49,27,297,280,101,80,12,9,179,212,155,128,18,9,57,116,93,87,4,2,23,73,57,52,3,2,16,122,100,83,12,5,22
S01007055,422,321,219,91,11,101,84,50,25,24,1,34,128,95,64,27,4,33,62,51,43,6,2,11,51,44,26,16,2,7,97,81,61,18,2,16
S01007056,528,378,251,107,20,150,137,55,27,24,4,82,129,104,67,28,9,25,90,80,57,17,6,10,45,37,28,8,1,8,127,102,72,30,0,25
S01007057,459,249,212,25,12,210,182,49,40,5,4,133,92,60,49,7,4,32,65,53,46,4,3,12,43,34,29,4,1,9,77,53,48,5,0,24
S01007058,502,269,235,23,11,233,218,57,45,10,2,161,116,93,82,4,7,23,72,56,49,5,2,16,41,33,32,1,0,8,55,30,27,3,0,25
S01007059,813,510,432,56,22,303,243,77,66,8,3,166,230,157,131,15,11,73,109,83,69,12,2,26,88,75,66,6,3,13,143,118,100,15,3,25
S01007060,485,316,257,24,35,169,172,72,57,5,10,100,164,121,95,11,15,43,59,47,44,1,2,12,39,34,26,4,4,5,51,42,35,3,4,9
S01007061,739,576,449,109,18,163,121,63,34,25,4,58,152,128,97,26,5,24,120,98,79,18,1,22,88,77,66,8,3,11,258,210,173,32,5,48
S01007062,565,423,305,104,14,142,103,51,25,22,4,52,136,98,69,27,2,38,77,62,40,19,3,15,54,46,30,14,2,8,195,166,141,22,3,29
S01007063,549,361,305,46,10,188,162,62,54,8,0,100,138,101,79,18,4,37,81,68,57,9,2,13,65,53,47,4,2,12,103,77,68,7,2,26
S01007064,528,392,279,101,12,136,121,61,39,16,6,60,135,110,73,33,4,25,74,56,44,12,0,18,48,43,30,12,1,5,150,122,93,28,1,28
S01007065,474,325,269,50,6,149,95,44,34,9,1,51,103,71,60,10,1,32,62,48,43,5,0,14,58,44,37,6,1,14,156,118,95,20,3,38
S01007066,537,386,291,82,13,151,112,57,33,20,4,55,141,98,74,20,4,43,88,68,52,15,1,20,52,45,40,4,1,7,144,118,92,23,3,26
S01007067,489,339,294,30,15,150,92,34,29,4,1,58,130,96,88,4,4,34,95,76,65,10,1,19,64,53,44,4,5,11,108,80,68,8,4,28
S01007068,625,378,301,59,18,247,192,62,50,9,3,130,150,111,86,16,9,39,77,57,47,7,3,20,65,46,39,6,1,19,141,102,79,21,2,39
S01007069,644,435,364,47,24,209,172,74,60,12,2,98,218,170,136,18,16,48,81,59,50,4,5,22,74,58,54,3,1,16,99,74,64,10,0,25
S01007070,429,288,239,26,23,141,144,66,55,6,5,78,125,96,76,8,12,29,52,44,35,5,4,8,47,40,33,5,2,7,61,42,40,2,0,19
S01007071,688,497,438,44,15,191,162,75,62,7,6,87,218,169,152,9,8,49,95,73,64,9,0,22,63,54,48,6,0,9,150,126,112,13,1,24
S01007072,513,399,338,44,17,114,128,69,58,8,3,59,137,110,88,17,5,27,104,93,79,9,5,11,64,55,47,6,2,9,80,72,66,4,2,8
S01007073,903,524,447,57,20,379,276,95,77,15,3,181,284,176,147,20,9,108,115,84,77,4,3,31,90,70,65,5,0,20,138,99,81,13,5,39
S01007074,549,393,333,30,30,156,184,96,80,8,8,88,179,139,109,13,17,40,54,48,43,3,2,6,56,49,45,3,1,7,76,61,56,3,2,15
S01007075,585,398,371,8,19,187,206,89,80,2,7,117,196,159,150,1,8,37,78,65,61,2,2,13,44,37,34,2,1,7,61,48,46,1,1,13
S01007076,599,441,385,31,25,158,187,96,81,9,6,91,200,168,147,12,9,32,70,63,57,2,4,7,67,59,52,4,3,8,75,55,48,4,3,20
S01007077,594,379,337,21,21,215,242,99,87,7,5,143,161,123,108,3,12,38,70,60,54,6,0,10,40,32,29,0,3,8,81,65,59,5,1,16
S01007078,717,436,361,34,41,281,277,115,92,12,11,162,188,140,109,14,17,48,85,61,55,3,3,24,67,47,40,1,6,20,100,73,65,4,4,27
S01007079,858,488,413,38,37,370,330,99,82,7,10,231,233,169,142,9,18,64,99,76,67,6,3,23,66,52,45,4,3,14,130,92,77,12,3,38
S01007080,669,388,330,22,36,281,270,94,76,5,13,176,181,127,105,6,16,54,74,53,47,2,4,21,67,58,50,6,2,9,77,56,52,3,1,21
S01007081,734,500,425,40,35,234,290,159,133,15,11,131,224,170,143,11,16,54,64,48,43,2,3,16,50,41,38,3,0,9,106,82,68,9,5,24
S01007082,439,300,251,26,23,139,171,90,71,7,12,81,124,95,78,10,7,29,42,37,29,5,3,5,47,33,30,2,1,14,55,45,43,2,0,10
S01007083,794,429,367,27,35,365,375,126,107,10,9,249,206,151,124,7,20,55,59,44,39,2,3,15,74,54,50,3,1,20,80,54,47,5,2,26
S01007084,557,302,260,33,9,255,213,57,41,14,2,156,127,93,83,7,3,34,71,51,44,4,3,20,56,45,43,2,0,11,90,56,49,6,1,34
S01007085,684,490,390,54,46,194,176,90,69,4,17,86,191,145,105,19,21,46,70,50,40,5,5,20,78,67,57,9,1,11,169,138,119,17,2,31
S01007086,917,665,540,32,93,252,281,146,113,6,27,135,306,242,196,9,37,64,95,75,62,5,8,20,87,76,66,4,6,11,148,126,103,8,15,22
S01007087,753,497,416,34,47,256,294,115,96,8,11,179,200,164,134,11,19,36,79,64,58,1,5,15,57,45,37,4,4,12,123,109,91,10,8,14
S01007088,437,263,209,19,35,174,197,93,69,9,15,104,130,80,63,2,15,50,32,25,21,3,1,7,28,24,18,3,3,4,50,41,38,2,1,9
S01007089,423,284,238,37,9,139,98,42,36,5,1,56,118,84,65,16,3,34,70,54,49,3,2,16,47,40,36,4,0,7,90,64,52,9,3,26
S01007090,451,346,298,35,13,105,112,51,47,4,0,61,144,119,102,13,4,25,68,63,51,6,6,5,48,42,39,1,2,6,79,71,59,11,1,8
S01007091,587,446,390,27,29,141,127,68,55,3,10,59,201,153,128,11,14,48,103,90,81,6,3,13,67,58,53,4,1,9,89,77,73,3,1,12
S01007092,537,311,274,18,19,226,228,81,71,5,5,147,164,116,106,3,7,48,43,38,27,8,3,5,41,31,29,1,1,10,61,45,41,1,3,16
S01007093,853,549,489,48,12,304,245,75,62,10,3,170,227,165,147,14,4,62,125,100,94,5,1,25,100,83,74,9,0,17,156,126,112,10,4,30
S01007094,759,498,419,69,10,261,227,100,79,20,1,127,237,171,142,23,6,66,92,77,71,6,0,15,72,58,51,6,1,14,131,92,76,14,2,39
S01007095,447,301,220,74,7,146,109,42,25,15,2,67,119,91,61,27,3,28,69,55,44,11,0,14,46,35,25,8,2,11,104,78,65,13,0,26
S01007096,645,475,392,73,10,170,124,54,36,15,3,70,178,137,113,19,5,41,98,79,65,13,1,19,86,75,67,7,1,11,159,130,111,19,0,29
S01007097,396,293,235,50,8,103,85,40,26,14,0,45,116,89,78,10,1,27,57,48,38,7,3,9,48,45,37,7,1,3,90,71,56,12,3,19
S01007098,640,455,350,97,8,185,133,64,42,21,1,69,150,112,84,24,4,38,118,94,81,12,1,24,76,65,50,15,0,11,163,120,93,25,2,43
S01007099,694,504,383,105,16,190,159,63,50,11,2,96,199,154,112,38,4,45,114,95,67,21,7,19,85,77,66,11,0,8,137,115,88,24,3,22
S01007100,601,406,332,60,14,195,166,75,51,20,4,91,159,127,107,14,6,32,82,58,51,5,2,24,57,42,39,2,1,15,137,104,84,19,1,33
S01007101,706,438,359,40,39,268,285,119,99,10,10,166,205,155,131,12,12,50,69,52,39,4,9,17,55,44,37,5,2,11,92,68,53,9,6,24
S01007102,590,386,303,66,17,204,181,81,58,20,3,100,149,109,88,13,8,40,77,57,48,6,3,20,52,45,36,8,1,7,131,94,73,19,2,37
S01007103,678,435,350,69,16,243,207,90,70,16,4,117,180,132,107,19,6,48,90,63,54,7,2,27,78,62,53,6,3,16,123,88,66,21,1,35
S01007104,398,250,178,66,6,148,119,53,31,22,0,66,116,79,56,21,2,37,49,33,27,6,0,16,40,32,27,3,2,8,74,53,37,14,2,21
S01007105,447,257,218,30,9,190,143,33,26,5,2,110,129,95,74,16,5,34,59,40,37,3,0,19,56,44,41,1,2,12,60,45,40,5,0,15
S01007106,615,357,289,46,22,258,207,65,52,9,4,142,159,109,93,11,5,50,66,51,44,4,3,15,77,59,45,10,4,18,106,73,55,12,6,33
S01007107,543,374,280,84,10,169,139,78,52,24,2,61,141,100,74,23,3,41,78,54,41,11,2,24,72,59,47,11,1,13,113,83,66,15,2,30
S01007108,468,315,211,92,12,153,138,62,32,29,1,76,115,85,57,24,4,30,58,50,33,15,2,8,66,55,39,13,3,11,91,63,50,11,2,28
S01007109,668,404,329,47,28,264,270,122,103,12,7,148,181,129,103,17,9,52,64,44,36,4,4,20,67,49,41,4,4,18,86,60,46,10,4,26
S01007110,608,396,326,45,25,212,174,64,47,10,7,110,198,152,115,22,15,46,68,53,52,1,0,15,77,59,52,6,1,18,91,68,60,6,2,23
S01007111,435,268,231,23,14,167,147,52,43,7,2,95,122,86,75,6,5,36,48,32,29,2,1,16,64,56,49,5,2,8,54,42,35,3,4,12
S01007112,475,300,228,58,14,175,160,72,46,22,4,88,108,72,54,15,3,36,60,45,39,4,2,15,57,49,40,7,2,8,90,62,49,10,3,28
S01007113,488,268,209,48,11,220,130,25,15,10,0,105,118,87,63,17,7,31,39,27,26,1,0,12,54,41,32,7,2,13,147,88,73,13,2,59
S01007114,745,464,420,35,9,281,251,98,90,6,2,153,201,145,125,15,5,56,98,68,63,5,0,30,101,84,77,5,2,17,94,69,65,4,0,25
S01007115,584,347,303,31,13,237,199,73,64,8,1,126,149,104,87,11,6,45,63,48,45,1,2,15,81,64,53,8,3,17,92,58,54,3,1,34
S01007116,732,557,441,92,24,175,135,75,54,17,4,60,209,157,117,31,9,52,112,86,76,6,4,26,112,99,86,10,3,13,164,140,108,28,4,24
S01007117,398,252,203,43,6,146,89,29,21,7,1,60,110,85,69,12,4,25,57,39,31,7,1,18,48,36,29,7,0,12,94,63,53,10,0,31
S01007118,531,365,315,20,30,166,171,89,68,10,11,82,179,131,121,1,9,48,53,46,41,3,2,7,75,58,52,2,4,17,53,41,33,4,4,12
S01007119,658,422,365,29,28,236,261,122,101,12,9,139,205,150,126,9,15,55,65,50,48,1,1,15,72,58,54,2,2,14,55,42,36,5,1,13
S01007120,907,591,513,27,51,316,371,174,143,7,24,197,221,170,147,6,17,51,100,73,68,3,2,27,100,81,69,5,7,19,115,93,86,6,1,22
S01007121,466,226,194,16,16,240,215,56,49,6,1,159,109,71,58,5,8,38,50,36,32,0,4,14,37,27,22,3,2,10,55,36,33,2,1,19
S01007122,506,311,265,35,11,195,142,45,36,7,2,97,133,92,75,10,7,41,56,41,39,2,0,15,60,50,44,4,2,10,115,83,71,12,0,32
S01007123,566,328,291,21,16,238,245,86,79,5,2,159,147,105,89,7,9,42,58,46,43,2,1,12,48,39,38,1,0,9,68,52,42,6,4,16
S01007124,749,500,433,41,26,249,244,107,85,15,7,137,223,181,153,16,12,42,96,71,64,4,3,25,84,64,60,2,2,20,102,77,71,4,2,25
S01007125,676,418,351,33,34,258,249,105,83,13,9,144,208,143,124,6,13,65,67,51,45,3,3,16,60,50,41,6,3,10,92,69,58,5,6,23
S01007126,723,454,383,25,46,269,307,140,119,5,16,167,198,144,114,11,19,54,54,38,32,3,3,16,86,73,67,2,4,13,78,59,51,4,4,19
S01007127,833,599,503,41,55,234,336,196,160,13,23,140,204,165,141,10,14,39,67,46,36,5,5,21,79,66,54,3,9,13,147,126,112,10,4,21
S01007128,696,392,329,27,36,304,332,120,96,11,13,212,167,126,102,10,14,41,68,57,50,2,5,11,52,38,36,2,0,14,77,51,45,2,4,26
S01007129,739,517,431,75,11,222,86,35,15,18,2,51,92,63,57,4,2,29,103,80,70,8,2,23,87,64,55,8,1,23,371,275,234,37,4,96
S01007130,530,327,272,41,14,203,121,32,27,5,0,89,113,64,54,6,4,49,72,61,49,12,0,11,61,50,41,3,6,11,163,120,101,15,4,43
S01007131,655,417,368,34,15,238,148,40,33,6,1,108,133,85,72,7,6,48,96,75,65,9,1,21,57,48,40,5,3,9,221,169,158,7,4,52
S01007132,590,370,320,42,8,220,114,42,30,9,3,72,125,73,62,10,1,52,95,72,67,3,2,23,70,51,46,5,0,19,186,132,115,15,2,54
S01007133,554,379,287,84,8,175,121,53,35,17,1,68,117,84,61,19,4,33,80,61,47,14,0,19,55,47,36,10,1,8,181,134,108,24,2,47
S01007134,611,409,305,88,16,202,163,61,40,19,2,102,144,104,79,20,5,40,70,55,41,12,2,15,69,57,41,13,3,12,165,132,104,24,4,33
S01007135,437,291,218,63,10,146,47,18,14,4,0,29,87,60,35,18,7,27,58,42,33,9,0,16,36,29,20,8,1,7,209,142,116,24,2,67
S01007136,403,294,210,72,12,109,40,16,5,10,1,24,77,54,29,19,6,23,58,42,31,8,3,16,45,39,31,7,1,6,183,143,114,28,1,40
S01007137,519,439,360,58,21,80,38,20,11,5,4,18,125,99,75,16,8,26,79,69,56,9,4,10,67,53,47,6,0,14,210,198,171,22,5,12
S01007138,477,333,261,59,13,144,75,37,27,9,1,38,109,73,51,16,6,36,68,47,36,8,3,21,50,43,37,3,3,7,175,133,110,23,0,42
S01007139,627,414,316,70,28,213,166,57,41,11,5,109,151,110,76,18,16,41,87,75,62,9,4,12,69,53,42,10,1,16,154,119,95,22,2,35
S01007140,826,523,404,93,26,303,156,70,42,25,3,86,206,120,86,22,12,86,101,75,57,11,7,26,94,57,46,11,0,37,269,201,173,24,4,68
S01007141,541,368,295,63,10,173,94,25,25,0,0,69,131,91,69,19,3,40,83,58,46,10,2,25,62,55,43,11,1,7,171,139,112,23,4,32
S01007142,453,315,275,33,7,138,89,19,12,5,2,70,81,50,44,4,2,31,76,60,51,8,1,16,50,44,40,3,1,6,157,142,128,13,1,15
S01007143,435,374,331,37,6,61,23,12,10,2,0,11,100,83,70,12,1,17,82,72,63,8,1,10,61,53,44,8,1,8,169,154,144,7,3,15
S01007144,614,398,283,92,23,216,171,78,54,21,3,93,139,92,63,16,13,47,89,66,51,14,1,23,55,44,31,12,1,11,160,118,84,29,5,42
S01007145,773,414,351,43,20,359,182,45,34,5,6,137,172,109,84,17,8,63,111,71,60,7,4,40,77,44,38,5,1,33,231,145,135,9,1,86
S01007146,606,346,301,29,16,260,126,28,20,6,2,98,154,94,73,12,9,60,78,51,46,3,2,27,51,39,38,0,1,12,197,134,124,8,2,63
S01007147,607,364,317,33,14,243,105,35,27,5,3,70,141,83,72,8,3,58,93,71,62,7,2,22,79,60,52,6,2,19,189,115,104,7,4,74
S01007148,444,289,239,33,17,155,55,17,13,2,2,38,101,60,46,8,6,41,67,54,46,7,1,13,56,37,34,2,1,19,165,121,100,14,7,44
S01007149,472,264,236,21,7,208,99,29,22,7,0,70,118,70,64,5,1,48,65,49,43,3,3,16,62,42,39,3,0,20,128,74,68,3,3,54
S01007150,697,292,233,50,9,405,159,26,16,9,1,133,125,51,43,5,3,74,92,50,42,5,3,42,83,41,36,4,1,42,238,124,96,27,1,114
S01007151,714,464,395,48,21,250,124,29,25,4,0,95,150,95,73,17,5,55,119,91,70,9,12,28,84,61,55,4,2,23,237,188,172,14,2,49
S01007152,476,279,241,25,13,197,93,19,12,4,3,74,104,66,51,9,6,38,65,50,45,3,2,15,49,37,35,2,0,12,165,107,98,7,2,58
S01007153,526,304,259,35,10,222,110,28,24,3,1,82,101,59,43,11,5,42,82,53,46,5,2,29,61,45,41,4,0,16,172,119,105,12,2,53
S01007154,712,349,295,33,21,363,202,38,32,3,3,164,160,87,71,7,9,73,84,51,46,4,1,33,85,55,49,4,2,30,181,118,97,15,6,63
S01007155,541,301,255,34,12,240,120,20,12,7,1,100,113,66,54,9,3,47,86,53,46,4,3,33,58,45,39,5,1,13,164,117,104,9,4,47
S01007156,608,383,325,35,23,225,160,60,53,4,3,100,161,105,87,14,4,56,92,71,59,7,5,21,67,48,42,2,4,19,128,99,84,8,7,29
S01007157,503,365,304,35,26,138,111,44,32,6,6,67,143,113,91,13,9,30,85,74,59,6,9,11,73,62,54,6,2,11,91,72,68,4,0,19
S01007158,740,535,463,40,32,205,135,45,35,6,4,90,186,142,125,12,5,44,122,103,92,5,6,19,107,90,76,6,8,17,190,155,135,11,9,35
S01007159,687,430,350,46,34,257,211,78,57,12,9,133,178,127,100,12,15,51,103,75,65,6,4,28,87,73,59,11,3,14,108,77,69,5,3,31
S01007160,676,399,319,40,40,277,190,50,32,16,2,140,184,126,95,7,24,58,95,68,56,8,4,27,86,66,55,3,8,20,121,89,81,6,2,32
S01007161,576,351,287,39,25,225,134,42,33,5,4,92,153,97,77,11,9,56,93,65,61,2,2,28,60,46,32,7,7,14,136,101,84,14,3,35
S01007162,422,255,218,19,18,167,88,21,19,0,2,67,95,60,47,6,7,35,58,40,36,2,2,18,60,45,41,3,1,15,121,89,75,8,6,32
S01007163,745,413,346,44,23,332,185,45,34,7,4,140,194,112,92,9,11,82,83,59,50,7,2,24,90,64,53,6,5,26,193,133,117,15,1,60
S01007164,503,278,232,29,17,225,121,23,15,4,4,98,111,63,54,6,3,48,71,48,42,4,2,23,43,35,29,2,4,8,157,109,92,13,4,48
S01007165,707,407,323,63,21,300,112,29,18,6,5,83,136,84,57,20,7,52,101,60,47,8,5,41,78,59,46,12,1,19,280,175,155,17,3,105
S01007166,562,316,266,37,13,246,113,35,25,8,2,78,121,81,65,11,5,40,68,39,30,6,3,29,66,40,37,2,1,26,194,121,109,10,2,73
S01007167,679,415,345,57,13,264,110,38,29,8,1,72,156,96,74,18,4,60,99,71,55,13,3,28,88,62,53,5,4,26,226,148,134,13,1,78
S01007168,842,516,448,52,16,326,157,43,29,12,2,114,188,110,87,17,6,78,134,99,94,2,3,35,101,77,69,8,0,24,262,187,169,13,5,75
S01007169,636,393,335,35,23,243,112,32,25,5,2,80,137,86,74,5,7,51,115,76,63,4,9,39,76,55,47,6,2,21,196,144,126,15,3,52
S01007170,542,385,258,96,31,157,128,72,39,29,4,56,109,81,50,20,11,28,88,73,56,10,7,15,58,40,23,13,4,18,159,119,90,24,5,40
S01007171,742,526,413,96,17,216,184,83,63,15,5,101,198,153,121,27,5,45,97,84,65,16,3,13,92,74,58,13,3,18,171,132,106,25,1,39
S01007172,701,385,289,74,22,316,161,47,25,19,3,114,150,93,67,16,10,57,99,65,54,8,3,34,66,44,37,5,2,22,225,136,106,26,4,89
S01007173,670,511,438,50,23,159,135,69,56,9,4,66,183,146,118,15,13,37,126,105,88,13,4,21,106,94,87,7,0,12,120,97,89,6,2,23
S01007174,681,456,376,48,32,225,187,66,45,13,8,121,170,132,109,13,10,38,112,95,81,6,8,17,96,78,65,8,5,18,116,85,76,8,1,31
S01007175,548,281,251,19,11,267,195,41,34,3,4,154,133,88,82,1,5,45,80,57,50,7,0,23,50,33,27,5,1,17,90,62,58,3,1,28
S01007176,557,340,295,25,20,217,156,46,40,4,2,110,146,103,87,8,8,43,88,70,60,6,4,18,80,53,45,3,5,27,87,68,63,4,1,19
S01007177,508,300,236,18,46,208,168,52,34,4,14,116,125,91,71,6,14,34,67,53,41,3,9,14,71,57,47,3,7,14,77,47,43,2,2,30
S01007178,837,518,406,49,63,319,275,110,80,11,19,165,255,175,134,14,27,80,111,82,69,8,5,29,92,75,62,5,8,17,104,76,61,11,4,28
S01007179,870,510,446,42,22,360,243,61,53,3,5,182,200,128,104,14,10,72,120,94,83,8,3,26,101,78,67,9,2,23,206,149,139,8,2,57
S01007180,634,337,269,47,21,297,153,42,25,15,2,111,143,82,56,15,11,61,77,50,42,6,2,27,85,66,58,4,4,19,176,97,88,7,2,79
S01007181,704,372,282,68,22,332,190,39,25,13,1,151,154,83,56,16,11,71,101,66,58,6,2,35,76,59,45,10,4,17,183,125,98,23,4,58
S01007182,907,532,437,66,29,375,249,68,50,14,4,181,190,137,108,18,11,53,119,86,78,4,4,33,110,82,68,9,5,28,239,159,133,21,5,80
S01007183,939,529,434,56,39,410,307,77,56,12,9,230,205,143,110,15,18,62,122,91,74,7,10,31,117,85,76,9,0,32,188,133,118,13,2,55
S01007184,916,553,450,37,66,363,284,90,67,4,19,194,245,161,126,15,20,84,114,93,79,6,8,21,115,99,85,5,9,16,158,110,93,7,10,48
S01007185,692,389,304,38,47,303,279,76,54,9,13,203,168,122,92,11,19,46,74,62,54,4,4,12,65,53,45,3,5,12,106,76,59,11,6,30
S01007186,494,308,232,24,52,186,179,71,49,8,14,108,125,86,61,4,21,39,56,43,36,4,3,13,66,55,42,4,9,11,68,53,44,4,5,15
S01007187,707,422,327,43,52,285,266,80,55,8,17,186,148,98,70,9,19,50,86,72,58,10,4,14,93,81,72,5,4,12,114,91,72,11,8,23
S01007188,515,350,281,42,27,165,131,57,39,12,6,74,128,98,76,11,11,30,69,48,38,5,5,21,83,67,56,7,4,16,104,80,72,7,1,24
S01007189,710,348,264,38,46,362,281,62,41,10,11,219,181,115,87,9,19,66,90,64,48,10,6,26,53,38,30,2,6,15,105,69,58,7,4,36
S01007190,711,364,299,51,14,347,266,68,51,14,3,198,188,113,92,17,4,75,80,62,51,6,5,18,75,54,46,7,1,21,102,67,59,7,1,35
S01007191,511,335,268,33,34,176,172,70,54,9,7,102,152,113,86,10,17,39,58,47,39,7,1,11,63,54,44,3,7,9,66,51,45,4,2,15
S01007192,501,307,251,20,36,194,181,66,52,4,10,115,168,123,96,8,19,45,46,34,26,4,4,12,46,35,33,0,2,11,60,49,44,4,1,11
S01007193,608,376,303,35,38,232,214,86,65,5,16,128,200,131,103,18,10,69,72,49,40,6,3,23,65,60,50,4,6,5,57,50,45,2,3,7
S01007194,463,277,206,17,54,186,164,59,40,3,16,105,184,132,95,9,28,52,37,25,21,1,3,12,40,33,27,0,6,7,38,28,23,4,1,10
S01007195,436,259,197,24,38,177,162,67,49,6,12,95,121,79,66,4,9,42,53,42,36,4,2,11,44,32,15,4,13,12,56,39,31,6,2,17
S01007196,540,369,297,19,53,171,135,63,44,7,12,72,183,133,100,6,27,50,81,61,56,1,4,20,57,49,44,2,3,8,84,63,53,3,7,21
S01007197,457,308,223,18,67,149,152,64,46,4,14,88,142,108,75,2,31,34,55,49,37,4,8,6,43,35,24,3,8,8,65,52,41,5,6,13
S01007198,402,258,190,22,46,144,157,68,44,3,21,89,104,76,53,6,17,28,44,35,27,5,3,9,40,33,27,3,3,7,57,46,39,5,2,11
S01007199,601,366,282,17,67,235,210,95,72,5,18,115,196,136,99,8,29,60,61,41,33,1,7,20,67,50,39,1,10,17,67,44,39,2,3,23
S01007200,715,477,408,35,34,238,217,87,72,7,8,130,210,148,120,11,17,62,107,91,84,4,3,16,75,67,57,8,2,8,106,84,75,5,4,22
S01007201,625,352,297,24,31,273,220,67,49,5,13,153,178,122,99,9,14,56,76,50,47,2,1,26,51,41,37,3,1,10,100,72,65,5,2,28
S01007202,619,384,302,31,51,235,229,97,69,12,16,132,172,124,94,7,23,48,70,54,49,1,4,16,68,49,42,3,4,19,80,60,48,8,4,20
S01007203,518,344,288,32,24,174,170,67,59,4,4,103,144,112,87,15,10,32,64,52,43,5,4,12,63,52,47,2,3,11,77,61,52,6,3,16
S01007204,825,538,406,111,21,287,186,74,54,17,3,112,184,130,103,24,3,54,107,79,57,20,2,28,97,83,65,11,7,14,251,172,127,39,6,79
S01007205,583,356,261,75,20,227,111,33,22,10,1,78,156,102,74,14,14,54,81,60,39,18,3,21,65,50,37,11,2,15,170,111,89,22,0,59
S01007206,331,193,164,17,12,138,113,34,31,2,1,79,64,49,39,2,8,15,38,25,22,1,2,13,36,27,24,2,1,9,80,58,48,10,0,22
S01007207,754,478,400,53,25,276,223,71,48,15,8,152,190,148,120,16,12,42,103,80,73,5,2,23,92,80,74,4,2,12,146,99,85,13,1,47
S01007208,808,517,419,24,74,291,217,68,48,4,16,149,235,176,136,5,35,59,105,79,70,4,5,26,109,89,73,5,11,20,142,105,92,6,7,37
S01007209,671,391,313,46,32,280,205,47,29,8,10,158,163,106,88,8,10,57,76,61,49,9,3,15,80,71,58,8,5,9,147,106,89,13,4,41
S01007210,628,416,343,30,43,212,209,86,63,7,16,123,171,135,113,7,15,36,75,58,48,5,5,17,69,53,46,5,2,16,104,84,73,6,5,20
S01007211,805,457,374,37,46,348,280,87,62,10,15,193,205,136,111,10,15,69,96,71,63,3,5,25,89,72,61,4,7,17,135,91,77,10,4,44
S01007212,456,295,240,35,20,161,115,44,36,6,2,71,107,77,61,6,10,30,66,51,42,8,1,15,58,51,39,7,5,7,110,72,62,8,2,38
S01007213,789,422,346,48,28,367,225,54,43,10,1,171,187,112,84,13,15,75,92,60,49,6,5,32,77,57,52,3,2,20,208,139,118,16,5,69
S01007214,656,358,289,35,34,298,256,70,50,9,11,186,145,100,80,7,13,45,71,55,52,3,0,16,73,59,50,2,7,14,111,74,57,14,3,37
S01007215,650,403,332,40,31,247,205,65,46,11,8,140,163,120,97,7,16,43,80,63,57,4,2,17,76,61,53,6,2,15,126,94,79,12,3,32
S01007216,616,371,309,41,21,245,164,43,27,13,3,121,159,109,94,6,9,50,88,76,66,7,3,12,59,42,38,2,2,17,146,101,84,13,4,45
S01007217,787,481,394,44,43,306,308,107,87,12,8,201,204,152,112,17,23,52,88,72,62,3,7,16,66,54,51,2,1,12,121,96,82,10,4,25
S01007218,722,446,372,59,15,276,174,63,50,11,2,111,165,116,104,8,4,49,94,75,58,13,4,19,96,75,63,10,2,21,193,117,97,17,3,76
S01007219,675,406,346,34,26,269,239,70,58,8,4,169,185,144,117,9,18,41,91,72,62,8,2,19,66,53,49,3,1,13,94,67,60,6,1,27
S01007220,556,364,309,29,26,192,210,85,72,7,6,125,166,139,117,9,13,27,61,48,40,4,4,13,40,31,28,2,1,9,79,61,52,7,2,18
S01007221,525,323,261,47,15,202,132,29,17,7,5,103,106,64,48,12,4,42,84,71,61,9,1,13,66,58,47,7,4,8,137,101,88,12,1,36
S01007222,640,417,350,39,28,223,171,80,63,9,8,91,190,139,116,12,11,51,80,60,55,3,2,20,74,59,50,4,5,15,125,79,66,11,2,46
S01007223,416,280,239,28,13,136,82,24,19,3,2,58,91,63,49,7,7,28,60,47,40,4,3,13,62,54,49,5,0,8,121,92,82,9,1,29
S01007224,491,284,232,42,10,207,128,36,27,7,2,92,114,71,60,7,4,43,62,52,41,9,2,10,48,37,34,2,1,11,139,88,70,17,1,51
S01007225,721,491,379,96,16,230,152,68,51,17,0,84,188,143,109,26,8,45,89,67,48,16,3,22,82,69,53,12,4,13,210,144,118,25,1,66
S01007226,669,453,305,123,25,216,155,71,35,34,2,84,152,104,68,27,9,48,95,72,49,19,4,23,58,49,35,12,2,9,209,157,118,31,8,52
S01007227,780,484,388,65,31,296,225,78,64,11,3,147,172,120,94,13,13,52,110,87,65,16,6,23,86,65,53,6,6,21,187,134,112,19,3,53
S01007228,517,348,245,84,19,169,111,48,31,14,3,63,113,75,58,12,5,38,82,66,40,24,2,16,58,46,30,13,3,12,153,113,86,21,6,40
S01007229,915,632,470,138,24,283,209,96,60,33,3,113,236,184,137,34,13,52,128,93,71,20,2,35,95,77,52,23,2,18,247,182,150,28,4,65
S01007230,588,365,292,23,50,223,197,78,59,2,17,119,191,139,109,8,22,52,74,55,43,9,3,19,53,43,36,3,4,10,73,50,45,1,4,23
S01007231,576,312,251,22,39,264,234,71,53,10,8,163,169,119,92,4,23,50,72,49,41,5,3,23,39,29,27,1,1,10,62,44,38,2,4,18
S01007232,601,350,285,15,50,251,226,77,55,4,18,149,189,127,100,6,21,62,67,55,51,1,3,12,48,39,32,2,5,9,71,52,47,2,3,19
S01007233,647,428,338,53,37,219,204,90,68,13,9,114,190,145,114,16,15,45,86,66,56,6,4,20,54,40,31,5,4,14,113,87,69,13,5,26
S01007234,505,297,245,25,27,208,182,68,49,9,10,114,140,96,79,7,10,44,57,42,37,0,5,15,43,36,34,1,1,7,83,55,46,8,1,28
S01007235,659,395,326,36,33,264,209,67,55,7,5,142,157,118,94,8,16,39,83,56,44,6,6,27,85,68,58,7,3,17,125,86,75,8,3,39
S01007236,521,335,277,37,21,186,165,54,40,10,4,111,138,111,97,7,7,27,72,54,48,4,2,18,55,39,30,5,4,16,91,77,62,11,4,14
S01007237,608,371,317,41,13,237,163,42,38,3,1,121,172,116,100,11,5,56,86,70,59,10,1,16,52,47,39,6,2,5,135,96,81,11,4,39
S01007238,778,487,421,38,28,291,239,71,58,6,7,168,228,171,143,15,13,57,110,93,82,7,4,17,79,62,55,6,1,17,122,90,83,4,3,32
S01007239,745,373,307,55,11,372,192,47,32,13,2,145,164,95,75,15,5,69,87,61,54,7,0,26,71,50,44,5,1,21,231,120,102,15,3,111
S01007240,463,310,225,71,14,153,96,43,27,16,0,53,121,86,63,17,6,35,56,46,34,10,2,10,80,65,44,19,2,15,110,70,57,9,4,40
S01007241,507,352,254,90,8,155,112,49,28,18,3,63,106,79,56,22,1,27,70,58,48,9,1,12,54,40,27,12,1,14,165,126,95,29,2,39
S01007242,833,496,401,69,26,337,183,51,38,6,7,132,217,145,111,23,11,72,115,88,72,12,4,27,83,60,52,7,1,23,235,152,128,21,3,83
S01007243,504,312,254,38,20,192,122,38,24,9,5,84,104,67,53,10,4,37,77,58,42,8,8,19,64,47,42,4,1,17,137,102,93,7,2,35
S01007244,620,372,282,74,16,248,161,58,37,19,2,103,142,91,77,9,5,51,72,54,38,11,5,18,70,56,43,11,2,14,175,113,87,24,2,62
S01007245,583,368,278,77,13,215,194,61,38,22,1,133,153,118,89,23,6,35,58,51,38,10,3,7,63,52,43,7,2,11,115,86,70,15,1,29
S01007246,473,324,249,58,17,149,132,65,42,20,3,67,128,97,80,13,4,31,72,55,41,9,5,17,45,35,28,4,3,10,96,72,58,12,2,24
S01007247,530,350,276,62,12,180,143,54,47,7,0,89,107,79,61,11,7,28,80,62,42,17,3,18,37,32,26,4,2,5,163,123,100,23,0,40
S01007248,643,366,297,57,12,277,124,35,26,7,2,89,137,87,70,14,3,50,99,63,53,9,1,36,66,51,42,8,1,15,217,130,106,19,5,87
S01007249,371,186,157,20,9,185,117,17,12,5,0,100,73,46,37,5,4,27,47,31,27,2,2,16,39,32,27,3,2,7,95,60,54,5,1,35
S01007250,716,490,415,44,31,226,196,73,62,7,4,123,185,136,109,11,16,49,93,77,65,10,2,16,85,72,62,2,8,13,157,132,117,14,1,25
S01007251,422,247,199,34,14,175,146,40,31,7,2,106,95,66,49,11,6,29,54,43,36,5,2,11,37,32,24,5,3,5,90,66,59,6,1,24
S01007252,642,421,346,54,21,221,163,51,37,11,3,112,182,137,113,16,8,45,93,73,55,11,7,20,65,50,45,4,1,15,139,110,96,12,2,29
S01007253,687,405,339,42,24,282,200,64,50,8,6,136,180,121,96,15,10,59,87,65,59,3,3,22,67,48,41,5,2,19,153,107,93,11,3,46
S01007254,679,376,314,29,33,303,271,66,52,7,7,205,172,129,106,6,17,43,72,53,49,2,2,19,68,60,47,7,6,8,96,68,60,7,1,28
S01007255,613,414,318,21,75,199,246,117,82,8,27,129,182,143,102,7,34,39,59,47,38,1,8,12,48,42,37,2,3,6,78,65,59,3,3,13
S01007256,647,428,357,35,36,219,233,106,83,10,13,127,152,114,93,8,13,38,64,53,47,3,3,11,79,67,60,4,3,12,119,88,74,10,4,31
S01007257,486,317,254,30,33,169,144,74,57,9,8,70,148,93,72,5,16,55,65,49,42,3,4,16,46,37,30,5,2,9,83,64,53,8,3,19
S01007258,733,417,332,52,33,316,198,63,53,5,5,135,192,112,80,17,15,80,79,49,40,6,3,30,80,62,53,5,4,18,184,131,106,19,6,53
S01007259,722,418,348,34,36,304,266,78,62,5,11,188,212,146,122,11,13,66,83,70,61,7,2,13,69,59,51,6,2,10,92,65,52,5,8,27
S01007260,719,489,373,37,79,230,276,132,100,16,16,144,219,173,126,7,40,46,61,51,40,3,8,10,73,58,46,1,11,15,90,75,61,10,4,15
S01007261,683,399,335,42,22,284,221,80,63,16,1,141,168,117,94,13,10,51,86,59,51,2,6,27,61,46,40,3,3,15,147,97,87,8,2,50
S01007262,585,385,331,12,42,200,221,94,82,2,10,127,172,129,106,4,19,43,64,55,48,1,6,9,54,46,40,2,4,8,74,61,55,3,3,13
S01007263,653,393,348,22,23,260,245,92,79,6,7,153,186,134,120,8,6,52,66,46,43,2,1,20,63,56,52,0,4,7,93,65,54,6,5,28
S01007264,663,364,322,29,13,299,235,67,57,8,2,168,162,108,96,8,4,54,80,60,53,3,4,20,63,51,48,0,3,12,123,78,68,10,0,45
S01007265,902,553,472,49,32,349,334,100,82,7,11,234,253,193,159,21,13,60,94,81,70,9,2,13,94,81,73,5,3,13,127,98,88,7,3,29
S01007266,569,378,328,39,11,191,170,76,63,10,3,94,160,126,112,11,3,34,65,49,41,7,1,16,47,33,30,0,3,14,127,94,82,11,1,33
S01007267,439,313,220,76,17,126,110,53,33,14,6,57,108,85,61,18,6,23,58,43,30,11,2,15,45,38,24,14,0,7,118,94,72,19,3,24
S01007268,496,333,226,88,19,163,96,44,28,10,6,52,111,75,52,20,3,36,79,62,38,22,2,17,44,32,17,13,2,12,166,120,91,23,6,46
S01007269,440,251,196,46,9,189,111,34,21,10,3,77,104,63,50,12,1,41,55,34,30,2,2,21,51,38,35,2,1,13,119,82,60,20,2,37
S01007270,384,277,191,76,10,107,88,47,28,15,4,41,75,60,42,14,4,15,55,41,32,9,0,14,46,42,21,19,2,4,120,87,68,19,0,33
S01007271,836,518,416,74,28,318,242,85,58,21,6,157,195,136,108,16,12,59,115,92,74,12,6,23,77,54,46,7,1,23,207,151,130,18,3,56
S01007272,672,407,331,32,44,265,235,87,75,7,5,148,199,144,110,8,26,55,89,71,61,6,4,18,63,46,32,5,9,17,86,59,53,6,0,27
S01007273,547,338,280,39,19,209,145,52,36,11,5,93,133,88,73,9,6,45,86,62,55,5,2,24,52,45,39,3,3,7,131,91,77,11,3,40
S01007274,717,432,335,55,42,285,215,59,45,9,5,156,152,98,72,9,17,54,96,76,55,15,6,20,78,60,51,5,4,18,176,139,112,17,10,37
S01007275,499,262,214,35,13,237,127,28,22,5,1,99,88,42,37,2,3,46,69,46,31,11,4,23,49,37,31,4,2,12,166,109,93,13,3,57
S01007276,678,417,347,42,28,261,149,61,48,6,7,88,187,116,97,9,10,71,102,76,61,12,3,26,76,59,52,4,3,17,164,105,89,11,5,59
S01007277,637,373,317,42,14,264,117,32,25,7,0,85,138,83,73,8,2,55,99,73,62,5,6,26,53,37,31,4,2,16,230,148,126,18,4,82
S01007278,449,273,226,39,8,176,79,23,19,4,0,56,113,72,57,11,4,41,88,59,49,7,3,29,35,26,24,2,0,9,134,93,77,15,1,41
S01007279,466,318,200,106,12,148,89,43,23,17,3,46,95,66,36,29,1,29,61,51,35,11,5,10,48,34,22,12,0,14,173,124,84,37,3,49
S01007280,445,306,204,79,23,139,103,50,28,18,4,53,93,67,43,19,5,26,61,44,27,11,6,17,45,34,22,9,3,11,143,111,84,22,5,32
S01007281,805,522,394,109,19,283,170,66,40,20,6,104,194,118,90,20,8,76,126,98,71,27,0,28,97,75,60,13,2,22,218,165,133,29,3,53
S01007282,436,312,220,78,14,124,108,56,42,12,2,52,117,94,70,17,7,23,58,48,30,15,3,10,37,29,17,12,0,8,116,85,61,22,2,31
S01007283,866,406,310,81,15,460,248,47,36,11,0,201,175,97,68,25,4,78,98,57,45,11,1,41,92,60,45,10,5,32,253,145,116,24,5,108
S01007284,702,427,275,141,11,275,166,59,30,25,4,107,153,100,69,27,4,53,109,77,51,25,1,32,57,46,33,11,2,11,217,145,92,53,0,72
S01007285,724,456,267,176,13,268,157,64,36,26,2,93,154,93,58,31,4,61,112,88,51,33,4,24,67,53,28,24,1,14,234,158,94,62,2,76
S01007286,787,513,345,146,22,274,176,62,32,26,4,114,171,131,92,33,6,40,119,90,64,23,3,29,76,57,39,15,3,19,245,173,118,49,6,72
S01007287,523,360,204,140,16,163,104,49,25,22,2,55,98,73,35,26,12,25,77,59,31,28,0,18,49,36,22,14,0,13,195,143,91,50,2,52
S01007288,487,318,189,117,12,169,101,41,24,15,2,60,103,72,40,30,2,31,79,58,31,25,2,21,42,31,17,11,3,11,162,116,77,36,3,46
S01007289,674,455,352,95,8,219,113,41,29,12,0,72,151,110,85,20,5,41,135,101,78,22,1,34,38,28,25,3,0,10,237,175,135,38,2,62
S01007290,515,394,303,56,35,121,91,50,32,10,8,41,176,134,96,20,18,42,100,80,67,10,3,20,36,31,27,3,1,5,112,99,81,13,5,13
S01007291,583,336,267,49,20,247,240,65,49,13,3,175,124,100,77,13,10,24,79,62,48,9,5,17,36,27,26,1,0,9,104,82,67,13,2,22
S01007292,632,440,365,61,14,192,135,64,51,9,4,71,188,140,112,22,6,48,118,99,81,14,4,19,43,36,31,5,0,7,148,101,90,11,0,47
S01007293,577,449,375,34,40,128,179,110,84,12,14,69,195,158,134,8,16,37,74,67,58,5,4,7,45,42,37,2,3,3,84,72,62,7,3,12
S01007294,745,501,411,69,21,244,217,96,81,10,5,121,230,182,144,25,13,48,129,105,89,16,0,24,43,32,28,3,1,11,126,86,69,15,2,40
S01007295,432,257,206,24,27,175,167,59,43,4,12,108,114,86,69,7,10,28,60,44,36,5,3,16,23,22,21,1,0,1,68,46,37,7,2,22
S01007296,519,352,270,52,30,167,130,56,42,7,7,74,132,99,73,14,12,33,78,65,51,11,3,13,47,43,32,6,5,4,132,89,72,14,3,43
S01007297,783,567,450,96,21,216,143,54,38,13,3,89,165,134,99,22,13,31,128,101,81,18,2,27,66,57,50,6,1,9,281,221,182,37,2,60
S01007298,437,293,240,39,14,144,134,59,42,10,7,75,95,74,62,11,1,21,70,60,50,9,1,10,35,29,26,2,1,6,103,71,60,7,4,32
S01007299,733,521,406,78,37,212,192,89,63,18,8,103,207,162,122,25,15,45,117,92,75,11,6,25,53,50,45,2,3,3,164,128,101,22,5,36
S01007300,411,282,212,38,32,129,164,77,55,10,12,87,108,88,65,13,10,20,59,51,40,4,7,8,28,27,20,4,3,1,52,39,32,7,0,13
S01007301,626,399,291,99,9,227,125,51,23,24,4,74,114,77,60,15,2,37,81,64,49,15,0,17,47,41,29,11,1,6,259,166,130,34,2,93
S01007302,512,345,278,42,25,167,185,78,54,19,5,107,130,107,81,14,12,23,75,64,58,2,4,11,34,30,27,1,2,4,88,66,58,6,2,22
S01007303,779,476,346,113,17,303,140,53,34,14,5,87,141,106,69,34,3,35,120,89,66,20,3,31,81,52,37,12,3,29,297,176,140,33,3,121
S01007304,584,343,215,118,10,241,129,49,24,24,1,80,121,86,60,23,3,35,66,47,30,16,1,19,44,33,22,10,1,11,224,128,79,45,4,96
S01007305,608,407,298,100,9,201,118,49,30,16,3,69,106,78,51,23,4,28,111,84,69,15,0,27,49,38,31,7,0,11,224,158,117,39,2,66
S01007306,612,396,294,81,21,216,147,61,41,13,7,86,113,84,67,14,3,29,98,73,46,25,2,25,68,51,44,5,2,17,186,127,96,24,7,59
S01007307,663,439,299,129,11,224,109,37,23,12,2,72,150,101,67,30,4,49,94,73,49,22,2,21,73,60,46,14,0,13,237,168,114,51,3,69
S01007308,686,439,326,91,22,247,162,67,44,18,5,95,164,110,89,13,8,54,84,61,44,14,3,23,67,57,44,10,3,10,209,144,105,36,3,65
S01007309,550,365,248,101,16,185,116,52,31,19,2,64,117,78,52,24,2,39,77,53,32,15,6,24,35,32,23,8,1,3,205,150,110,35,5,55
S01007310,686,384,231,125,28,302,126,45,16,25,4,81,161,104,58,28,18,57,83,55,34,20,1,28,46,29,18,11,0,17,270,151,105,41,5,119
S01007311,653,474,361,89,24,179,176,80,48,22,10,96,180,150,117,26,7,30,108,92,75,14,3,16,59,50,43,5,2,9,130,102,78,22,2,28
S01007312,626,371,278,71,22,255,125,51,32,16,3,74,143,89,65,17,7,54,73,51,31,14,6,22,64,45,40,3,2,19,221,135,110,21,4,86
S01007313,826,533,345,171,17,293,149,61,36,22,3,88,140,84,52,26,6,56,112,87,61,24,2,25,73,56,31,23,2,17,352,245,165,76,4,107
S01007314,528,386,290,84,12,142,119,57,34,21,2,62,92,73,53,16,4,19,91,81,66,11,4,10,47,44,39,5,0,3,179,131,98,31,2,48
S01007315,781,532,456,49,27,249,150,64,48,11,5,86,182,139,113,8,18,43,140,108,94,11,3,32,64,50,45,4,1,14,245,171,156,15,0,74
S01007316,733,431,348,48,35,302,195,53,40,6,7,142,196,138,101,20,17,58,113,96,84,7,5,17,54,38,34,2,2,16,175,106,89,13,4,69
S01007317,530,376,315,41,20,154,110,51,40,8,3,59,142,108,94,7,7,34,71,58,47,5,6,13,39,34,29,4,1,5,168,125,105,17,3,43
S01007318,475,318,242,56,20,157,119,50,33,10,7,69,118,94,67,20,7,24,72,59,48,9,2,13,45,33,27,4,2,12,121,82,67,13,2,39
S01007319,632,396,310,64,22,236,169,67,45,15,7,102,146,105,76,18,11,41,79,61,51,8,2,18,50,40,34,6,0,10,188,123,104,17,2,65
S01007320,640,400,269,108,23,240,101,42,15,21,6,59,106,72,49,15,8,34,84,56,41,12,3,28,65,53,42,9,2,12,284,177,122,51,4,107
S01007321,528,330,204,111,15,198,111,47,29,15,3,64,110,78,47,26,5,32,78,59,29,28,2,19,39,28,16,10,2,11,190,118,83,32,3,72
S01007322,634,395,274,95,26,239,195,75,36,32,7,120,150,109,80,20,9,41,97,73,55,17,1,24,49,42,33,7,2,7,143,96,70,19,7,47
S01007323,394,266,209,48,9,128,120,57,38,15,4,63,97,70,54,14,2,27,65,59,48,10,1,6,23,19,16,2,1,4,89,61,53,7,1,28
S01007324,290,180,126,43,11,110,59,25,19,6,0,34,48,34,26,5,3,14,48,31,24,5,2,17,14,12,8,3,1,2,121,78,49,24,5,43
S01007325,685,411,274,121,16,274,171,62,39,21,2,109,133,90,57,24,9,43,113,87,56,28,3,26,54,46,29,17,0,8,214,126,93,31,2,88
S01007326,659,410,294,97,19,249,202,89,53,34,2,113,160,115,92,15,8,45,100,74,56,14,4,26,53,46,31,11,4,7,144,86,62,23,1,58
S01007327,657,396,305,66,25,261,225,78,55,13,10,147,171,119,92,17,10,52,77,62,47,11,4,15,46,40,31,9,0,6,138,97,80,16,1,41
S01007328,713,448,334,87,27,265,248,104,63,29,12,144,197,154,114,31,9,43,112,83,70,10,3,29,38,31,28,2,1,7,118,76,59,15,2,42
S01007329,568,364,227,119,18,204,166,73,33,35,5,93,118,76,43,27,6,42,91,70,53,14,3,21,31,29,22,6,1,2,162,116,76,37,3,46
S01007330,690,369,231,114,24,321,209,74,38,28,8,135,148,98,60,31,7,50,87,59,37,20,2,28,53,34,24,8,2,19,193,104,72,27,5,89
S01007331,815,545,380,135,30,270,252,108,65,37,6,144,206,162,107,44,11,44,129,106,81,19,6,23,61,44,32,9,3,17,167,125,95,26,4,42
S01007332,435,254,137,104,13,181,128,51,13,34,4,77,115,74,49,22,3,41,66,49,28,17,4,17,31,17,12,4,1,14,95,63,35,27,1,32
S01007333,688,385,296,70,19,303,182,60,44,12,4,122,147,98,79,15,4,49,120,94,80,10,4,26,50,30,22,4,4,20,189,103,71,29,3,86
S01007334,591,327,243,33,51,264,277,96,65,9,22,181,153,109,86,7,16,44,68,53,39,7,7,15,31,25,22,2,1,6,62,44,31,8,5,18
S01007335,667,379,315,27,37,288,291,100,78,7,15,191,178,127,107,8,12,51,82,62,51,3,8,20,42,33,30,3,0,9,74,57,49,6,2,17
S01007336,458,269,190,37,42,189,146,54,22,16,16,92,103,67,49,5,13,36,71,56,48,4,4,15,36,31,20,6,5,5,102,61,51,6,4,41
S01007337,562,285,218,44,23,277,250,53,39,10,4,197,138,94,74,11,9,44,66,59,47,5,7,7,32,26,18,8,0,6,76,53,40,10,3,23
S01007338,606,384,321,42,21,222,232,93,79,9,5,139,169,132,110,15,7,37,93,75,61,9,5,18,39,30,25,1,4,9,73,54,46,8,0,19
S01007339,527,289,229,53,7,238,158,45,34,10,1,113,113,74,62,10,2,39,78,56,39,15,2,22,41,27,24,3,0,14,137,87,70,15,2,50
S01007340,404,200,146,38,16,204,127,34,24,8,2,93,83,51,37,8,6,32,59,38,28,7,3,21,40,30,21,8,1,10,95,47,36,7,4,48
S01007341,654,295,217,58,20,359,198,38,18,16,4,160,143,78,60,9,9,65,95,55,47,7,1,40,47,38,30,7,1,9,171,86,62,19,5,85
S01007342,724,383,272,99,12,341,166,48,34,12,2,118,126,80,49,27,4,46,97,60,46,10,4,37,62,44,27,17,0,18,273,151,116,33,2,122
S01007343,569,337,204,125,8,232,164,80,37,41,2,84,138,92,54,35,3,46,80,53,37,15,1,27,39,30,23,7,0,9,148,82,53,27,2,66
S01007344,394,193,148,38,7,201,118,33,18,12,3,85,96,55,48,7,0,41,41,25,20,4,1,16,39,26,18,8,0,13,100,54,44,7,3,46
S01007345,454,272,197,30,45,182,158,60,36,9,15,98,124,93,68,8,17,31,76,55,42,5,8,21,32,25,20,2,3,7,64,39,31,6,2,25
S01007346,487,258,191,25,42,229,203,52,37,4,11,151,122,82,54,8,20,40,55,37,33,1,3,18,34,27,22,0,5,7,73,60,45,12,3,13
S01007347,543,265,199,32,34,278,250,69,49,11,9,181,127,79,64,8,7,48,51,40,27,5,8,11,44,36,28,4,4,8,71,41,31,4,6,30
S01007348,491,279,217,32,30,212,196,77,53,13,11,119,135,89,70,9,10,46,68,47,39,2,6,21,31,26,23,2,1,5,61,40,32,6,2,21
S01007349,340,207,168,18,21,133,106,45,29,8,8,61,110,78,62,4,12,32,50,36,34,1,1,14,17,9,9,0,0,8,57,39,34,5,0,18
S01007350,506,274,198,50,26,232,178,47,36,7,4,131,139,98,66,22,10,41,53,38,25,6,7,15,41,33,26,5,2,8,95,58,45,10,3,37
S01007351,592,281,170,97,14,311,164,36,21,13,2,128,118,73,43,27,3,45,72,48,28,18,2,24,47,32,17,12,3,15,191,92,61,27,4,99
S01007352,442,262,142,102,18,180,80,28,11,16,1,52,84,54,30,22,2,30,78,56,32,21,3,22,34,22,5,16,1,12,166,102,64,27,11,64
S01007353,538,286,200,66,20,252,115,29,19,8,2,86,113,70,47,17,6,43,67,47,35,9,3,20,50,33,24,8,1,17,193,107,75,24,8,86
S01007354,707,340,258,62,20,367,164,32,24,3,5,132,149,76,50,17,9,73,91,48,36,9,3,43,68,41,35,6,0,27,235,143,113,27,3,92
S01007355,854,459,311,124,24,395,226,73,40,30,3,153,137,72,54,14,4,65,116,69,46,19,4,47,83,64,46,16,2,19,292,181,125,45,11,111
S01007356,625,320,221,70,29,305,128,49,31,12,6,79,124,59,38,12,9,65,86,50,39,6,5,36,60,40,28,8,4,20,227,122,85,32,5,105
S01007357,681,386,263,108,15,295,183,73,47,24,2,110,139,89,60,23,6,50,73,42,34,5,3,31,54,40,25,15,0,14,232,142,97,41,4,90
S01007358,765,537,420,91,26,228,188,88,65,14,9,100,173,132,107,15,10,41,103,82,62,19,1,21,64,51,44,6,1,13,237,184,142,37,5,53
S01007359,668,364,290,43,31,304,213,68,51,8,9,145,145,96,76,10,10,49,102,66,49,10,7,36,51,37,30,4,3,14,157,97,84,11,2,60
S01007360,481,234,178,42,14,247,111,34,22,9,3,77,104,54,48,3,3,50,75,44,31,9,4,31,43,22,21,1,0,21,148,80,56,20,4,68
S01007361,884,475,339,98,38,409,238,66,46,15,5,172,163,104,69,25,10,59,138,99,64,23,12,39,83,64,42,14,8,19,262,142,118,21,3,120
S01007362,659,349,281,48,20,310,176,56,39,13,4,120,148,83,66,6,11,65,98,68,57,8,3,30,77,47,35,11,1,30,160,95,84,10,1,65
S01007363,608,283,219,35,29,325,187,39,28,6,5,148,121,73,54,9,10,48,75,50,39,5,6,25,55,39,33,5,1,16,170,82,65,10,7,88
S01007364,687,404,317,27,60,283,244,89,66,7,16,155,190,129,102,3,24,61,95,74,63,5,6,21,74,51,36,7,8,23,84,61,50,5,6,23
S01007365,392,230,178,25,27,162,115,38,26,6,6,77,103,80,58,8,14,23,57,40,32,6,2,17,33,25,21,3,1,8,84,47,41,2,4,37
S01007366,398,173,132,17,24,225,178,38,31,2,5,140,94,44,31,7,6,50,42,32,24,0,8,10,26,21,18,2,1,5,58,38,28,6,4,20
S01007367,474,273,212,41,20,201,152,50,35,10,5,102,130,92,77,7,8,38,50,37,29,6,2,13,49,40,29,7,4,9,93,54,42,11,1,39
S01007368,404,240,174,26,40,164,123,49,32,3,14,74,115,77,58,6,13,38,71,50,35,7,8,21,40,27,22,2,3,13,55,37,27,8,2,18
S01007369,628,394,311,49,34,234,191,65,45,11,9,126,165,117,88,13,16,48,85,65,51,8,6,20,55,48,44,3,1,7,132,99,83,14,2,33
S01007370,640,433,330,50,53,207,135,58,35,11,12,77,152,109,85,9,15,43,109,92,69,14,9,17,74,62,52,3,7,12,170,112,89,13,10,58
S01007371,563,370,293,44,33,193,126,51,37,9,5,75,143,99,77,9,13,44,88,68,52,8,8,20,70,55,44,6,5,15,136,97,83,12,2,39
S01007372,759,398,310,61,27,361,194,51,33,15,3,143,154,91,70,16,5,63,99,63,50,7,6,36,76,56,51,2,3,20,236,137,106,21,10,99
S01007373,536,278,189,70,19,258,128,27,15,10,2,101,109,69,46,15,8,40,66,43,30,9,4,23,58,38,29,7,2,20,175,101,69,29,3,74
S01007374,435,286,223,47,16,149,60,23,19,1,3,37,88,62,48,8,6,26,71,50,39,11,0,21,51,39,33,5,1,12,165,112,84,22,6,53
S01007375,406,223,159,47,17,183,77,22,10,10,2,55,71,42,28,10,4,29,60,46,37,6,3,14,44,30,24,6,0,14,154,83,60,15,8,71
S01007376,688,416,328,33,55,272,197,65,52,3,10,132,185,124,90,9,25,61,116,86,71,4,11,30,68,52,42,7,3,16,122,89,73,10,6,33
S01007377,553,356,280,61,15,197,89,36,27,9,0,53,110,72,54,15,3,38,70,48,41,4,3,22,67,49,42,6,1,18,217,151,116,27,8,66
S01007378,1367,1180,1116,49,15,187,131,83,70,13,0,48,480,447,426,11,10,33,290,273,268,3,2,17,137,116,111,4,1,21,329,261,241,18,2,68
S01007379,405,235,194,15,26,170,161,58,45,5,8,103,106,74,58,2,14,32,56,48,46,1,1,8,39,26,20,3,3,13,43,29,25,4,0,14
S01007380,448,314,270,20,24,134,90,43,38,2,3,47,168,129,107,5,17,39,58,40,35,3,2,18,42,36,32,3,1,6,90,66,58,7,1,24
S01007381,423,208,170,28,10,215,57,12,12,0,0,45,79,30,21,4,5,49,54,29,24,4,1,25,31,16,15,1,0,15,202,121,98,19,4,81
S01007382,534,336,273,53,10,198,71,21,17,4,0,50,104,66,53,10,3,38,86,53,41,10,2,33,62,47,42,4,1,15,211,149,120,25,4,62
S01007383,637,369,286,63,20,268,107,38,29,9,0,69,130,65,48,8,9,65,73,49,36,10,3,24,77,58,45,8,5,19,250,159,128,28,3,91
S01007384,611,419,353,33,33,192,86,35,23,4,8,51,115,81,71,2,8,34,110,89,73,9,7,21,57,44,37,3,4,13,243,170,149,15,6,73
S01007385,729,388,312,56,20,341,147,36,28,7,1,111,157,94,73,13,8,63,94,62,47,10,5,32,86,52,44,5,3,34,245,144,120,21,3,101
S01007386,684,369,263,94,12,315,61,13,8,4,1,48,78,40,29,10,1,38,104,61,43,13,5,43,60,39,28,10,1,21,381,216,155,57,4,165
S01007387,664,376,302,64,10,288,66,22,18,3,1,44,89,42,32,8,2,47,106,58,52,4,2,48,68,51,38,11,2,17,335,203,162,38,3,132
S01007388,572,366,301,41,24,206,60,20,12,6,2,40,106,69,56,8,5,37,99,67,57,5,5,32,66,57,47,5,5,9,241,153,129,17,7,88
S01007389,388,292,242,16,34,96,40,28,21,1,6,12,135,101,86,1,14,34,69,51,43,3,5,18,51,38,34,3,1,13,93,74,58,8,8,19
S01007390,363,277,229,29,19,86,54,29,23,4,2,25,137,102,86,7,9,35,80,65,51,8,6,15,38,34,28,5,1,4,54,47,41,5,1,7
S01007391,487,303,254,31,18,184,44,13,11,2,0,31,104,64,50,7,7,40,89,59,46,8,5,30,57,38,34,3,1,19,193,129,113,11,5,64
S01007392,413,219,176,32,11,194,59,18,14,4,0,41,65,35,30,3,2,30,61,34,24,6,4,27,46,31,26,3,2,15,182,101,82,16,3,81
S01007393,665,271,191,61,19,394,121,14,11,1,2,107,102,33,19,10,4,69,83,32,20,3,9,51,43,23,18,5,0,20,316,169,123,42,4,147
S01007394,559,264,212,34,18,295,102,15,11,4,0,87,104,55,35,13,7,49,68,32,26,4,2,36,47,31,27,2,2,16,238,131,113,11,7,107
S01007395,714,433,341,52,40,281,193,53,37,8,8,140,147,103,80,9,14,44,109,85,67,10,8,24,89,62,49,7,6,27,176,130,108,18,4,46
S01007396,691,409,334,44,31,282,195,57,38,8,11,138,143,91,80,5,6,52,92,73,60,11,2,19,76,63,54,5,4,13,185,125,102,15,8,60
S01007397,794,455,369,69,17,339,145,42,30,10,2,103,125,75,61,8,6,50,110,73,60,11,2,37,85,61,48,12,1,24,329,204,170,28,6,125
S01007398,515,330,265,23,42,185,180,84,65,8,11,96,148,106,86,3,17,42,76,54,42,6,6,22,52,34,26,3,5,18,59,52,46,3,3,7
S01007399,503,312,222,27,63,191,202,89,57,10,22,113,133,101,67,5,29,32,59,40,29,4,7,19,41,32,26,4,2,9,68,50,43,4,3,18
S01007400,605,362,285,47,30,243,145,38,25,10,3,107,118,82,66,6,10,36,96,71,56,8,7,25,44,35,28,3,4,9,202,136,110,20,6,66
S01007401,570,373,314,37,22,197,96,32,24,7,1,64,116,82,70,7,5,34,102,69,58,6,5,33,67,51,46,1,4,16,189,139,116,16,7,50
S01007402,521,321,274,39,8,200,109,33,28,5,0,76,110,72,56,16,0,38,85,60,48,8,4,25,62,47,43,3,1,15,155,109,99,7,3,46
S01007403,551,434,377,32,25,117,53,24,19,3,2,29,148,114,95,7,12,34,126,103,93,4,6,23,75,62,56,4,2,13,149,131,114,14,3,18
S01007404,371,241,151,75,15,130,83,33,15,16,2,50,79,57,34,16,7,22,62,42,27,13,2,20,37,31,23,7,1,6,110,78,52,23,3,32
S01007405,550,376,288,73,15,174,62,30,14,14,2,32,97,61,43,15,3,36,85,62,47,12,3,23,55,46,39,3,4,9,251,177,145,29,3,74
S01007406,521,309,249,47,13,212,55,14,7,5,2,41,78,46,37,7,2,32,101,71,62,6,3,30,55,40,30,6,4,15,232,138,113,23,2,94
S01007407,598,358,291,54,13,240,92,24,16,6,2,68,118,68,51,14,3,50,100,70,58,10,2,30,75,56,47,6,3,19,213,140,119,18,3,73
S01007408,484,313,249,34,30,171,120,35,22,8,5,85,109,84,73,4,7,25,69,55,47,4,4,14,45,37,29,4,4,8,141,102,78,14,10,39
S01007409,614,390,340,34,16,224,174,58,49,8,1,116,154,108,91,10,7,46,98,83,73,6,4,15,64,51,46,5,0,13,124,90,81,5,4,34
S01007410,541,302,244,17,41,239,228,76,52,5,19,152,162,108,91,5,12,54,60,47,37,4,6,13,49,34,33,0,1,15,42,37,31,3,3,5
S01007411,699,411,318,29,64,288,267,85,61,3,21,182,206,144,101,9,34,62,63,51,42,5,4,12,67,58,50,4,4,9,96,73,64,8,1,23
S01007412,396,230,194,12,24,166,142,45,38,2,5,97,107,73,56,5,12,34,48,37,30,2,5,11,34,27,25,1,1,7,65,48,45,2,1,17
S01007413,721,564,476,53,35,157,93,43,32,9,2,50,212,158,135,9,14,54,147,126,112,11,3,21,87,79,69,5,5,8,182,158,128,19,11,24
S01007414,525,410,367,32,11,115,65,24,19,4,1,41,121,91,80,6,5,30,89,75,67,6,2,14,72,67,61,6,0,5,178,153,140,10,3,25
S01007415,677,414,341,27,46,263,306,134,107,9,18,172,198,137,112,6,19,61,47,36,34,1,1,11,49,44,38,1,5,5,77,63,50,10,3,14
S01007416,423,247,185,14,48,176,151,69,47,5,17,82,150,92,65,3,24,58,42,27,21,2,4,15,38,24,20,2,2,14,42,35,32,2,1,7
S01007417,793,579,502,47,30,214,124,47,41,3,3,77,181,127,111,9,7,54,132,110,94,11,5,22,94,76,66,6,4,18,262,219,190,18,11,43
S01007418,534,330,279,18,33,204,233,99,82,5,12,134,142,101,84,3,14,41,47,38,34,3,1,9,59,47,42,1,4,12,53,45,37,6,2,8
S01007419,650,437,337,23,77,213,220,109,79,5,25,111,211,151,115,5,31,60,94,75,61,2,12,19,50,39,32,4,3,11,75,63,50,7,6,12
S01007420,1283,607,500,64,43,676,340,71,55,8,8,269,379,174,144,15,15,205,182,97,82,6,9,85,124,64,54,9,1,60,258,201,165,26,10,57
S01007421,524,381,305,49,27,143,117,39,33,4,2,78,113,83,61,10,12,30,62,46,36,5,5,16,76,71,55,12,4,5,156,142,120,18,4,14
S01007422,492,299,242,37,20,193,143,46,30,10,6,97,104,75,57,7,11,29,60,41,37,3,1,19,48,35,26,7,2,13,137,102,92,10,0,35
S01007423,600,432,374,37,21,168,122,36,31,2,3,86,138,102,85,7,10,36,80,63,52,9,2,17,61,53,46,6,1,8,199,178,160,13,5,21
S01007424,673,413,376,29,8,260,139,38,34,4,0,101,129,81,73,5,3,48,135,98,90,7,1,37,64,42,39,2,1,22,206,154,140,11,3,52
S01007425,724,459,380,41,38,265,139,54,41,5,8,85,176,120,92,12,16,56,124,89,77,6,6,35,74,57,49,3,5,17,211,139,121,15,3,72
S01007426,543,317,254,35,28,226,162,54,41,5,8,108,135,99,73,10,16,36,64,47,41,3,3,17,44,30,27,3,0,14,138,87,72,14,1,51
S01007427,550,312,246,19,47,238,198,65,48,4,13,133,147,94,73,2,19,53,83,63,51,4,8,20,47,37,30,1,6,10,75,53,44,8,1,22
S01007428,749,456,379,36,41,293,227,68,52,6,10,159,193,131,102,9,20,62,104,79,68,5,6,25,70,60,51,7,2,10,155,118,106,9,3,37
S01007429,601,423,344,40,39,178,144,56,41,7,8,88,142,113,87,13,13,29,105,77,57,12,8,28,64,52,44,2,6,12,146,125,115,6,4,21
S01007430,395,238,191,30,17,157,105,27,19,4,4,78,84,61,49,6,6,23,50,36,27,6,3,14,33,29,24,2,3,4,123,85,72,12,1,38
S01007431,478,326,282,21,23,152,84,28,24,2,2,56,122,93,76,10,7,29,80,54,46,1,7,26,60,43,40,0,3,17,132,108,96,8,4,24
S01007432,708,415,350,41,24,293,265,86,65,14,7,179,167,119,105,7,7,48,99,76,64,5,7,23,64,50,45,5,0,14,113,84,71,10,3,29
S01007433,659,390,309,57,24,269,210,67,53,8,6,143,148,88,67,13,8,60,78,58,47,8,3,20,67,53,46,4,3,14,156,124,96,24,4,32
S01007434,402,262,196,26,40,140,151,70,44,10,16,81,113,83,61,6,16,30,55,39,31,4,4,16,31,28,23,2,3,3,52,42,37,4,1,10
S01007435,574,377,308,34,35,197,158,62,43,7,12,96,140,107,86,8,13,33,100,78,72,3,3,22,53,40,31,7,2,13,123,90,76,9,5,33
S01007436,543,336,279,20,37,207,180,70,59,5,6,110,161,120,91,8,21,41,51,39,33,1,5,12,48,37,35,1,1,11,103,70,61,5,4,33
S01007437,370,234,179,24,31,136,91,33,20,4,9,58,98,63,51,5,7,35,53,39,26,8,5,14,39,34,24,3,7,5,89,65,58,4,3,24
S01007438,572,348,280,25,43,224,191,65,49,8,8,126,142,93,72,6,15,49,71,55,45,1,9,16,65,55,44,6,5,10,103,80,70,4,6,23
S01007439,600,352,296,29,27,248,198,64,45,9,10,134,123,77,61,6,10,46,98,82,72,7,3,16,53,40,38,1,1,13,128,89,80,6,3,39
S01007440,539,335,281,28,26,204,200,75,57,11,7,125,130,103,86,9,8,27,78,63,54,4,5,15,50,35,29,2,4,15,81,59,55,2,2,22
S01007441,462,303,265,25,13,159,68,32,24,5,3,36,99,62,57,2,3,37,94,71,60,8,3,23,56,38,34,2,2,18,145,100,90,8,2,45
S01007442,418,258,216,35,7,160,57,22,18,3,1,35,89,49,35,11,3,40,64,42,36,4,2,22,54,37,32,4,1,17,154,108,95,13,0,46
S01007443,758,379,290,62,27,379,127,37,28,5,4,90,148,76,55,11,10,72,114,57,50,3,4,57,62,42,36,6,0,20,307,167,121,37,9,140
S01007444,773,424,319,89,16,349,107,24,15,7,2,83,128,60,44,12,4,68,104,64,49,12,3,40,45,32,25,6,1,13,389,244,186,52,6,145
S01007445,505,298,239,50,9,207,42,16,13,3,0,26,56,29,22,6,1,27,75,42,38,3,1,33,59,38,30,7,1,21,273,173,136,31,6,100
S01007446,422,268,201,52,15,154,40,7,2,4,1,33,66,42,34,4,4,24,60,42,32,5,5,18,24,16,11,3,2,8,232,161,122,36,3,71
S01007447,411,250,176,64,10,161,58,17,10,7,0,41,57,35,25,9,1,22,55,36,27,8,1,19,47,33,25,8,0,14,194,129,89,32,8,65
S01007448,736,454,347,80,27,282,189,61,38,19,4,128,170,115,88,16,11,55,105,78,60,13,5,27,83,57,44,8,5,26,189,143,117,24,2,46
S01007449,821,515,402,38,75,306,249,99,74,8,17,150,248,175,128,10,37,73,99,73,57,5,11,26,86,66,55,6,5,20,139,102,88,9,5,37
S01007450,598,357,276,25,56,241,227,81,59,6,16,146,181,130,95,8,27,51,69,51,39,7,5,18,59,50,43,2,5,9,62,45,40,2,3,17
S01007451,524,330,280,25,25,194,191,69,57,5,7,122,132,91,78,4,9,41,70,57,46,8,3,13,46,41,36,2,3,5,85,72,63,6,3,13
S01007452,414,257,180,37,40,157,145,70,51,6,13,75,111,76,45,11,20,35,52,40,28,9,3,12,22,19,13,5,1,3,84,52,43,6,3,32
S01007453,458,358,311,34,13,100,50,23,18,4,1,27,113,80,66,8,6,33,69,55,45,5,5,14,47,43,41,2,0,4,179,157,141,15,1,22
S01007454,418,279,223,28,28,139,168,79,63,6,10,89,118,90,76,6,8,28,48,40,28,8,4,8,35,28,21,3,4,7,49,42,35,5,2,7
S01007455,677,428,345,21,62,249,242,87,65,4,18,155,216,166,134,8,24,50,77,62,52,2,8,15,71,56,45,1,10,15,71,57,49,6,2,14
S01007456,702,430,347,22,61,272,256,98,74,4,20,158,246,180,142,8,30,66,63,43,37,3,3,20,62,51,43,2,6,11,75,58,51,5,2,17
S01007457,870,553,440,41,72,317,259,83,57,7,19,176,256,194,143,12,39,62,120,98,83,7,8,22,93,69,59,8,2,24,142,109,98,7,4,33
S01007458,443,288,259,19,10,155,90,30,25,4,1,60,117,84,70,6,8,33,75,57,54,3,0,18,69,52,49,2,1,17,92,65,61,4,0,27
S01007459,551,313,262,31,20,238,192,49,39,6,4,143,132,91,76,7,8,41,81,59,47,9,3,22,53,42,36,2,4,11,93,72,64,7,1,21
S01007460,619,364,282,43,39,255,218,61,45,4,12,157,180,136,102,18,16,44,99,74,58,7,9,25,53,38,35,3,0,15,69,55,42,11,2,14
S01007461,568,327,235,21,71,241,229,84,50,7,27,145,157,102,76,6,20,55,72,54,38,2,14,18,55,44,37,1,6,11,55,43,34,5,4,12
S01007462,661,462,388,43,31,199,170,56,40,7,9,114,178,136,107,15,14,42,99,89,81,7,1,10,76,63,56,7,0,13,138,118,104,7,7,20
S01007463,721,419,292,35,92,302,309,129,75,14,40,180,244,168,123,11,34,76,55,35,27,2,6,20,38,30,22,3,5,8,75,57,45,5,7,18
S01007464,548,286,232,10,44,262,246,85,67,1,17,161,157,101,82,1,18,56,58,42,37,2,3,16,35,25,22,0,3,10,52,33,24,6,3,19
S01007465,594,324,215,18,91,270,256,82,52,2,28,174,171,118,72,2,44,53,61,42,27,6,9,19,58,44,33,3,8,14,48,38,31,5,2,10
S01007466,851,490,372,31,87,361,318,89,59,3,27,229,233,162,116,9,37,71,111,92,77,7,8,19,71,55,41,5,9,16,118,92,79,7,6,26
S01007467,824,469,397,32,40,355,254,63,42,8,13,191,198,125,108,5,12,73,108,80,71,4,5,28,85,68,62,2,4,17,179,133,114,13,6,46
S01007468,607,429,376,36,17,178,115,41,32,7,2,74,179,129,109,13,7,50,105,82,78,2,2,23,72,62,53,5,4,10,136,115,104,9,2,21
S01007469,465,311,260,18,33,154,143,57,49,5,3,86,144,108,86,4,18,36,62,45,41,1,3,17,45,38,32,3,3,7,71,63,52,5,6,8
S01007470,572,320,248,26,46,252,188,60,43,6,11,128,162,105,73,8,24,57,60,34,26,4,4,26,76,57,48,4,5,19,86,64,58,4,2,22
S01007471,382,264,236,14,14,118,107,43,33,6,4,64,107,74,69,0,5,33,51,42,41,0,1,9,61,55,49,5,1,6,56,50,44,3,3,6
S01007472,458,256,210,13,33,202,194,58,45,4,9,136,111,75,62,2,11,36,60,47,43,0,4,13,44,35,25,6,4,9,49,41,35,1,5,8
S01007473,370,227,197,11,19,143,148,56,47,4,5,92,94,75,66,0,9,19,47,36,30,3,3,11,39,30,29,0,1,9,42,30,25,4,1,12
S01007474,445,313,263,35,15,132,88,45,35,8,2,43,95,66,53,8,5,29,89,74,62,8,4,15,65,52,47,3,2,13,108,76,66,8,2,32
S01007475,491,337,290,24,23,154,73,24,18,6,0,49,101,68,58,3,7,33,81,66,58,3,5,15,72,59,49,6,4,13,164,120,107,6,7,44
S01007476,565,313,264,29,20,252,155,52,41,4,7,103,119,81,72,5,4,38,83,55,45,7,3,28,69,48,39,5,4,21,139,77,67,8,2,62
S01007477,437,291,238,37,16,146,77,28,17,8,3,49,99,67,56,9,2,32,58,46,39,2,5,12,61,49,42,3,4,12,142,101,84,15,2,41
S01007478,751,474,398,46,30,277,193,42,33,6,3,151,116,77,60,9,8,39,109,87,76,9,2,22,84,70,58,6,6,14,249,198,171,16,11,51
S01007479,458,331,294,14,23,127,99,38,32,2,4,61,116,92,78,2,12,24,80,65,55,6,4,15,69,60,57,1,2,9,94,76,72,3,1,18
S01007480,609,476,428,25,23,133,124,59,51,6,2,65,179,150,132,5,13,29,99,90,81,4,5,9,79,70,65,3,2,9,128,107,99,7,1,21
S01007481,740,359,288,59,12,381,202,50,34,15,1,152,173,94,72,18,4,79,94,62,57,3,2,32,64,43,33,10,0,21,207,110,92,13,5,97
S01007482,408,197,167,18,12,211,198,50,43,5,2,148,89,58,45,7,6,31,37,28,25,0,3,9,28,26,24,2,0,2,56,35,30,4,1,21
S01007483,629,402,311,57,34,227,266,113,82,20,11,153,144,109,83,17,9,35,89,70,58,6,6,19,52,46,33,8,5,6,78,64,55,6,3,14
S01007484,470,277,193,36,48,193,188,59,37,9,13,129,125,87,57,16,14,38,62,52,35,4,13,10,38,30,23,2,5,8,57,49,41,5,3,8
S01007485,359,210,154,13,43,149,153,60,36,4,20,93,126,83,64,3,16,43,38,34,26,2,6,4,18,13,11,2,0,5,24,20,17,2,1,4
S01007486,382,193,134,8,51,189,180,63,42,2,19,117,127,81,54,4,23,46,34,22,21,0,1,12,18,12,6,1,5,6,23,15,11,1,3,8
S01007487,763,452,336,50,66,311,321,111,77,15,19,210,207,150,111,16,23,57,108,90,64,7,19,18,47,41,36,5,0,6,80,60,48,7,5,20
S01007488,838,535,420,71,44,303,258,84,53,21,10,174,226,164,129,22,13,62,137,110,85,15,10,27,71,58,49,3,6,13,146,119,104,10,5,27
S01007489,725,429,339,58,32,296,285,115,82,22,11,170,175,122,101,11,10,53,98,74,63,6,5,24,55,41,30,7,4,14,112,77,63,12,2,35
S01007490,757,397,318,46,33,360,375,117,90,15,12,258,179,127,106,11,10,52,98,79,62,11,6,19,38,26,23,1,2,12,67,48,37,8,3,19
S01007491,886,570,470,42,58,316,285,110,82,12,16,175,275,206,159,19,28,69,138,107,97,4,6,31,76,61,55,4,2,15,112,86,77,3,6,26
S01007492,597,358,301,29,28,239,274,106,86,9,11,168,138,108,92,6,10,30,65,52,44,5,3,13,50,44,38,4,2,6,70,48,41,5,2,22
S01007493,677,433,369,31,33,244,260,114,99,9,6,146,223,165,137,10,18,58,97,76,65,5,6,21,46,36,33,3,0,10,51,42,35,4,3,9
S01007494,448,258,164,79,15,190,155,55,28,23,4,100,108,78,45,26,7,30,57,45,33,10,2,12,43,27,18,7,2,16,85,53,40,13,0,32
S01007495,677,449,309,129,11,228,227,113,77,35,1,114,165,126,80,38,8,39,91,73,54,18,1,18,52,46,32,14,0,6,142,91,66,24,1,51
S01007496,882,481,313,142,26,401,266,95,54,35,6,171,183,118,74,38,6,65,121,80,55,21,4,41,69,48,39,7,2,21,243,140,91,41,8,103
S01007497,481,274,201,60,13,207,198,65,52,9,4,133,127,98,68,24,6,29,60,44,35,7,2,16,34,29,18,10,1,5,62,38,28,10,0,24
S01007498,737,393,294,72,27,344,323,102,73,22,7,221,168,125,90,21,14,43,89,62,48,12,2,27,44,32,24,5,3,12,113,72,59,12,1,41
S01007499,687,444,309,103,32,243,255,114,75,30,9,141,183,142,97,35,10,41,82,55,38,13,4,27,54,38,32,4,2,16,113,95,67,21,7,18
S01007500,516,260,168,71,21,256,197,54,34,14,6,143,108,63,37,18,8,45,68,53,36,16,1,15,41,31,18,9,4,10,102,59,43,14,2,43
S01007501,598,296,167,102,27,302,205,67,24,34,9,138,123,70,40,22,8,53,81,56,34,19,3,25,41,27,18,8,1,14,148,76,51,19,6,72
S01007502,447,261,177,72,12,186,157,53,31,20,2,104,119,84,48,28,8,35,66,53,42,10,1,13,26,20,13,6,1,6,79,51,43,8,0,28
S01007503,870,485,309,136,40,385,328,110,66,36,8,218,209,149,84,43,22,60,104,73,45,21,7,31,67,50,34,15,1,17,162,103,80,21,2,59
S01007504,588,351,204,124,23,237,192,70,37,28,5,122,132,101,55,35,11,31,89,61,37,21,3,28,40,30,16,13,1,10,135,89,59,27,3,46
S01007505,346,226,131,78,17,120,92,34,11,18,5,58,90,68,42,18,8,22,49,37,19,14,4,12,23,18,14,4,0,5,92,69,45,24,0,23
S01007506,426,240,140,91,9,186,124,38,18,19,1,86,82,57,30,25,2,25,58,42,30,10,2,16,37,24,9,15,0,13,125,79,53,22,4,46
S01007507,793,436,297,107,32,357,324,121,81,29,11,203,179,124,85,25,14,55,89,67,49,12,6,22,35,28,18,10,0,7,166,96,64,31,1,70
S01007508,604,348,234,98,16,256,239,101,55,36,10,138,121,89,59,26,4,32,71,55,41,12,2,16,36,23,15,8,0,13,137,80,64,16,0,57
S01007509,528,316,187,108,21,212,174,73,35,29,9,101,120,89,54,28,7,31,53,38,23,14,1,15,46,33,19,13,1,13,135,83,56,24,3,52
S01007510,862,416,269,125,22,446,303,97,64,28,5,206,198,119,78,32,9,79,93,57,37,18,2,36,68,45,29,16,0,23,200,98,61,31,6,102
S01007511,675,350,226,81,43,325,308,110,74,21,15,198,163,106,67,22,17,57,68,48,31,8,9,20,37,27,21,4,2,10,99,59,33,26,0,40
S01007512,449,247,143,90,14,202,132,57,34,22,1,75,105,70,42,22,6,35,50,36,22,12,2,14,31,20,11,9,0,11,131,64,34,25,5,67
S01007513,825,501,393,61,47,324,297,114,78,15,21,183,225,166,130,20,16,59,122,104,91,7,6,18,53,39,35,4,0,14,128,78,59,15,4,50
S01007514,445,274,210,46,18,171,176,72,59,11,2,104,104,75,58,7,10,29,64,48,31,12,5,16,21,18,13,4,1,3,80,61,49,12,0,19
S01007515,519,263,196,44,23,256,136,34,16,11,7,102,112,67,45,11,11,45,79,56,49,3,4,23,25,16,12,3,1,9,167,90,74,16,0,77
S01007516,475,305,240,36,29,170,191,88,64,13,11,103,137,100,75,10,15,37,70,60,53,5,2,10,23,18,17,0,1,5,54,39,31,8,0,15
S01007517,426,182,144,30,8,244,165,30,20,8,2,135,77,50,40,7,3,27,40,27,24,3,0,13,30,21,16,4,1,9,114,54,44,8,2,60
S01007518,699,393,318,47,28,306,297,95,72,15,8,202,176,132,107,10,15,44,94,69,59,8,2,25,43,37,31,5,1,6,89,60,49,9,2,29
S01007519,406,209,130,70,9,197,113,35,15,18,2,78,86,55,37,15,3,31,48,29,17,12,0,19,33,23,16,7,0,10,126,67,45,18,4,59
S01007520,810,433,310,94,29,377,269,89,62,18,9,180,198,131,94,24,13,67,107,68,54,13,1,39,67,46,29,13,4,21,169,99,71,26,2,70
S01007521,380,225,159,61,5,155,70,32,19,11,2,38,84,56,44,11,1,28,59,37,24,11,2,22,36,29,20,9,0,7,131,71,52,19,0,60
S01007522,868,436,317,92,27,432,279,82,58,20,4,197,166,110,86,18,6,56,115,87,61,19,7,28,68,45,27,16,2,23,240,112,85,19,8,128
S01007523,457,272,187,67,18,185,116,51,26,22,3,65,101,77,57,12,8,24,71,40,32,7,1,31,32,24,15,8,1,8,137,80,57,18,5,57
S01007524,818,496,325,150,21,322,238,89,49,38,2,149,209,158,107,44,7,51,94,67,47,15,5,27,58,44,32,9,3,14,219,138,90,44,4,81
S01007525,465,251,198,38,15,214,200,69,50,17,2,131,90,69,56,7,6,21,63,50,40,7,3,13,26,22,17,4,1,4,86,41,35,3,3,45
S01007526,633,311,226,61,24,322,195,66,43,13,10,129,137,87,68,12,7,50,84,50,39,8,3,34,48,33,22,9,2,15,169,75,54,19,2,94
S01007527,679,398,293,76,29,281,213,85,55,20,10,128,156,121,90,20,11,35,97,70,61,7,2,27,48,34,25,6,3,14,165,88,62,23,3,77
S01007528,633,393,289,75,29,240,231,88,59,24,5,143,154,120,85,22,13,34,84,64,51,6,7,20,51,45,38,6,1,6,113,76,56,17,3,37
S01007529,582,290,210,70,10,292,149,40,20,15,5,109,114,67,50,15,2,47,100,62,48,12,2,38,37,26,17,9,0,11,182,95,75,19,1,87
S01007530,446,278,175,95,8,168,91,41,23,17,1,50,100,70,42,26,2,30,66,49,38,10,1,17,35,24,14,8,2,11,154,94,58,34,2,60
S01007531,581,343,219,113,11,238,164,68,40,26,2,96,117,82,55,26,1,35,77,47,36,11,0,30,45,32,18,12,2,13,178,114,70,38,6,64
S01007532,480,302,196,90,16,178,111,41,23,16,2,70,130,97,65,22,10,33,70,56,40,16,0,14,39,26,14,11,1,13,130,82,54,25,3,48
S01007533,471,295,183,99,13,176,138,52,26,24,2,86,115,84,43,35,6,31,74,59,40,19,0,15,37,28,18,6,4,9,107,72,56,15,1,35
S01007534,790,440,334,78,28,350,293,81,66,10,5,212,200,142,104,25,13,58,100,76,64,9,3,24,55,40,34,5,1,15,142,101,66,29,6,41
S01007535,862,487,380,72,35,375,259,78,53,18,7,181,204,147,110,21,16,57,130,95,74,15,6,35,63,47,38,7,2,16,206,120,105,11,4,86
S01007536,783,482,373,79,30,301,275,95,61,26,8,180,198,138,107,19,12,60,121,101,87,10,4,20,73,63,45,12,6,10,116,85,73,12,0,31
S01007537,906,472,367,79,26,434,319,96,68,19,9,223,171,120,94,19,7,51,131,86,69,13,4,45,66,45,36,6,3,21,219,125,100,22,3,94
S01007538,760,476,320,134,22,284,210,69,40,26,3,141,178,131,89,29,13,47,104,88,58,26,4,16,66,47,29,17,1,19,202,141,104,36,1,61
S01007539,584,289,230,48,11,295,170,37,24,10,3,133,114,73,59,11,3,41,74,51,38,11,2,23,52,37,30,7,0,15,174,91,79,9,3,83
S01007540,722,384,304,53,27,338,265,75,60,13,2,190,192,132,100,21,11,60,92,66,52,8,6,26,54,41,35,3,3,13,119,70,57,8,5,49
S01007541,672,352,288,44,20,320,228,61,45,13,3,167,148,107,89,10,8,41,95,68,56,6,6,27,42,29,24,5,0,13,159,87,74,10,3,72
S01007542,712,464,341,67,56,248,231,88,56,18,14,143,210,157,108,26,23,53,100,88,70,9,9,12,55,39,34,3,2,16,116,92,73,11,8,24
S01007543,869,562,453,64,45,307,308,138,112,13,13,170,260,200,160,23,17,60,115,95,72,13,10,20,62,44,36,5,3,18,124,85,73,10,2,39
S01007544,930,437,259,162,16,493,207,60,27,29,4,147,159,83,52,25,6,76,116,71,39,30,2,45,72,49,33,16,0,23,376,174,108,62,4,202
S01007545,682,405,258,130,17,277,164,68,36,29,3,96,142,91,60,27,4,51,99,72,46,21,5,27,76,60,33,25,2,16,201,114,83,28,3,87
S01007546,458,302,211,78,13,156,129,47,28,18,1,82,91,70,51,15,4,21,66,50,33,15,2,16,36,29,21,6,2,7,136,106,78,24,4,30
S01007547,459,317,200,105,12,142,116,59,29,26,4,57,93,70,41,26,3,23,64,44,31,10,3,20,43,38,28,9,1,5,143,106,71,34,1,37
S01007548,578,361,264,71,26,217,152,56,38,11,7,96,133,87,61,17,9,46,89,68,47,15,6,21,55,44,36,7,1,11,149,106,82,21,3,43
S01007549,519,274,179,70,25,245,145,41,22,14,5,104,113,65,40,13,12,48,67,42,27,13,2,25,52,35,30,5,0,17,142,91,60,25,6,51
S01007550,789,381,264,98,19,408,232,49,35,12,2,183,161,110,76,24,10,51,91,55,35,19,1,36,70,35,28,5,2,35,235,132,90,38,4,103
S01007551,766,462,272,171,19,304,180,69,35,32,2,111,156,96,51,39,6,60,94,63,39,21,3,31,59,45,28,14,3,14,277,189,119,65,5,88
S01007552,737,439,333,51,55,298,310,120,88,11,21,190,222,162,131,15,16,60,80,61,42,12,7,19,55,44,31,7,6,11,70,52,41,6,5,18
S01007553,709,368,290,26,52,341,375,122,91,12,19,253,176,133,102,7,24,43,73,52,45,0,7,21,36,24,20,2,2,12,49,37,32,5,0,12
S01007554,371,159,125,9,25,212,210,55,45,3,7,155,93,61,48,3,10,32,28,16,13,1,2,12,23,16,12,0,4,7,17,11,7,2,2,6
S01007555,446,259,199,40,20,187,141,37,28,6,3,104,110,84,70,7,7,26,54,47,33,11,3,7,34,23,18,3,2,11,107,68,50,13,5,39
S01007556,439,230,176,29,25,209,225,65,47,8,10,160,109,83,67,10,6,26,36,29,23,3,3,7,22,18,14,1,3,4,47,35,25,7,3,12
S01007557,899,513,426,32,55,386,400,147,115,15,17,253,252,189,153,12,24,63,115,83,76,1,6,32,47,43,39,1,3,4,85,51,43,3,5,34
S01007558,366,202,132,58,12,164,114,41,27,9,5,73,84,54,35,15,4,30,47,29,20,8,1,18,41,27,18,9,0,14,80,51,32,17,2,29
S01007559,591,411,275,111,25,180,116,49,25,20,4,67,158,131,83,35,13,27,84,57,42,11,4,27,46,38,27,10,1,8,187,136,98,35,3,51
S01007560,796,432,343,70,19,364,296,85,68,16,1,211,169,117,91,19,7,52,90,65,50,8,7,25,51,42,32,8,2,9,190,123,102,19,2,67
S01007561,640,314,243,41,30,326,250,68,46,14,8,182,143,91,70,10,11,52,82,59,47,7,5,23,36,26,23,3,0,10,129,70,57,7,6,59
S01007562,688,420,297,97,26,268,160,49,30,15,4,111,180,125,89,24,12,55,110,78,58,18,2,32,48,35,25,7,3,13,190,133,95,33,5,57
S01007563,729,422,280,116,26,307,193,63,39,21,3,130,158,103,66,29,8,55,89,67,41,20,6,22,47,31,21,7,3,16,242,158,113,39,6,84
S01007564,652,410,256,132,22,242,177,73,44,25,4,104,136,97,54,31,12,39,81,52,39,11,2,29,62,52,32,19,1,10,196,136,87,46,3,60
S01007565,794,482,362,87,33,312,210,71,48,16,7,139,215,150,116,21,13,65,110,81,61,12,8,29,59,48,35,11,2,11,200,132,102,27,3,68
S01007566,603,376,262,93,21,227,162,64,40,21,3,98,158,120,81,29,10,38,88,60,43,14,3,28,56,41,31,9,1,15,139,91,67,20,4,48
S01007567,483,338,236,86,16,145,112,48,28,19,1,64,106,82,58,19,5,24,81,66,45,18,3,15,38,35,26,7,2,3,146,107,79,23,5,39
S01007568,550,355,276,68,11,195,126,49,31,18,0,77,122,85,65,19,1,37,74,48,33,11,4,26,52,45,37,4,4,7,176,128,110,16,2,48
S01007569,698,414,321,80,13,284,256,100,69,26,5,156,176,128,100,23,5,48,76,54,41,11,2,22,44,36,31,5,0,8,146,96,80,15,1,50
S01007570,567,365,283,59,23,202,133,52,39,10,3,81,142,94,70,12,12,48,76,58,46,10,2,18,41,32,23,7,2,9,175,129,105,20,4,46
S01007571,465,303,218,73,12,162,97,42,24,16,2,55,101,71,52,17,2,30,65,51,40,10,1,14,42,33,24,7,2,9,160,106,78,23,5,54
S01007572,788,459,357,67,35,329,285,77,52,17,8,208,199,150,114,20,16,49,117,81,62,15,4,36,46,42,35,5,2,4,141,109,94,10,5,32
S01007573,646,543,490,45,8,103,76,42,33,8,1,34,176,150,131,17,2,26,114,99,95,1,3,15,78,73,66,6,1,5,202,179,165,13,1,23
S01007574,820,514,431,35,48,306,346,133,102,12,19,213,243,189,160,10,19,54,96,77,65,7,5,19,66,57,56,1,0,9,69,58,48,5,5,11
S01007575,704,393,308,30,55,311,346,125,91,10,24,221,185,139,113,10,16,46,70,51,43,2,6,19,51,42,38,0,4,9,52,36,23,8,5,16
S01007576,542,319,212,17,90,223,246,103,61,5,37,143,173,128,84,4,40,45,45,33,28,1,4,12,43,37,29,3,5,6,35,18,10,4,4,17
S01007577,527,305,235,16,54,222,220,84,67,4,13,136,177,132,98,3,31,45,64,41,34,4,3,23,33,28,22,1,5,5,33,20,14,4,2,13
S01007578,540,325,257,22,46,215,244,95,75,3,17,149,169,127,93,12,22,42,59,50,43,5,2,9,37,31,26,1,4,6,31,22,20,1,1,9
S01007579,495,329,269,13,47,166,170,74,59,1,14,96,159,127,96,4,27,32,58,45,40,3,2,13,44,37,34,1,2,7,64,46,40,4,2,18
S01007580,638,389,319,16,54,249,261,107,86,3,18,154,232,167,128,8,31,65,56,49,45,1,3,7,45,38,34,3,1,7,44,28,26,1,1,16
S01007581,392,241,197,21,23,151,164,63,53,7,3,101,136,102,81,3,18,34,48,43,36,7,0,5,16,13,11,1,1,3,28,20,16,3,1,8
S01007582,533,339,278,23,38,194,214,93,77,10,6,121,172,125,96,6,23,47,63,50,41,3,6,13,37,32,25,4,3,5,47,39,39,0,0,8
S01007583,833,493,389,30,74,340,334,131,100,8,23,203,271,190,149,9,32,81,80,65,57,1,7,15,62,47,35,5,7,15,86,60,48,7,5,26
S01007584,493,330,264,30,36,163,189,87,64,11,12,102,155,121,100,8,13,34,56,48,39,2,7,8,36,28,25,2,1,8,57,46,36,7,3,11
S01007585,811,435,367,44,24,376,291,95,78,13,4,196,172,117,90,13,14,55,112,71,64,5,2,41,63,43,40,2,1,20,173,109,95,11,3,64
S01007586,670,422,345,29,48,248,217,84,64,9,11,133,219,158,131,6,21,61,97,81,69,4,8,16,51,38,30,2,6,13,86,61,51,8,2,25
S01007587,732,353,286,39,28,379,238,50,36,10,4,188,140,77,55,10,12,63,96,55,48,3,4,41,55,39,35,1,3,16,203,132,112,15,5,71
S01007588,711,410,337,62,11,301,140,33,23,9,1,107,140,96,78,12,6,44,101,68,60,7,1,33,53,33,25,8,0,20,277,180,151,26,3,97
S01007589,679,453,376,49,28,226,155,63,47,13,3,92,122,85,68,9,8,37,96,71,62,2,7,25,71,62,51,5,6,9,235,172,148,20,4,63
S01007590,539,295,239,46,10,244,106,22,18,4,0,84,92,48,36,10,2,44,85,58,49,8,1,27,48,37,28,7,2,11,208,130,108,17,5,78
S01007591,490,336,286,32,18,154,135,52,43,4,5,83,114,84,67,11,6,30,76,64,58,5,1,12,37,31,29,1,1,6,128,105,89,11,5,23
S01007592,580,366,310,22,34,214,197,76,62,6,8,121,150,119,99,5,15,31,87,67,58,4,5,20,41,31,26,3,2,10,105,73,65,4,4,32
S01007593,922,519,427,72,20,403,312,84,69,14,1,228,196,139,118,16,5,57,115,85,69,12,4,30,71,60,46,5,9,11,228,151,125,25,1,77
S01007594,712,454,361,75,18,258,246,93,69,20,4,153,165,125,105,15,5,40,92,81,70,6,5,11,56,43,32,10,1,13,153,112,85,24,3,41
S01007595,901,588,378,191,19,313,247,102,65,34,3,145,214,151,95,52,4,63,121,92,68,22,2,29,73,61,36,22,3,12,246,182,114,61,7,64
S01007596,483,253,172,68,13,230,156,45,28,13,4,111,113,78,59,16,3,35,60,42,26,13,3,18,27,15,11,4,0,12,127,73,48,22,3,54
S01007597,529,345,259,70,16,184,115,50,28,18,4,65,120,73,51,17,5,47,81,62,51,9,2,19,40,33,25,7,1,7,173,127,104,19,4,46
S01007598,551,355,272,64,19,196,140,59,39,12,8,81,137,100,77,17,6,37,78,57,47,8,2,21,40,30,24,6,0,10,156,109,85,21,3,47
S01007599,697,457,389,42,26,240,198,79,66,9,4,119,135,105,81,14,10,30,110,80,70,6,4,30,53,42,38,0,4,11,201,151,134,13,4,50
S01007600,952,542,448,73,21,410,243,66,43,18,5,177,168,106,83,16,7,62,119,86,68,13,5,33,71,47,39,7,1,24,351,237,215,19,3,114
S01007601,526,421,371,30,20,105,83,57,45,6,6,26,145,117,100,6,11,28,85,70,66,3,1,15,65,59,52,7,0,6,148,118,108,8,2,30
S01007602,528,385,333,36,16,143,102,53,45,6,2,49,140,102,81,12,9,38,84,70,66,1,3,14,51,40,36,3,1,11,151,120,105,14,1,31
S01007603,646,504,450,36,18,142,102,47,36,5,6,55,124,102,88,10,4,22,136,119,109,8,2,17,73,60,55,3,2,13,211,176,162,10,4,35
S01007604,760,469,418,41,10,291,174,46,37,9,0,128,171,122,110,8,4,49,124,91,79,9,3,33,78,54,49,4,1,24,213,156,143,11,2,57
S01007605,713,469,425,36,8,244,161,53,48,4,1,108,166,123,109,11,3,43,126,100,94,5,1,26,74,60,53,7,0,14,186,133,121,9,3,53
S01007606,522,331,277,32,22,191,117,39,30,7,2,78,127,97,79,11,7,30,75,61,52,3,6,14,44,32,23,4,5,12,159,102,93,7,2,57
S01007607,590,403,359,30,14,187,131,38,34,3,1,93,141,115,98,11,6,26,102,88,77,6,5,14,57,50,49,0,1,7,159,112,101,10,1,47
S01007608,640,414,374,32,8,226,133,37,32,5,0,96,166,127,106,17,4,39,91,74,68,5,1,17,61,46,44,1,1,15,189,130,124,4,2,59
S01007609,738,469,401,25,43,269,255,100,83,5,12,155,203,156,132,6,18,47,95,83,72,6,5,12,67,56,46,4,6,11,118,74,68,4,2,44
S01007610,450,246,205,15,26,204,181,42,37,3,2,139,102,75,58,5,12,27,54,43,39,1,3,11,32,27,20,2,5,5,81,59,51,4,4,22
S01007611,795,433,364,24,45,362,272,80,62,11,7,192,173,117,95,7,15,56,109,77,66,2,9,32,66,51,43,1,7,15,175,108,98,3,7,67
S01007612,938,619,477,55,87,319,279,104,65,10,29,175,230,180,132,19,29,50,161,135,109,10,16,26,89,75,64,4,7,14,179,125,107,12,6,54
S01007613,662,433,311,81,41,229,125,41,19,11,11,84,139,95,67,18,10,44,100,74,52,11,11,26,55,45,31,9,5,10,243,178,142,32,4,65
S01007614,695,440,376,49,15,255,99,36,28,6,2,63,145,89,77,11,1,56,95,72,64,4,4,23,56,36,31,4,1,20,300,207,176,24,7,93
S01007615,881,569,465,67,37,312,221,59,44,10,5,162,193,148,114,17,17,45,117,90,74,13,3,27,89,70,57,10,3,19,261,202,176,17,9,59
S01007616,610,402,341,29,32,208,183,73,52,7,14,110,155,118,104,7,7,37,87,72,63,7,2,15,70,53,44,5,4,17,115,86,78,3,5,29
S01007617,441,276,226,23,27,165,192,82,62,10,10,110,110,90,73,5,12,20,49,40,33,5,2,9,31,23,20,1,2,8,59,41,38,2,1,18
S01007618,517,291,252,15,24,226,250,86,74,6,6,164,142,113,96,6,11,29,41,29,27,1,1,12,38,30,24,1,5,8,46,33,31,1,1,13
S01007619,518,325,280,18,27,193,246,108,92,7,9,138,131,107,92,4,11,24,46,40,34,4,2,6,41,30,27,1,2,11,54,40,35,2,3,14
S01007620,507,324,272,42,10,183,152,61,45,14,2,91,145,100,81,13,6,45,54,47,43,4,0,7,50,40,35,3,2,10,106,76,68,8,0,30
S01007621,558,343,297,33,13,215,189,62,47,13,2,127,138,105,91,8,6,33,81,59,52,5,2,22,49,38,35,1,2,11,101,79,72,6,1,22
S01007622,471,290,244,33,13,181,177,64,52,9,3,113,109,77,66,8,3,32,64,52,44,5,3,12,48,40,33,5,2,8,73,57,49,6,2,16
S01007623,510,333,279,40,14,177,120,42,34,5,3,78,131,99,80,14,5,32,79,63,53,6,4,16,41,34,29,5,0,7,139,95,83,10,2,44
S01007624,539,400,361,33,6,139,145,65,54,10,1,80,141,111,100,8,3,30,88,76,70,5,1,12,56,53,51,2,0,3,109,95,86,8,1,14
S01007625,431,287,251,27,9,144,131,46,36,7,3,85,114,89,75,10,4,25,73,63,55,7,1,10,36,29,27,2,0,7,77,60,58,1,1,17
S01007626,501,407,365,32,10,94,105,55,48,6,1,50,140,122,109,12,1,18,89,79,73,5,1,10,54,52,48,0,4,2,113,99,87,9,3,14
S01007627,445,304,258,38,8,141,102,32,22,10,0,70,105,76,63,10,3,29,62,50,39,7,4,12,38,35,30,4,1,3,138,111,104,7,0,27
S01007628,605,346,279,54,13,259,171,47,30,14,3,124,112,85,66,19,0,27,92,62,49,6,7,30,62,44,39,4,1,18,168,108,95,11,2,60
S01007629,578,381,287,74,20,197,166,68,46,19,3,98,146,110,81,19,10,36,74,63,51,9,3,11,50,36,26,7,3,14,142,104,83,20,1,38
S01007630,696,483,348,118,17,213,164,73,42,28,3,91,163,128,93,29,6,35,126,86,56,26,4,40,63,55,45,10,0,8,180,141,112,25,4,39
S01007631,518,325,211,103,11,193,118,45,23,21,1,73,114,80,49,25,6,34,72,55,41,11,3,17,48,40,28,11,1,8,166,105,70,35,0,61
S01007632,803,500,410,60,30,303,247,93,67,21,5,154,201,147,123,11,13,54,116,93,82,7,4,23,67,51,38,10,3,16,172,116,100,11,5,56
S01007633,822,498,399,61,38,324,276,103,73,22,8,173,201,159,126,11,22,42,115,84,70,11,3,31,59,48,45,1,2,11,171,104,85,16,3,67
S01007634,485,314,236,59,19,171,151,59,31,22,6,92,122,88,64,13,11,34,63,48,39,8,1,15,39,31,24,7,0,8,110,88,78,9,1,22
S01007635,649,276,223,45,8,373,217,41,24,14,3,176,124,78,66,10,2,46,91,57,48,9,0,34,47,28,22,6,0,19,170,72,63,6,3,98
S01007636,743,398,310,55,33,345,278,75,55,17,3,203,181,134,100,14,20,47,104,73,58,8,7,31,47,34,30,2,2,13,133,82,67,14,1,51
S01007637,703,435,352,52,31,268,299,118,91,19,8,181,186,145,118,14,13,41,85,73,62,5,6,12,40,32,29,3,0,8,93,67,52,11,4,26
S01007638,653,395,321,44,30,258,222,65,45,10,10,157,161,129,99,19,11,32,89,66,57,5,4,23,48,41,40,0,1,7,133,94,80,10,4,39
S01007639,846,564,476,39,49,282,288,127,100,9,18,161,263,205,176,11,18,58,109,87,72,7,8,22,65,54,49,3,2,11,121,91,79,9,3,30
S01007640,600,390,257,109,24,210,175,71,43,22,6,104,138,103,64,29,10,35,80,64,37,24,3,16,52,40,27,12,1,12,155,112,86,22,4,43
S01007641,679,434,319,90,25,245,202,85,60,21,4,117,149,114,86,21,7,35,91,67,42,20,5,24,44,39,31,6,2,5,193,129,100,22,7,64
S01007642,718,381,265,100,16,337,200,57,31,22,4,143,151,87,59,26,2,64,102,71,53,13,5,31,44,31,26,3,2,13,221,135,96,36,3,86
S01007643,761,463,346,85,32,298,217,66,43,14,9,151,174,134,105,19,10,40,108,79,59,15,5,29,59,49,38,8,3,10,203,135,101,29,5,68
S01007644,698,371,288,60,23,327,199,78,62,10,6,121,185,119,95,11,13,66,77,52,41,8,3,25,50,24,20,4,0,26,187,98,70,27,1,89
S01007645,449,299,182,91,26,150,122,62,29,27,6,60,116,79,52,20,7,37,42,35,23,10,2,7,36,31,18,9,4,5,133,92,60,25,7,41
S01007646,534,323,203,98,22,211,133,50,27,17,6,83,117,86,62,18,6,31,96,67,39,22,6,29,42,32,18,13,1,10,146,88,57,28,3,58
S01007647,620,360,282,56,22,260,185,71,53,11,7,114,148,104,77,16,11,44,82,52,39,9,4,30,39,25,23,2,0,14,166,108,90,18,0,58
S01007648,743,459,366,70,23,284,253,88,68,15,5,165,193,144,113,27,4,49,94,80,70,7,3,14,55,42,33,6,3,13,148,105,82,15,8,43
S01007649,620,399,318,64,17,221,270,128,106,20,2,142,150,121,99,12,10,29,78,56,43,12,1,22,35,30,21,8,1,5,87,64,49,12,3,23
S01007650,827,518,373,120,25,309,297,128,81,38,9,169,204,148,96,46,6,56,102,82,67,11,4,20,42,36,32,3,1,6,182,124,97,22,5,58
S01007651,475,329,205,108,16,146,159,93,40,48,5,66,126,96,58,32,6,30,59,45,33,10,2,14,31,22,14,7,1,9,100,73,60,11,2,27
S01007652,503,268,200,52,16,235,212,63,39,18,6,149,127,91,71,17,3,36,53,39,27,9,3,14,35,26,23,1,2,9,76,49,40,7,2,27
S01007653,758,491,345,120,26,267,252,97,61,28,8,155,197,146,103,34,9,51,108,94,75,16,3,14,55,43,36,6,1,12,146,111,70,36,5,35
S01007654,907,533,409,93,31,374,355,135,103,21,11,220,253,179,135,32,12,74,116,98,79,16,3,18,52,38,29,7,2,14,131,83,63,17,3,48
S01007655,663,425,239,166,20,238,213,95,35,57,3,118,152,119,61,50,8,33,81,55,33,18,4,26,59,49,33,14,2,10,158,107,77,27,3,51
S01007656,716,436,302,112,22,280,225,87,47,35,5,138,183,138,89,39,10,45,96,61,45,14,2,35,59,49,36,9,4,10,153,101,85,15,1,52
S01007657,360,248,184,55,9,112,100,35,20,13,2,65,83,67,50,13,4,16,57,47,35,11,1,10,36,31,21,10,0,5,84,68,58,8,2,16
S01007658,429,264,184,65,15,165,115,44,26,16,2,71,117,80,52,21,7,37,45,29,21,7,1,16,38,32,25,6,1,6,114,79,60,15,4,35
S01007659,667,388,286,79,23,279,224,80,50,23,7,144,184,129,95,23,11,55,93,67,45,20,2,26,39,30,28,1,1,9,127,82,68,12,2,45
S01007660,680,429,359,35,35,251,262,110,87,12,11,152,217,168,141,8,19,49,86,66,57,8,1,20,38,32,27,5,0,6,77,53,47,2,4,24
S01007661,564,351,278,50,23,213,196,79,57,16,6,117,144,99,78,13,8,45,77,61,49,6,6,16,42,33,27,4,2,9,105,79,67,11,1,26
S01007662,775,422,343,40,39,353,316,82,52,20,10,234,205,150,127,6,17,55,86,64,56,5,3,22,51,38,34,2,2,13,117,88,74,7,7,29
S01007663,725,415,354,43,18,310,248,77,59,16,2,171,155,109,93,7,9,46,111,80,66,9,5,31,65,49,46,3,0,16,146,100,90,8,2,46
S01007664,485,292,238,29,25,193,199,71,59,7,5,128,144,109,90,6,13,35,52,41,32,7,2,11,41,31,26,2,3,10,49,40,31,7,2,9
S01007665,502,341,296,22,23,161,178,69,57,6,6,109,169,135,116,9,10,34,66,60,55,2,3,6,27,23,22,1,0,4,62,54,46,4,4,8
S01007666,415,247,220,23,4,168,135,31,28,1,2,104,85,62,57,5,0,23,65,52,43,7,2,13,39,32,31,1,0,7,91,70,61,9,0,21
S01007667,586,390,332,46,12,196,132,41,30,10,1,91,158,114,94,15,5,44,107,93,87,6,0,14,54,45,42,3,0,9,135,97,79,12,6,38
S01007668,879,516,440,29,47,363,426,150,124,7,19,276,226,188,163,9,16,38,88,79,66,5,8,9,50,41,37,2,2,9,89,58,50,6,2,31
S01007669,480,307,238,22,47,173,224,102,71,9,22,122,142,119,99,10,10,23,38,27,20,0,7,11,30,24,19,1,4,6,46,35,29,2,4,11
S01007670,539,355,283,19,53,184,195,89,63,5,21,106,162,138,112,4,22,24,66,52,43,3,6,14,40,27,23,1,3,13,76,49,42,6,1,27
S01007671,623,397,305,88,4,226,201,71,43,27,1,130,127,96,68,26,2,31,81,65,52,13,0,16,58,49,43,6,0,9,156,116,99,16,1,40
S01007672,770,398,325,61,12,372,197,42,31,9,2,155,167,114,96,11,7,53,91,59,50,8,1,32,72,48,42,5,1,24,243,135,106,28,1,108
S01007673,586,405,342,54,9,181,197,92,73,17,2,105,177,133,113,16,4,44,86,77,69,6,2,9,36,29,25,4,0,7,90,74,62,11,1,16
S01007674,665,399,334,24,41,266,303,133,106,8,19,170,198,139,117,5,17,59,77,62,54,5,3,15,35,22,22,0,0,13,52,43,35,6,2,9
S01007675,525,331,264,49,18,194,157,63,50,11,2,94,140,104,79,17,8,36,79,69,54,11,4,10,46,31,27,4,0,15,103,64,54,6,4,39
S01007676,573,401,277,112,12,172,197,85,45,37,3,112,148,125,89,29,7,23,81,72,52,18,2,9,42,38,26,12,0,4,105,81,65,16,0,24
S01007677,412,258,220,32,6,154,119,31,21,9,1,88,139,108,95,10,3,31,61,52,45,6,1,9,29,26,23,3,0,3,64,41,36,4,1,23
S01007678,668,373,315,33,25,295,335,124,105,4,15,211,167,118,97,17,4,49,75,65,59,1,5,10,21,17,15,2,0,4,70,49,39,9,1,21
S01007679,683,353,285,29,39,330,310,105,82,8,15,205,185,127,100,10,17,58,69,52,45,4,3,17,33,24,19,4,1,9,86,45,39,3,3,41
S01007680,783,522,438,65,19,261,252,102,86,13,3,150,254,214,175,28,11,40,79,61,51,8,2,18,49,37,28,7,2,12,149,108,98,9,1,41
S01007681,365,230,185,33,12,135,192,83,63,17,3,109,67,63,51,7,5,4,36,29,24,2,3,7,15,10,9,1,0,5,55,45,38,6,1,10
S01007682,766,478,375,76,27,288,98,31,23,5,3,67,111,69,42,17,10,42,111,72,59,10,3,39,67,53,47,4,2,14,379,253,204,40,9,126
S01007683,584,357,291,41,25,227,66,22,13,7,2,44,83,54,34,7,13,29,101,56,50,3,3,45,58,43,33,7,3,15,276,182,161,17,4,94
S01007684,694,369,310,43,16,325,82,11,9,2,0,71,98,42,35,3,4,56,108,53,45,4,4,55,59,49,38,7,4,10,347,214,183,27,4,133
S01007685,801,440,304,69,67,361,35,13,7,5,1,22,95,41,31,6,4,54,245,98,59,6,33,147,54,34,19,4,11,20,372,254,188,48,18,118
S01007686,591,344,297,37,10,247,65,13,9,3,1,52,86,42,33,7,2,44,90,42,35,3,4,48,48,35,31,4,0,13,302,212,189,20,3,90
S01007687,776,461,381,45,35,315,53,13,7,4,2,40,90,45,34,7,4,45,197,100,82,4,14,97,59,43,33,8,2,16,377,260,225,22,13,117
S01007688,930,557,455,44,58,373,62,19,15,3,1,43,90,57,42,8,7,33,230,96,73,4,19,134,110,79,68,5,6,31,438,306,257,24,25,132
S01007689,559,328,261,34,33,231,88,14,12,2,0,74,42,21,14,3,4,21,116,68,55,4,9,48,54,33,26,4,3,21,259,192,154,21,17,67
S01007690,822,399,331,31,37,423,94,16,14,1,1,78,64,34,21,5,8,30,274,117,100,5,12,157,75,52,43,3,6,23,315,180,153,17,10,135
S01007691,2819,1118,701,41,376,1701,143,45,20,5,20,98,256,97,50,4,43,159,1394,508,312,5,191,886,263,129,92,4,33,134,763,339,227,23,89,424
S01007692,865,441,346,31,64,424,63,16,14,0,2,47,88,57,38,8,11,31,305,102,76,2,24,203,84,58,48,1,9,26,325,208,170,20,18,117
S01007693,931,387,274,19,94,544,66,35,20,2,13,31,105,42,28,3,11,63,475,147,98,3,46,328,81,51,35,2,14,30,204,112,93,9,10,92
S01007694,1011,502,406,28,68,509,151,41,26,5,10,110,124,62,52,5,5,62,353,143,106,7,30,210,103,74,64,3,7,29,280,182,158,8,16,98
S01007695,894,461,372,35,54,433,217,34,26,4,4,183,106,60,46,6,8,46,134,67,50,5,12,67,69,41,34,3,4,28,368,259,216,17,26,109
S01007696,719,340,253,18,69,379,128,38,24,6,8,90,93,56,33,3,20,37,219,81,61,1,19,138,75,47,36,0,11,28,204,118,99,8,11,86
S01007697,886,461,389,34,38,425,224,30,20,5,5,194,123,77,64,5,8,46,124,71,57,6,8,53,82,51,42,3,6,31,333,232,206,15,11,101
S01007698,984,615,489,40,86,369,144,51,33,8,10,93,137,94,67,9,18,43,220,109,92,2,15,111,121,88,65,6,17,33,362,273,232,15,26,89
S01007699,691,427,349,23,55,264,118,46,30,4,12,72,119,70,53,5,12,49,120,81,64,1,16,39,80,59,55,1,3,21,254,171,147,12,12,83
S01007700,858,557,453,62,42,301,110,26,15,6,5,84,130,79,60,7,12,51,132,91,80,6,5,41,77,62,47,8,7,15,409,299,251,35,13,110
S01007701,492,258,189,7,62,234,135,47,30,2,15,88,91,49,32,0,17,42,85,44,32,0,12,41,44,27,16,1,10,17,137,91,79,4,8,46
S01007702,963,508,329,32,147,455,39,15,9,5,1,24,85,45,25,1,19,40,412,209,113,4,92,203,127,70,45,4,21,57,300,169,137,18,14,131
S01007703,696,405,330,38,37,291,151,36,32,2,2,115,127,80,64,6,10,47,117,72,51,10,11,45,75,64,57,4,3,11,226,153,126,16,11,73
S01007704,799,438,285,23,130,361,255,79,42,1,36,176,161,103,59,3,41,58,128,75,50,3,22,53,80,53,37,6,10,27,175,128,97,10,21,47
S01007705,735,389,277,15,97,346,36,21,11,0,10,15,86,47,30,1,16,39,256,125,82,6,37,131,96,59,41,1,17,37,261,137,113,7,17,124
S01007706,757,396,315,13,68,361,29,9,4,0,5,20,61,35,27,0,8,26,296,143,112,5,26,153,105,68,53,3,12,37,266,141,119,5,17,125
S01007707,766,506,433,38,35,260,36,17,11,3,3,19,70,55,46,4,5,15,152,70,56,6,8,82,82,58,45,8,5,24,426,306,275,17,14,120
S01007708,550,368,294,27,47,182,135,47,32,6,9,88,113,76,62,4,10,37,83,66,51,3,12,17,71,56,43,3,10,15,148,123,106,11,6,25
S01007709,530,292,226,14,52,238,156,47,26,4,17,109,106,58,42,3,13,48,71,39,32,2,5,32,63,47,36,1,10,16,134,101,90,4,7,33
S01007710,741,451,362,24,65,290,111,40,35,1,4,71,123,77,63,3,11,46,137,82,66,2,14,55,110,82,69,3,10,28,260,170,129,15,26,90
S01007711,980,535,432,20,83,445,240,70,58,6,6,170,157,101,79,4,18,56,232,144,111,3,30,88,102,77,62,2,13,25,249,143,122,5,16,106
S01007712,631,371,297,23,51,260,89,21,15,2,4,68,77,44,32,3,9,33,130,64,45,7,12,66,78,55,45,2,8,23,257,187,160,9,18,70
S01007713,417,249,185,29,35,168,111,35,24,4,7,76,93,64,45,8,11,29,65,43,31,6,6,22,46,35,27,5,3,11,102,72,58,6,8,30
S01007714,547,376,327,15,34,171,144,58,46,3,9,86,151,124,105,6,13,27,76,55,50,1,4,21,66,55,50,0,5,11,110,84,76,5,3,26
S01007715,434,250,196,11,43,184,121,40,27,1,12,81,96,56,41,2,13,40,52,35,24,2,9,17,50,44,37,4,3,6,115,75,67,2,6,40
S01007716,943,472,347,39,86,471,343,63,43,3,17,280,171,108,79,6,23,63,111,78,60,4,14,33,83,67,50,8,9,16,235,156,115,18,23,79
S01007717,840,470,345,38,87,370,276,93,62,11,20,183,217,149,99,10,40,68,77,47,38,3,6,30,83,64,49,5,10,19,187,117,97,9,11,70
S01007718,633,330,262,22,46,303,241,59,40,6,13,182,126,81,65,4,12,45,66,52,43,4,5,14,65,49,40,4,5,16,135,89,74,4,11,46
S01007719,880,491,402,28,61,389,352,91,67,5,19,261,191,126,98,12,16,65,85,59,53,1,5,26,89,73,58,5,10,16,163,142,126,5,11,21
S01007720,647,296,241,24,31,351,278,59,43,6,10,219,143,67,52,6,9,76,62,49,40,3,6,13,62,46,41,3,2,16,102,75,65,6,4,27
S01007721,646,389,315,32,42,257,222,70,49,6,15,152,145,103,79,11,13,42,89,70,59,5,6,19,74,52,45,3,4,22,116,94,83,7,4,22
S01007722,733,390,307,25,58,343,312,83,62,8,13,229,182,114,82,7,25,68,74,57,47,1,9,17,52,39,30,4,5,13,113,97,86,5,6,16
S01007723,851,396,331,16,49,455,389,87,77,2,8,302,181,104,83,4,17,77,69,49,40,1,8,20,81,57,45,1,11,24,131,99,86,8,5,32
S01007724,528,353,276,15,62,175,140,71,56,1,14,69,128,86,62,4,20,42,70,53,41,2,10,17,68,57,45,3,9,11,122,86,72,5,9,36
S01007725,690,416,325,21,70,274,235,75,54,3,18,160,201,135,100,7,28,66,72,61,45,5,11,11,75,61,49,4,8,14,107,84,77,2,5,23
S01007726,677,421,330,22,69,256,195,59,43,3,13,136,143,101,70,2,29,42,90,71,62,2,7,19,85,64,51,5,8,21,164,126,104,10,12,38
S01007727,876,507,372,41,94,369,243,77,51,5,21,166,192,133,82,17,34,59,127,65,51,0,14,62,101,74,60,4,10,27,213,158,128,15,15,55
S01007728,684,437,322,27,88,247,143,81,59,9,13,62,160,91,59,4,28,69,102,76,57,2,17,26,80,54,40,3,11,26,199,135,107,9,19,64
S01007729,664,470,362,29,79,194,129,66,44,2,20,63,150,112,81,6,25,38,102,73,58,6,9,29,82,67,53,3,11,15,201,152,126,12,14,49
S01007730,674,494,410,33,51,180,125,59,48,2,9,66,112,90,75,6,9,22,110,72,62,7,3,38,99,82,65,5,12,17,228,191,160,13,18,37
S01007731,615,472,407,26,39,143,104,46,37,1,8,58,157,110,86,9,15,47,96,87,76,3,8,9,77,61,53,4,4,16,181,168,155,9,4,13
S01007732,594,400,319,21,60,194,129,47,33,6,8,82,109,72,56,2,14,37,95,62,50,1,11,33,81,65,50,4,11,16,180,154,130,8,16,26
S01007733,685,479,389,59,31,206,95,32,21,9,2,63,139,93,69,13,11,46,104,69,57,6,6,35,69,59,44,10,5,10,278,226,198,21,7,52
S01007734,725,440,341,70,29,285,142,48,29,12,7,94,151,94,66,16,12,57,111,74,66,6,2,37,85,68,52,13,3,17,236,156,128,23,5,80
S01007735,716,452,375,49,28,264,144,49,31,10,8,95,172,118,93,12,13,54,96,68,59,7,2,28,79,58,52,3,3,21,225,159,140,17,2,66
S01007736,618,413,338,59,16,205,146,40,29,9,2,106,148,111,86,18,7,37,74,60,52,4,4,14,66,57,48,8,1,9,184,145,123,20,2,39
S01007737,887,525,422,56,47,362,248,63,45,8,10,185,211,137,107,15,15,74,113,79,67,5,7,34,100,76,61,10,5,24,215,170,142,18,10,45
S01007738,626,343,286,22,35,283,191,42,34,5,3,149,160,105,80,10,15,55,73,49,38,1,10,24,51,38,32,2,4,13,151,109,102,4,3,42
S01007739,541,237,198,18,21,304,223,34,22,7,5,189,131,75,61,6,8,56,59,39,30,2,7,20,46,33,31,1,1,13,82,56,54,2,0,26
S01007740,497,270,238,20,12,227,126,27,20,4,3,99,133,85,71,10,4,48,70,44,39,3,2,26,47,40,40,0,0,7,121,74,68,3,3,47
S01007741,658,308,253,21,34,350,253,35,26,4,5,218,134,75,58,7,10,59,82,65,53,3,9,17,78,54,45,2,7,24,111,79,71,5,3,32
S01007742,552,292,249,24,19,260,153,39,31,5,3,114,149,84,71,5,8,65,73,42,35,4,3,31,54,42,39,2,1,12,123,85,73,8,4,38
S01007743,724,463,375,32,56,261,232,88,66,6,16,144,224,154,113,11,30,70,90,75,64,5,6,15,69,60,58,1,1,9,109,86,74,9,3,23
S01007744,617,318,251,14,53,299,283,88,61,8,19,195,180,106,82,1,23,74,62,45,37,3,5,17,41,38,32,1,5,3,51,41,39,1,1,10
S01007745,583,349,287,25,37,234,222,78,48,11,19,144,178,132,114,6,12,46,62,51,47,2,2,11,48,33,29,2,2,15,73,55,49,4,2,18
S01007746,720,467,367,28,72,253,296,126,97,8,21,170,245,187,140,8,39,58,72,63,55,4,4,9,45,38,33,3,2,7,62,53,42,5,6,9
S01007747,417,254,194,15,45,163,154,61,41,6,14,93,150,105,83,2,20,45,38,31,23,3,5,7,29,20,16,3,1,9,46,37,31,1,5,9
S01007748,543,318,242,17,59,225,231,87,61,5,21,144,156,104,68,6,30,52,52,44,41,2,1,8,47,39,36,3,0,8,57,44,36,1,7,13
S01007749,583,355,306,31,18,228,134,44,37,4,3,90,149,91,75,9,7,58,102,79,66,9,4,23,61,44,40,3,1,17,137,97,88,6,3,40
S01007750,720,365,306,46,13,355,130,31,26,5,0,99,135,68,51,11,6,67,116,81,64,12,5,35,74,43,38,5,0,31,265,142,127,13,2,123
S01007751,676,294,225,58,11,382,143,23,15,8,0,120,108,42,33,6,3,66,91,46,38,7,1,45,60,44,38,5,1,16,274,139,101,32,6,135
S01007752,658,282,227,42,13,376,186,19,15,2,2,167,105,41,35,4,2,64,81,43,40,1,2,38,50,34,27,4,3,16,236,145,110,31,4,91
S01007753,416,251,208,16,27,165,156,65,54,5,6,91,133,91,74,5,12,42,48,38,28,5,5,10,39,28,25,1,2,11,40,29,27,0,2,11
S01007754,690,376,287,20,69,314,324,117,84,5,28,207,181,123,86,8,29,58,66,48,41,2,5,18,60,44,36,3,5,16,59,44,40,2,2,15
S01007755,676,345,270,16,59,331,319,91,70,7,14,228,186,123,93,3,27,63,66,49,43,1,5,17,53,43,34,1,8,10,52,39,30,4,5,13
S01007756,481,261,210,18,33,220,209,65,51,5,9,144,150,106,80,6,20,44,41,28,23,4,1,13,31,25,22,1,2,6,50,37,34,2,1,13
S01007757,718,361,300,48,13,357,109,23,15,6,2,86,183,91,69,18,4,92,85,46,40,5,1,39,92,55,49,3,3,37,249,146,127,16,3,103
S01007758,791,372,296,64,12,419,134,17,11,5,1,117,146,65,49,11,5,81,115,67,55,10,2,48,72,44,37,6,1,28,324,179,144,32,3,145
S01007759,869,494,406,48,40,375,246,60,44,7,9,186,157,98,75,10,13,59,104,76,62,10,4,28,89,70,58,9,3,19,273,190,167,12,11,83
S01007760,518,258,205,48,5,260,81,13,7,6,0,68,79,31,25,5,1,48,65,34,28,4,2,31,42,26,17,8,1,16,251,154,128,25,1,97
S01007761,727,464,370,76,18,263,84,26,18,6,2,58,104,51,42,5,4,53,100,66,52,10,4,34,69,57,46,10,1,12,370,264,212,45,7,106
S01007762,729,398,336,36,26,331,172,42,29,10,3,130,138,69,60,7,2,69,82,53,44,5,4,29,69,55,49,3,3,14,268,179,154,11,14,89
S01007763,483,193,158,21,14,290,207,29,23,5,1,178,106,51,39,5,7,55,48,32,28,3,1,16,47,31,25,4,2,16,75,50,43,4,3,25
S01007764,634,431,363,53,15,203,63,23,15,7,1,40,142,103,84,13,6,39,121,86,73,7,6,35,74,60,49,10,1,14,234,159,142,16,1,75
S01007765,568,308,271,24,13,260,79,19,17,2,0,60,128,61,48,8,5,67,90,59,52,4,3,31,70,49,41,5,3,21,201,120,113,5,2,81
S01007766,777,436,379,36,21,341,97,26,22,4,0,71,181,100,79,12,9,81,125,77,72,1,4,48,92,63,58,2,3,29,282,170,148,17,5,112
S01007767,762,446,379,56,11,316,126,31,22,7,2,95,167,90,80,10,0,77,109,92,81,10,1,17,93,68,56,7,5,25,267,165,140,22,3,102
S01007768,572,313,258,36,19,259,108,20,16,4,0,88,100,51,35,6,10,49,75,47,42,5,0,28,53,34,32,2,0,19,236,161,133,19,9,75
S01007769,641,335,266,53,16,306,110,27,15,11,1,83,121,66,51,10,5,55,89,55,44,9,2,34,63,38,30,7,1,25,258,149,126,16,7,109
S01007770,613,362,286,58,18,251,50,13,7,5,1,37,106,63,45,10,8,43,93,63,49,11,3,30,66,45,39,4,2,21,298,178,146,28,4,120
S01007771,450,220,183,26,11,230,65,11,9,1,1,54,68,35,27,6,2,33,67,43,34,2,7,24,43,23,20,3,0,20,207,108,93,14,1,99
S01007772,846,457,377,37,43,389,248,53,45,5,3,195,212,133,105,9,19,79,98,78,72,2,4,20,103,75,59,5,11,28,185,118,96,16,6,67
S01007773,642,399,344,40,15,243,111,37,27,7,3,74,159,100,82,11,7,59,102,83,69,11,3,19,65,49,46,3,0,16,205,130,120,8,2,75
S01007774,681,578,511,51,16,103,48,25,21,3,1,23,130,106,92,11,3,24,123,105,89,11,5,18,91,77,68,6,3,14,289,265,241,20,4,24
S01007775,755,484,417,42,25,271,138,25,22,2,1,113,186,117,96,14,7,69,91,72,63,5,4,19,76,63,53,5,5,13,264,207,183,16,8,57
S01007776,561,412,350,42,20,149,69,25,21,3,1,44,121,85,65,11,9,36,98,77,71,4,2,21,61,51,46,5,0,10,212,174,147,19,8,38
S01007777,671,571,494,60,17,100,56,33,25,6,2,23,122,102,75,19,8,20,123,109,94,9,6,14,91,82,73,9,0,9,279,245,227,17,1,34
S01007778,372,269,218,44,7,103,55,10,7,2,1,45,57,40,28,11,1,17,48,35,23,9,3,13,39,38,34,4,0,1,173,146,126,18,2,27
S01007779,608,428,371,33,24,180,150,71,53,10,8,79,187,139,118,10,11,48,83,75,67,5,3,8,77,58,55,3,0,19,111,85,78,5,2,26
S01007780,649,501,430,43,28,148,102,56,44,9,3,46,213,168,143,11,14,45,104,85,69,10,6,19,71,60,55,3,2,11,159,132,119,10,3,27
S01007781,736,580,499,37,44,156,162,92,74,9,9,70,227,184,158,7,19,43,105,91,72,12,7,14,84,73,65,4,4,11,158,140,130,5,5,18
S01007782,375,243,171,19,53,132,116,43,24,2,17,73,120,89,58,6,25,31,40,29,23,1,5,11,49,43,36,5,2,6,50,39,30,5,4,11
S01007783,637,288,211,11,66,349,349,112,77,5,30,237,150,85,63,1,21,65,45,29,21,1,7,16,41,26,21,0,5,15,52,36,29,4,3,16
S01007784,531,419,343,29,47,112,111,63,43,9,11,48,176,144,113,7,24,32,74,63,55,3,5,11,67,58,48,4,6,9,103,91,84,6,1,12
S01007785,438,252,187,10,55,186,187,67,49,2,16,120,129,87,62,3,22,42,41,36,24,3,9,5,32,24,19,0,5,8,49,38,33,2,3,11
S01007786,612,353,293,24,36,259,265,102,79,9,14,163,194,129,109,8,12,65,61,50,46,2,2,11,45,32,25,1,6,13,47,40,34,4,2,7
S01007787,522,317,251,26,40,205,211,96,72,8,16,115,163,115,94,8,13,48,48,38,27,5,6,10,47,31,29,2,0,16,53,37,29,3,5,16
S01007788,466,280,181,17,82,186,187,81,40,7,34,106,157,106,71,2,33,51,46,31,22,4,5,15,32,27,20,2,5,5,44,35,28,2,5,9
S01007789,459,288,221,18,49,171,141,62,41,7,14,79,171,118,90,6,22,53,53,38,28,3,7,15,50,34,29,1,4,16,44,36,33,1,2,8
S01007790,560,362,280,12,70,198,209,110,80,2,28,99,203,132,101,4,27,71,57,44,33,3,8,13,47,37,29,2,6,10,44,39,37,1,1,5
S01007791,400,300,254,35,11,100,97,40,31,6,3,57,84,67,55,8,4,17,57,49,39,7,3,8,42,35,30,4,1,7,120,109,99,10,0,11
S01007792,709,424,346,21,57,285,283,103,80,6,17,180,218,156,124,4,28,62,76,65,58,3,4,11,56,44,37,2,5,12,76,56,47,6,3,20
S01007793,724,369,285,24,60,355,333,108,81,6,21,225,207,137,99,11,27,70,60,39,32,2,5,21,63,43,37,2,4,20,61,42,36,3,3,19
S01007794,448,275,221,16,38,173,168,67,52,7,8,101,144,109,90,4,15,35,56,41,24,3,14,15,36,29,28,1,0,7,44,29,27,1,1,15
S01007795,458,303,256,14,33,155,170,82,72,7,3,88,159,112,91,4,17,47,41,35,27,0,8,6,33,29,27,0,2,4,55,45,39,3,3,10
S01007796,528,341,281,17,43,187,170,64,46,4,14,106,166,125,96,7,22,41,61,52,51,0,1,9,49,40,35,3,2,9,82,60,53,3,4,22
S01007797,406,225,177,11,37,181,197,71,53,4,14,126,121,89,68,3,18,32,32,25,22,2,1,7,25,17,13,2,2,8,31,23,21,0,2,8
S01007798,494,399,332,48,19,95,86,44,34,6,4,42,149,127,104,15,8,22,82,72,63,6,3,10,51,45,42,2,1,6,126,111,89,19,3,15
S01007799,430,365,306,36,23,65,49,36,26,7,3,13,131,104,80,13,11,27,79,69,57,7,5,10,47,41,39,1,1,6,124,115,104,8,3,9
S01007800,720,404,302,26,76,316,341,142,106,8,28,199,184,115,71,10,34,69,61,47,41,2,4,14,55,44,37,2,5,11,79,56,47,4,5,23
S01007801,799,398,266,16,116,401,348,136,89,7,40,212,178,99,63,5,31,79,154,93,58,2,33,61,57,34,25,2,7,23,62,36,31,0,5,26
S01007802,403,348,308,27,13,55,60,47,37,9,1,13,130,109,92,9,8,21,71,65,59,5,1,6,49,43,41,1,1,6,93,84,79,3,2,9
S01007803,808,408,308,17,83,400,370,113,75,8,30,257,232,155,113,5,37,77,68,41,31,2,8,27,73,49,43,1,5,24,65,50,46,1,3,15
S01007804,452,246,195,13,38,206,187,55,42,3,10,132,106,69,47,7,15,37,53,42,34,1,7,11,50,33,30,1,2,17,56,47,42,1,4,9
S01007805,366,244,190,11,43,122,148,71,49,6,16,77,102,75,57,2,16,27,38,31,30,0,1,7,28,21,16,1,4,7,50,46,38,2,6,4
S01007806,520,311,264,17,30,209,214,78,60,6,12,136,139,99,83,5,11,40,62,54,52,0,2,8,41,29,26,1,2,12,64,51,43,5,3,13
S01007807,548,392,337,32,23,156,108,44,34,5,5,64,142,109,87,10,12,33,95,73,64,8,1,22,77,66,58,5,3,11,126,100,94,4,2,26
S01007808,635,432,347,32,53,203,209,102,77,8,17,107,172,124,86,13,25,48,90,68,61,3,4,22,76,60,55,3,2,16,88,78,68,5,5,10
S01007809,790,489,426,45,18,301,173,50,35,13,2,123,199,132,110,16,6,67,115,82,72,4,6,33,80,68,63,4,1,12,223,157,146,8,3,66
S01007810,690,359,283,19,57,331,305,98,78,5,15,207,189,119,91,5,23,70,70,45,32,1,12,25,58,44,39,3,2,14,68,53,43,5,5,15
S01007811,638,417,347,15,55,221,273,136,110,4,22,137,189,134,113,1,20,55,60,50,42,1,7,10,53,42,33,6,3,11,63,55,49,3,3,8
S01007812,589,371,269,22,80,218,258,133,91,6,36,125,173,121,88,6,27,52,57,39,29,3,7,18,56,40,29,3,8,16,45,38,32,4,2,7
S01007813,580,347,272,13,62,233,256,123,85,6,32,133,152,104,86,3,15,48,39,26,25,0,1,13,63,43,34,1,8,20,70,51,42,3,6,19
S01007814,468,279,237,21,21,189,161,59,48,6,5,102,129,91,75,6,10,38,72,51,45,2,4,21,39,37,32,3,2,2,67,41,37,4,0,26
S01007815,808,501,437,39,25,307,214,67,49,11,7,147,211,135,113,12,10,76,108,85,74,6,5,23,91,77,71,5,1,14,184,137,130,5,2,47
S01007816,558,375,324,35,16,183,120,47,35,12,0,73,188,136,116,13,7,52,86,68,61,4,3,18,59,47,44,1,2,12,105,77,68,5,4,28
S01007817,393,209,184,13,12,184,177,61,50,6,5,116,84,57,50,4,3,27,51,34,30,1,3,17,32,21,18,2,1,11,49,36,36,0,0,13
S01007818,607,415,358,38,19,192,162,61,55,5,1,101,177,134,108,17,9,43,84,64,54,5,5,20,63,57,52,2,3,6,121,99,89,9,1,22
S01007819,675,418,358,38,22,257,214,71,54,10,7,143,188,125,106,13,6,63,76,61,49,7,5,15,68,55,50,3,2,13,129,106,99,5,2,23
S01007820,808,459,380,40,39,349,269,78,55,13,10,191,232,145,117,10,18,87,112,93,84,4,5,19,76,59,49,7,3,17,119,84,75,6,3,35
S01007821,469,299,263,21,15,170,142,52,46,4,2,90,132,92,77,5,10,40,54,40,36,4,0,14,54,48,42,4,2,6,87,67,62,4,1,20
S01007822,634,359,315,29,15,275,209,58,49,6,3,151,162,99,82,10,7,63,67,55,48,4,3,12,72,54,52,1,1,18,124,93,84,8,1,31
S01007823,611,400,344,35,21,211,116,41,27,12,2,75,157,93,82,4,7,64,106,85,76,6,3,21,58,48,43,3,2,10,174,133,116,10,7,41
S01007824,632,362,323,34,5,270,169,56,47,9,0,113,154,102,89,11,2,52,88,60,54,3,3,28,55,37,34,3,0,18,166,107,99,8,0,59
S01007825,876,511,424,59,28,365,234,73,48,16,9,161,229,134,103,23,8,95,115,85,75,7,3,30,91,68,65,2,1,23,207,151,133,11,7,56
S01007826,465,236,187,17,32,229,220,63,50,6,7,157,119,75,54,6,15,44,37,29,24,1,4,8,37,33,26,3,4,4,52,36,33,1,2,16
S01007827,495,368,308,24,36,127,98,39,30,2,7,59,122,96,71,7,18,26,67,52,44,4,4,15,72,62,51,7,4,10,136,119,112,4,3,17
S01007828,889,465,383,32,50,424,293,64,46,4,14,229,202,105,81,11,13,97,104,77,62,3,12,27,95,74,65,6,3,21,195,145,129,8,8,50
S01007829,539,233,204,19,10,306,229,40,35,5,0,189,106,48,37,6,5,58,52,40,34,3,3,12,50,37,34,2,1,13,102,68,64,3,1,34
S01007830,818,405,342,23,40,413,312,83,64,5,14,229,183,98,81,6,11,85,86,56,51,1,4,30,72,51,44,4,3,21,165,117,102,7,8,48
S01007831,742,350,279,23,48,392,263,56,35,6,15,207,190,101,75,6,20,89,83,57,52,2,3,26,78,51,40,5,6,27,128,85,77,4,4,43
S01007832,551,300,240,19,41,251,187,55,40,2,13,132,151,84,65,5,14,67,63,50,42,5,3,13,50,32,22,4,6,18,100,79,71,3,5,21
S01007833,731,255,210,21,24,476,335,54,42,7,5,281,167,72,58,8,6,95,54,34,27,1,6,20,65,42,36,0,6,23,110,53,47,5,1,57
S01007834,625,373,301,20,52,252,182,62,42,5,15,120,144,80,61,5,14,64,75,59,44,5,10,16,64,49,39,3,7,15,160,123,115,2,6,37
S01007835,580,353,295,28,30,227,153,44,32,3,9,109,133,85,70,8,7,48,75,59,50,4,5,16,57,42,38,2,2,15,162,123,105,11,7,39
S01007836,468,248,214,17,17,220,120,30,27,1,2,90,104,56,46,6,4,48,65,42,34,4,4,23,38,29,27,1,1,9,141,91,80,5,6,50
S01007837,695,382,328,44,10,313,140,36,22,11,3,104,167,91,78,10,3,76,109,78,69,7,2,31,98,64,57,5,2,34,181,113,102,11,0,68
S01007838,738,402,345,38,19,336,162,37,29,7,1,125,178,104,87,9,8,74,106,71,60,6,5,35,83,58,53,4,1,25,209,132,116,12,4,77
S01007839,651,284,231,24,29,367,244,40,32,3,5,204,116,67,51,7,9,49,96,43,30,5,8,53,37,20,16,1,3,17,158,114,102,8,4,44
S01007840,647,376,326,18,32,271,211,61,50,2,9,150,160,114,104,4,6,46,96,60,50,4,6,36,59,45,38,3,4,14,121,96,84,5,7,25
S01007841,566,365,296,21,48,201,170,60,43,5,12,110,205,151,122,9,20,54,65,52,43,3,6,13,39,33,29,0,4,6,87,69,59,4,6,18
S01007842,575,372,275,20,77,203,150,63,38,7,18,87,195,141,104,5,32,54,78,52,43,3,6,26,60,44,32,0,12,16,92,72,58,5,9,20
S01007843,578,347,279,17,51,231,167,66,48,2,16,101,185,118,88,7,23,67,78,53,46,5,2,25,53,39,33,0,6,14,95,71,64,3,4,24
S01007844,773,493,383,32,78,280,216,86,61,7,18,130,214,160,114,3,43,54,94,58,48,6,4,36,92,77,65,5,7,15,157,112,95,11,6,45
S01007845,669,388,308,23,57,281,282,96,67,7,22,186,171,115,90,6,19,56,74,64,52,3,9,10,51,44,36,3,5,7,91,69,63,4,2,22
S01007846,576,334,279,16,39,242,207,82,65,5,12,125,169,105,88,2,15,64,64,45,41,2,2,19,45,36,32,1,3,9,91,66,53,6,7,25
S01007847,737,438,361,23,54,299,271,92,75,4,13,179,214,151,118,9,24,63,91,72,61,4,7,19,58,46,39,0,7,12,103,77,68,6,3,26
S01007848,643,364,278,12,74,279,272,92,53,5,34,180,155,108,83,2,23,47,75,48,38,1,9,27,57,46,44,1,1,11,84,70,60,3,7,14
S01007849,688,422,354,21,47,266,245,94,70,6,18,151,236,167,143,6,18,69,81,63,55,4,4,18,55,45,38,2,5,10,71,53,48,3,2,18
S01007850,615,345,273,27,45,270,273,110,81,11,18,163,191,119,92,9,18,72,51,38,29,3,6,13,48,36,31,2,3,12,52,42,40,2,0,10
S01007851,811,378,319,34,25,433,347,76,64,7,5,271,187,109,85,13,11,78,91,62,55,3,4,29,64,50,43,4,3,14,122,81,72,7,2,41
S01007852,540,328,229,21,78,212,189,76,48,3,25,113,172,116,71,9,36,56,62,43,39,2,2,19,46,36,25,3,8,10,71,57,46,4,7,14
S01007853,576,252,175,14,63,324,270,65,44,2,19,205,126,80,46,6,28,46,63,32,22,1,9,31,50,31,26,2,3,19,67,44,37,3,4,23
S01007854,891,484,343,30,111,407,359,118,75,8,35,241,239,151,87,10,54,88,85,64,53,1,10,21,66,45,36,5,4,21,142,106,92,6,8,36
S01007855,428,265,194,19,52,163,167,61,38,4,19,106,97,74,56,2,16,23,56,40,20,9,11,16,47,39,33,2,4,8,61,51,47,2,2,10
S01007856,674,423,364,27,32,251,205,79,67,6,6,126,214,152,126,8,18,62,82,51,42,6,3,31,53,40,37,2,1,13,120,101,92,5,4,19
S01007857,384,215,178,12,25,169,131,44,31,6,7,87,130,85,73,1,11,45,37,26,22,0,4,11,38,28,22,3,3,10,48,32,30,2,0,16
S01007858,879,475,364,38,73,404,341,101,68,14,19,240,264,177,141,10,26,87,72,54,40,2,12,18,87,68,50,8,10,19,115,75,65,4,6,40
S01007859,389,214,164,17,33,175,161,57,42,4,11,104,124,80,60,6,14,44,28,18,15,1,2,10,35,24,19,4,1,11,41,35,28,2,5,6
S01007860,445,332,258,31,43,113,102,53,39,5,9,49,129,98,67,9,22,31,62,50,45,1,4,12,51,44,36,4,4,7,101,87,71,12,4,14
S01007861,533,320,262,14,44,213,235,102,79,6,17,133,150,105,87,3,15,45,56,44,35,3,6,12,46,38,32,1,5,8,46,31,29,1,1,15
S01007862,575,346,279,23,44,229,226,99,78,8,13,127,174,116,89,7,20,58,73,55,44,1,10,18,39,32,28,3,1,7,63,44,40,4,0,19
S01007863,676,382,287,17,78,294,286,118,75,10,33,168,234,153,114,4,35,81,46,38,31,1,6,8,63,40,37,2,1,23,47,33,30,0,3,14
S01007864,771,441,368,24,49,330,300,108,83,4,21,192,226,140,115,6,19,86,94,71,64,4,3,23,59,49,43,3,3,10,92,73,63,7,3,19
S01007865,487,417,369,28,20,70,54,31,26,5,0,23,120,94,73,10,11,26,76,68,57,6,5,8,56,52,48,3,1,4,181,172,165,4,3,9
S01007866,450,397,339,38,20,53,54,41,30,8,3,13,145,125,108,10,7,20,71,64,54,5,5,7,64,60,48,10,2,4,116,107,99,5,3,9
S01007867,411,251,206,34,11,160,86,28,22,3,3,58,84,52,37,13,2,32,45,27,25,1,1,18,51,33,25,5,3,18,145,111,97,12,2,34
S01007868,758,501,429,44,28,257,134,58,39,12,7,76,187,105,91,9,5,82,146,122,107,6,9,24,74,63,53,7,3,11,217,153,139,10,4,64
S01007869,782,524,443,53,28,258,132,40,32,7,1,92,141,96,82,8,6,45,91,64,50,5,9,27,65,55,48,4,3,10,353,269,231,29,9,84
S01007870,458,289,223,53,13,169,172,73,49,21,3,99,112,76,59,11,6,36,60,52,42,9,1,8,36,24,20,2,2,12,78,64,53,10,1,14
S01007871,524,264,182,27,55,260,278,92,52,12,28,186,141,92,67,6,19,49,56,44,33,6,5,12,20,16,14,0,2,4,29,20,16,3,1,9
S01007872,558,286,209,13,64,272,267,80,52,3,25,187,151,96,65,4,27,55,66,52,48,3,1,14,30,25,18,2,5,5,44,33,26,1,6,11
S01007873,598,330,271,37,22,268,258,73,64,2,7,185,153,112,92,12,8,41,77,61,52,6,3,16,39,35,28,4,3,4,71,49,35,13,1,22
S01007874,638,335,273,25,37,303,295,80,63,10,7,215,180,137,105,10,22,43,66,49,46,1,2,17,37,27,24,0,3,10,60,42,35,4,3,18
S01007875,442,285,237,20,28,157,140,53,43,2,8,87,110,84,71,4,9,26,61,50,37,5,8,11,41,32,30,2,0,9,90,66,56,7,3,24
S01007876,776,516,409,59,48,260,227,85,61,14,10,142,202,145,108,9,28,57,124,97,74,16,7,27,95,77,70,5,2,18,128,112,96,15,1,16
S01007877,642,364,292,34,38,278,290,89,68,9,12,201,166,128,103,7,18,38,74,65,55,6,4,9,50,32,29,1,2,18,62,50,37,11,2,12
S01007878,560,282,231,19,32,278,272,68,57,3,8,204,144,102,77,9,16,42,55,43,37,3,3,12,42,32,28,1,3,10,47,37,32,3,2,10
S01007879,588,319,261,13,45,269,257,85,68,6,11,172,157,98,78,1,19,59,78,60,49,3,8,18,50,41,33,3,5,9,46,35,33,0,2,11
S01007880,336,210,148,50,12,126,105,37,19,13,5,68,61,44,33,9,2,17,55,40,27,10,3,15,23,20,14,5,1,3,92,69,55,13,1,23
S01007881,452,256,177,41,38,196,175,62,42,13,7,113,126,81,50,12,19,45,48,35,26,5,4,13,48,38,27,4,7,10,55,40,32,7,1,15
S01007882,614,440,319,104,17,174,145,78,35,40,3,67,144,103,63,30,10,41,80,65,53,9,3,15,62,52,45,7,0,10,183,142,123,18,1,41
S01007883,873,576,475,63,38,297,258,88,58,17,13,170,205,152,120,18,14,53,125,97,80,15,2,28,101,84,73,5,6,17,184,155,144,8,3,29
S01007884,514,330,270,32,28,184,176,62,51,5,6,114,155,117,90,15,12,38,89,76,66,5,5,13,48,38,30,4,4,10,46,37,33,3,1,9
S01007885,613,345,242,26,77,268,292,108,71,6,31,184,169,114,77,10,27,55,55,40,31,3,6,15,51,47,33,4,10,4,46,36,30,3,3,10
S01007886,742,430,344,50,36,312,256,67,50,7,10,189,157,100,77,15,8,57,118,96,82,8,6,22,83,71,60,7,4,12,128,96,75,13,8,32
S01007887,481,321,231,79,11,160,117,35,19,14,2,82,118,85,54,29,2,33,78,61,44,14,3,17,53,42,31,9,2,11,115,98,83,13,2,17
S01007888,829,514,394,24,96,315,381,178,133,7,38,203,246,183,132,4,47,63,84,59,52,5,2,25,48,36,32,2,2,12,70,58,45,6,7,12
S01007889,443,244,208,11,25,199,211,67,55,3,9,144,117,88,74,4,10,29,48,37,33,1,3,11,34,29,27,1,1,5,33,23,19,2,2,10
S01007890,594,381,304,44,33,213,225,80,63,9,8,145,177,148,118,16,14,29,72,56,43,8,5,16,42,37,30,4,3,5,78,60,50,7,3,18
S01007891,714,452,387,35,30,262,271,101,80,11,10,170,193,145,127,9,9,48,100,76,65,6,5,24,52,45,40,3,2,7,98,85,75,6,4,13
S01007892,634,404,330,50,24,230,167,53,35,10,8,114,138,101,76,18,7,37,110,85,68,9,8,25,74,54,50,3,1,20,145,111,101,10,0,34
S01007893,868,521,409,81,31,347,233,66,46,14,6,167,206,132,92,25,15,74,123,95,77,13,5,28,87,68,58,8,2,19,219,160,136,21,3,59
S01007894,761,488,405,47,36,273,279,108,92,9,7,171,196,144,116,13,15,52,119,94,76,11,7,25,72,63,54,4,5,9,95,79,67,10,2,16
S01007895,462,259,210,31,18,203,138,34,25,4,5,104,96,69,53,9,7,27,72,52,39,10,3,20,44,28,24,3,1,16,112,76,69,5,2,36
S01007896,701,386,298,35,53,315,306,106,78,12,16,200,189,121,92,11,18,68,73,56,48,3,5,17,69,57,43,6,8,12,64,46,37,3,6,18
S01007897,358,245,163,69,13,113,96,42,14,24,4,54,85,63,46,15,2,22,55,43,29,9,5,12,38,33,24,7,2,5,84,64,50,14,0,20
S01007898,363,249,169,65,15,114,90,41,21,18,2,49,112,79,52,16,11,33,59,50,35,14,1,9,30,27,20,7,0,3,72,52,41,10,1,20
S01007899,308,211,136,66,9,97,99,56,22,32,2,43,78,58,37,17,4,20,54,39,29,9,1,15,29,24,19,4,1,5,48,34,29,4,1,14
S01007900,451,248,199,15,34,203,219,78,60,4,14,141,102,72,51,6,15,30,60,47,42,4,1,13,35,29,28,0,1,6,35,22,18,1,3,13
S01007901,576,334,264,27,43,242,242,91,72,7,12,151,171,129,98,10,21,42,73,51,42,4,5,22,41,31,27,1,3,10,49,32,25,5,2,17
S01007902,732,372,298,28,46,360,372,127,100,8,19,245,199,128,106,6,16,71,66,47,33,7,7,19,52,45,38,5,2,7,43,25,21,2,2,18
S01007903,563,262,199,30,33,301,246,62,46,10,6,184,138,90,74,6,10,48,65,42,32,6,4,23,52,39,26,4,9,13,62,29,21,4,4,33
S01007904,697,418,300,102,16,279,225,73,42,28,3,152,165,112,82,28,2,53,76,57,42,9,6,19,73,60,48,11,1,13,158,116,86,26,4,42
S01007905,547,302,226,9,67,245,267,109,77,1,31,158,169,110,84,3,23,59,48,36,29,1,6,12,28,19,16,0,3,9,35,28,20,4,4,7
S01007906,625,308,240,26,42,317,360,99,73,10,16,261,134,100,77,8,15,34,48,38,34,3,1,10,37,31,21,5,5,6,46,40,35,0,5,6
S01007907,475,246,203,15,28,229,236,74,58,3,13,162,106,76,62,5,9,30,52,41,36,2,3,11,30,24,22,0,2,6,51,31,25,5,1,20
S01007908,796,426,339,43,44,370,355,108,77,15,16,247,182,127,95,12,20,55,106,76,65,9,2,30,72,56,51,2,3,16,81,59,51,5,3,22
S01007909,422,264,222,20,22,158,147,52,42,5,5,95,121,94,79,6,9,27,73,53,39,9,5,20,42,35,32,0,3,7,39,30,30,0,0,9
S01007910,695,419,323,29,67,276,255,96,71,9,16,159,230,159,114,12,33,71,88,71,60,3,8,17,65,51,41,2,8,14,57,42,37,3,2,15
S01007911,633,381,326,30,25,252,240,86,64,13,9,154,161,110,97,7,6,51,99,78,68,6,4,21,69,55,49,2,4,14,64,52,48,2,2,12
S01007912,662,397,324,27,46,265,275,99,80,8,11,176,163,117,93,8,16,46,81,72,57,6,9,9,63,52,42,2,8,11,80,57,52,3,2,23
S01007913,509,274,214,23,37,235,248,78,55,12,11,170,144,107,86,5,16,37,54,41,33,4,4,13,35,30,25,1,4,5,28,18,15,1,2,10
S01007914,517,295,219,21,55,222,204,72,55,5,12,132,135,94,59,8,27,41,62,44,35,1,8,18,59,48,38,3,7,11,57,37,32,4,1,20
S01007915,686,426,342,32,52,260,245,94,78,8,8,151,185,134,99,8,27,51,100,74,58,8,8,26,83,69,59,5,5,14,73,55,48,3,4,18
S01007916,704,333,274,29,30,371,313,73,58,6,9,240,167,105,81,8,16,62,96,64,52,9,3,32,51,36,31,4,1,15,77,55,52,2,1,22
S01007917,731,420,340,30,50,311,314,113,92,12,9,201,208,149,116,7,26,59,83,64,54,3,7,19,53,44,34,4,6,9,73,50,44,4,2,23
S01007918,794,465,373,42,50,329,289,88,63,7,18,201,178,129,101,13,15,49,109,86,72,7,7,23,82,67,56,2,9,15,136,95,81,13,1,41
S01007919,649,402,339,45,18,247,142,42,32,10,0,100,121,78,64,9,5,43,106,75,65,7,3,31,80,67,59,3,5,13,200,140,119,16,5,60
S01007920,493,327,282,32,13,166,112,42,30,10,2,70,103,73,60,6,7,30,99,75,67,6,2,24,68,53,47,4,2,15,111,84,78,6,0,27
S01007921,776,420,321,39,60,356,365,109,78,12,19,256,215,169,127,12,30,46,89,66,55,6,5,23,48,38,35,2,1,10,59,38,26,7,5,21
S01007922,718,396,295,38,63,322,348,114,83,16,15,234,174,130,91,10,29,44,88,70,55,7,8,18,58,46,37,4,5,12,50,36,29,1,6,14
S01007923,814,527,438,58,31,287,282,114,95,14,5,168,209,156,126,21,9,53,106,86,67,12,7,20,77,64,54,5,5,13,140,107,96,6,5,33
S01007924,826,461,351,30,80,365,361,113,78,6,29,248,217,162,118,12,32,55,85,63,50,3,10,22,69,54,44,5,5,15,94,69,61,4,4,25
S01007925,387,272,164,91,17,115,88,42,12,27,3,46,69,56,30,22,4,13,63,41,33,5,3,22,49,44,24,17,3,5,118,89,65,20,4,29
S01007926,393,277,194,74,9,116,98,46,18,26,2,52,88,62,42,18,2,26,65,47,37,9,1,18,40,36,28,8,0,4,102,86,69,13,4,16
S01007927,525,376,246,117,13,149,131,57,27,28,2,74,86,64,35,27,2,22,81,68,46,20,2,13,64,56,39,14,3,8,163,131,99,28,4,32
S01007928,850,495,381,93,21,355,215,63,45,13,5,152,167,113,85,21,7,54,135,94,74,15,5,41,59,37,27,10,0,22,274,188,150,34,4,86
S01007929,598,437,293,129,15,161,111,55,25,27,3,56,128,100,58,37,5,28,99,68,48,17,3,31,62,50,38,12,0,12,198,164,124,36,4,34
S01007930,473,357,238,111,8,116,86,50,18,31,1,36,90,69,41,24,4,21,92,76,56,20,0,16,36,27,17,9,1,9,169,135,106,27,2,34
S01007931,912,535,445,65,25,377,219,58,46,6,6,161,155,94,69,14,11,61,118,76,60,12,4,42,84,63,57,5,1,21,336,244,213,28,3,92
S01007932,725,414,327,59,28,311,142,30,19,5,6,112,145,92,70,14,8,53,124,79,62,11,6,45,72,56,43,12,1,16,242,157,133,17,7,85
S01007933,650,437,347,52,38,213,156,68,53,8,7,88,145,90,68,10,12,55,111,84,66,8,10,27,61,53,42,6,5,8,177,142,118,20,4,35
S01007934,561,355,284,36,35,206,143,36,22,5,9,107,148,105,86,10,9,43,107,88,74,7,7,19,56,43,32,7,4,13,107,83,70,7,6,24
S01007935,678,417,316,52,49,261,173,35,21,8,6,138,145,105,73,15,17,40,110,85,66,9,10,25,82,71,57,6,8,11,168,121,99,14,8,47
S01007936,791,567,491,56,20,224,118,43,29,9,5,75,108,82,69,10,3,26,124,92,78,8,6,32,102,83,75,7,1,19,339,267,240,22,5,72
S01007937,865,603,495,73,35,262,155,48,37,6,5,107,202,143,113,21,9,59,143,116,97,11,8,27,89,78,67,6,5,11,276,218,181,29,8,58
S01007938,632,372,295,39,38,260,227,65,43,15,7,162,155,108,75,12,21,47,73,53,46,3,4,20,83,74,68,2,4,9,94,72,63,7,2,22
S01007939,713,424,318,30,76,289,260,95,66,10,19,165,211,145,98,9,38,66,85,66,56,3,7,19,78,59,46,6,7,19,79,59,52,2,5,20
S01007940,871,508,400,60,48,363,301,94,66,16,12,207,211,147,117,14,16,64,120,85,68,9,8,35,65,48,37,7,4,17,174,134,112,14,8,40
S01007941,544,368,308,40,20,176,132,52,37,11,4,80,132,104,79,14,11,28,98,74,67,5,2,24,64,50,44,5,1,14,118,88,81,5,2,30
S01007942,362,262,211,25,26,100,77,32,20,7,5,45,111,89,75,4,10,22,51,38,27,2,9,13,53,43,38,3,2,10,70,60,51,9,0,10
S01007943,564,312,250,32,30,252,204,66,48,9,9,138,122,81,63,6,12,41,79,63,46,9,8,16,51,29,28,1,0,22,108,73,65,7,1,35
S01007944,764,467,358,53,56,297,248,87,65,8,14,161,218,160,116,17,27,58,109,74,58,15,1,35,65,51,38,4,9,14,124,95,81,9,5,29
S01007945,723,401,282,63,56,322,233,66,37,13,16,167,171,103,70,11,22,68,105,72,49,12,11,33,62,52,40,8,4,10,152,108,86,19,3,44
S01007946,663,402,302,42,58,261,223,76,51,12,13,147,150,99,70,9,20,51,100,77,55,8,14,23,65,54,45,4,5,11,125,96,81,9,6,29
S01007947,618,364,290,43,31,254,172,60,43,7,10,112,127,76,61,10,5,51,105,75,61,8,6,30,69,52,39,9,4,17,145,101,86,9,6,44
S01007948,526,283,194,29,60,243,246,97,60,14,23,149,138,84,61,4,19,54,52,38,28,3,7,14,48,38,26,6,6,10,42,26,19,2,5,16
S01007949,654,401,342,27,32,253,172,48,34,5,9,124,159,114,92,10,12,45,112,86,72,7,7,26,93,78,73,3,2,15,118,75,71,2,2,43
S01007950,735,473,395,58,20,262,177,55,39,11,5,122,176,116,94,17,5,60,117,87,74,10,3,30,95,74,67,5,2,21,170,141,121,15,5,29
S01007951,619,404,329,35,40,215,184,70,49,11,10,114,177,130,98,12,20,47,71,50,40,5,5,21,66,57,48,4,5,9,121,97,94,3,0,24
S01007952,543,297,208,44,45,246,229,58,34,16,8,171,124,91,63,10,18,33,75,60,46,6,8,15,50,39,30,3,6,11,65,49,35,9,5,16
S01007953,763,487,387,47,53,276,277,113,89,13,11,164,211,152,115,14,23,59,106,81,62,9,10,25,74,65,53,6,6,9,95,76,68,5,3,19
S01007954,586,337,263,17,57,249,244,86,66,3,17,158,165,108,80,6,22,57,61,47,41,1,5,14,57,53,43,4,6,4,59,43,33,3,7,16
S01007955,636,442,347,24,71,194,241,120,91,8,21,121,213,174,134,7,33,39,73,57,49,2,6,16,60,48,38,3,7,12,49,43,35,4,4,6
S01007956,577,376,295,25,56,201,211,87,66,4,17,124,185,140,106,10,24,45,64,52,43,2,7,12,71,62,51,4,7,9,46,35,29,5,1,11
S01007957,795,436,370,28,38,359,352,105,88,11,6,247,185,134,112,7,15,51,95,64,56,1,7,31,67,56,50,2,4,11,96,77,64,7,6,19
S01007958,740,426,322,22,82,314,312,114,75,6,33,198,179,130,99,6,25,49,91,63,50,4,9,28,72,59,44,3,12,13,86,60,54,3,3,26
S01007959,690,417,356,36,25,273,278,97,77,12,8,181,144,106,90,8,8,38,85,69,59,7,3,16,63,53,48,2,3,10,120,92,82,7,3,28
S01007960,571,370,309,22,39,201,220,97,73,7,17,123,145,106,89,6,11,39,72,55,49,2,4,17,68,56,47,3,6,12,66,56,51,4,1,10
S01007961,1103,477,296,155,26,626,402,92,50,33,9,310,288,116,72,38,6,172,130,85,47,30,8,45,95,60,45,15,0,35,188,124,82,39,3,64
S01007962,443,284,218,28,38,159,128,50,35,6,9,78,141,93,71,6,16,48,64,53,39,10,4,11,49,39,35,0,4,10,61,49,38,6,5,12
S01007963,702,369,222,27,120,333,348,142,74,11,57,206,211,127,72,9,46,84,56,33,27,2,4,23,49,39,25,3,11,10,38,28,24,2,2,10
S01007964,643,358,275,25,58,285,290,104,82,5,17,186,181,130,92,8,30,51,68,46,40,2,4,22,47,36,30,4,2,11,57,42,31,6,5,15
S01007965,456,274,224,14,36,182,173,64,54,1,9,109,135,88,64,6,18,47,75,65,56,5,4,10,44,32,26,1,5,12,29,25,24,1,0,4
S01007966,733,400,309,19,72,333,346,133,93,7,33,213,194,130,100,3,27,64,61,39,34,1,4,22,64,45,37,3,5,19,68,53,45,5,3,15
S01007967,464,296,223,14,59,168,189,88,59,4,25,101,137,96,72,2,22,41,63,50,40,3,7,13,47,37,33,1,3,10,28,25,19,4,2,3
S01007968,741,421,352,24,45,320,322,98,75,6,17,224,183,136,112,10,14,47,86,65,58,1,6,21,75,64,56,2,6,11,75,58,51,5,2,17
S01007969,700,404,337,29,38,296,289,95,72,13,10,194,163,119,95,6,18,44,83,63,53,4,6,20,80,61,57,2,2,19,85,66,60,4,2,19
S01007970,707,451,373,25,53,256,295,115,85,16,14,180,183,145,118,4,23,38,83,65,59,0,6,18,74,67,57,4,6,7,72,59,54,1,4,13
S01007971,796,450,363,23,64,346,324,88,65,8,15,236,222,172,133,6,33,50,86,63,51,5,7,23,69,57,51,0,6,12,95,70,63,4,3,25
S01007972,705,447,371,26,50,258,297,108,90,10,8,189,198,162,126,8,28,36,82,68,60,2,6,14,61,53,46,3,4,8,67,56,49,3,4,11
S01007973,724,485,431,38,16,239,185,76,61,10,5,109,183,132,118,10,4,51,110,87,75,8,4,23,84,78,73,3,2,6,162,112,104,7,1,50
S01007974,699,376,314,22,40,323,310,83,67,5,11,227,190,134,108,9,17,56,80,63,53,6,4,17,52,42,37,1,4,10,67,54,49,1,4,13
S01007975,561,321,256,23,42,240,232,69,56,5,8,163,137,109,83,7,19,28,75,53,41,6,6,22,47,36,28,2,6,11,70,54,48,3,3,16
S01007976,645,354,274,27,53,291,296,84,56,6,22,212,113,81,58,7,16,32,76,59,47,8,4,17,71,60,50,3,7,11,89,70,63,3,4,19
S01007977,558,392,343,31,18,166,124,49,43,4,2,75,133,90,73,9,8,43,71,57,50,6,1,14,66,53,50,2,1,13,164,143,127,10,6,21
S01007978,505,348,289,19,40,157,146,46,35,3,8,100,103,76,59,5,12,27,78,68,50,6,12,10,70,65,58,3,4,5,108,93,87,2,4,15
S01007979,707,469,386,53,30,238,141,49,43,3,3,92,125,82,56,14,12,43,114,85,72,7,6,29,87,75,61,8,6,12,240,178,154,21,3,62
S01007980,611,370,304,35,31,241,184,58,40,9,9,126,143,90,74,7,9,53,91,71,60,4,7,20,65,59,52,7,0,6,128,92,78,8,6,36
S01007981,488,267,216,37,14,221,163,45,30,10,5,118,106,62,50,8,4,44,66,46,34,9,3,20,45,31,29,2,0,14,108,83,73,8,2,25
S01007982,439,260,226,23,11,179,127,44,36,7,1,83,103,68,58,6,4,35,57,43,37,2,4,14,49,34,32,2,0,15,103,71,63,6,2,32
S01007983,649,335,257,26,52,314,287,76,59,7,10,211,165,109,79,4,26,56,68,43,34,2,7,25,70,59,47,6,6,11,59,48,38,7,3,11
S01007984,681,396,328,30,38,285,241,73,56,7,10,168,146,107,87,6,14,39,78,54,45,4,5,24,74,57,48,4,5,17,142,105,92,9,4,37
S01007985,744,430,330,25,75,314,288,96,74,5,17,192,231,162,116,10,36,69,97,70,49,3,18,27,68,58,50,5,3,10,60,44,41,2,1,16
S01007986,475,279,240,17,22,196,181,65,55,4,6,116,119,78,63,7,8,41,67,48,40,3,5,19,51,40,36,1,3,11,57,48,46,2,0,9
S01007987,621,419,357,30,32,202,188,67,54,9,4,121,140,109,84,7,18,31,103,85,80,3,2,18,70,58,52,2,4,12,120,100,87,9,4,20
S01007988,667,375,316,21,38,292,262,86,67,10,9,176,173,112,97,3,12,61,95,70,57,3,10,25,66,55,47,3,5,11,71,52,48,2,2,19
S01007989,551,369,297,27,45,182,167,83,63,9,11,84,163,116,83,11,22,47,89,62,56,2,4,27,74,60,52,2,6,14,58,48,43,3,2,10
S01007990,683,509,422,27,60,174,154,75,55,10,10,79,216,167,134,7,26,49,111,91,76,2,13,20,94,83,73,2,8,11,108,93,84,6,3,15
S01007991,720,594,516,52,26,126,86,52,38,13,1,34,134,107,86,13,8,27,144,118,101,12,5,26,100,90,82,1,7,10,256,227,209,13,5,29
S01007992,494,396,338,46,12,98,65,35,25,10,0,30,106,78,65,10,3,28,88,74,62,10,2,14,77,65,55,7,3,12,158,144,131,9,4,14
S01007993,703,503,429,47,27,200,139,64,51,8,5,75,166,125,102,16,7,41,127,100,86,9,5,27,89,73,59,7,7,16,182,141,131,7,3,41
S01007994,605,507,434,52,21,98,56,37,28,6,3,19,129,95,76,16,3,34,97,78,68,8,2,19,111,99,87,6,6,12,212,198,175,16,7,14
S01007995,683,540,482,35,23,143,103,54,43,4,7,49,180,134,114,12,8,46,121,99,89,5,5,22,73,66,63,2,1,7,206,187,173,12,2,19
S01007996,392,251,202,39,10,141,90,34,24,8,2,56,71,52,35,14,3,19,71,50,43,5,2,21,38,32,25,5,2,6,122,83,75,7,1,39
S01007997,581,358,288,51,19,223,110,45,28,10,7,65,94,61,51,7,3,33,91,64,54,6,4,27,58,41,30,10,1,17,228,147,125,18,4,81
S01007998,451,274,218,45,11,177,80,21,10,6,5,59,72,42,33,7,2,30,83,64,54,8,2,19,49,38,28,9,1,11,167,109,93,15,1,58
S01007999,544,353,289,29,35,191,232,107,79,14,14,125,161,123,101,8,14,38,63,49,42,3,4,14,42,37,32,2,3,5,46,37,35,2,0,9
S01008000,733,415,329,20,66,318,307,100,75,6,19,207,208,146,111,4,31,62,75,61,49,4,8,14,69,55,49,2,4,14,74,53,45,4,4,21
S01008001,655,367,272,14,81,288,309,121,84,2,35,188,180,120,83,3,34,60,68,53,41,4,8,15,56,41,36,3,2,15,42,32,28,2,2,10
S01008002,611,377,245,39,93,234,267,123,77,9,37,144,167,105,67,8,30,62,59,54,34,5,15,5,51,45,32,8,5,6,67,50,35,9,6,17
S01008003,533,316,255,29,32,217,217,68,50,9,9,149,122,93,71,11,11,29,54,41,32,3,6,13,49,41,38,1,2,8,91,73,64,5,4,18
S01008004,465,354,305,24,25,111,93,52,39,7,6,41,124,93,80,5,8,31,70,57,45,5,7,13,63,49,46,1,2,14,115,103,95,6,2,12
S01008005,397,322,270,27,25,75,49,24,17,6,1,25,106,81,59,7,15,25,72,66,60,3,3,6,58,47,40,4,3,11,112,104,94,7,3,8
S01008006,445,217,158,15,44,228,230,72,55,3,14,158,113,72,48,8,16,41,48,27,16,3,8,21,28,27,23,1,3,1,26,19,16,0,3,7
S01008007,336,221,161,7,53,115,141,74,48,2,24,67,82,58,39,2,17,24,40,32,23,0,9,8,31,25,22,0,3,6,42,32,29,3,0,10
S01008008,459,294,228,24,42,165,167,67,43,8,16,100,126,90,70,5,15,36,58,50,36,8,6,8,47,38,33,2,3,9,61,49,46,1,2,12
S01008009,590,363,271,31,61,227,188,72,43,8,21,116,142,96,63,10,23,46,79,53,44,4,5,26,76,55,43,2,10,21,105,87,78,7,2,18
S01008010,747,487,351,43,93,260,250,90,54,9,27,160,197,146,90,9,47,51,106,86,68,6,12,20,83,73,60,9,4,10,111,92,79,10,3,19
S01008011,612,311,231,19,61,301,290,60,35,3,22,230,106,74,49,5,20,32,50,40,32,1,7,10,57,46,34,4,8,11,109,91,81,6,4,18
S01008012,701,460,369,47,44,241,184,54,38,10,6,130,161,114,95,5,14,47,95,77,58,9,10,18,89,72,58,5,9,17,172,143,120,18,5,29
S01008013,620,338,279,36,23,282,232,38,30,3,5,194,107,73,56,9,8,34,73,56,44,10,2,17,56,45,40,2,3,11,152,126,109,12,5,26
S01008014,545,350,289,33,28,195,144,38,22,9,7,106,127,93,74,7,12,34,85,65,53,6,6,20,56,49,45,3,1,7,133,105,95,8,2,28
S01008015,663,394,330,19,45,269,258,86,66,5,15,172,155,103,86,7,10,52,73,61,50,1,10,12,66,52,44,3,5,14,111,92,84,3,5,19
S01008016,689,394,313,41,40,295,276,76,50,11,15,200,172,122,97,11,14,50,74,59,44,11,4,15,67,54,47,3,4,13,100,83,75,5,3,17
S01008017,787,427,364,46,17,360,191,37,28,7,2,154,120,67,52,11,4,53,132,92,82,5,5,40,71,53,49,3,1,18,273,178,153,20,5,95
S01008018,573,321,272,38,11,252,142,33,26,4,3,109,109,70,58,9,3,39,80,54,46,7,1,26,51,39,33,6,0,12,191,125,109,12,4,66
S01008019,620,386,307,60,19,234,125,22,15,4,3,103,96,66,48,14,4,30,89,64,49,9,6,25,77,55,49,5,1,22,233,179,146,28,5,54
S01008020,524,367,309,42,16,157,131,48,35,10,3,83,97,80,68,9,3,17,91,66,55,8,3,25,58,47,39,7,1,11,147,126,112,8,6,21
S01008021,482,288,233,43,12,194,93,29,18,9,2,64,91,52,40,9,3,39,89,65,54,8,3,24,60,41,33,7,1,19,149,101,88,10,3,48
S01008022,605,391,326,47,18,214,116,45,33,10,2,71,106,69,56,9,4,37,114,82,68,7,7,32,78,59,49,8,2,19,191,136,120,13,3,55
S01008023,549,421,351,51,19,128,82,42,34,6,2,40,128,99,70,19,10,29,107,88,71,12,5,19,64,55,50,4,1,9,168,137,126,10,1,31
S01008024,482,430,367,48,15,52,23,12,9,2,1,11,91,80,60,14,6,11,86,75,66,7,2,11,84,81,69,9,3,3,198,182,163,16,3,16
S01008025,583,405,356,38,11,178,162,71,52,15,4,91,167,121,109,7,5,46,96,79,74,3,2,17,57,50,43,7,0,7,101,84,78,6,0,17
S01008026,853,535,440,48,47,318,316,107,84,9,14,209,208,166,134,19,13,42,112,93,76,5,12,19,84,67,58,6,3,17,133,102,88,9,5,31
S01008027,475,289,252,11,26,186,189,69,63,1,5,120,126,95,77,4,14,31,62,47,42,0,5,15,40,35,33,0,2,5,58,43,37,6,0,15
S01008028,469,332,277,38,17,137,133,57,41,10,6,76,110,81,70,9,2,29,74,66,56,6,4,8,60,51,42,7,2,9,92,77,68,6,3,15
S01008029,784,472,351,91,30,312,225,76,43,27,6,149,174,91,62,21,8,83,110,88,63,21,4,22,81,62,51,5,6,19,194,155,132,17,6,39
S01008030,912,557,427,92,38,355,231,55,35,16,4,176,172,116,79,24,13,56,138,89,68,13,8,49,112,92,70,12,10,20,259,205,175,27,3,54
S01008031,730,446,366,37,43,284,248,80,59,7,14,168,171,131,110,10,11,40,84,59,52,3,4,25,90,66,53,7,6,24,137,110,92,10,8,27
S01008032,733,472,401,40,31,261,265,114,95,11,8,151,186,134,109,13,12,52,85,63,57,3,3,22,84,69,58,6,5,15,113,92,82,7,3,21
S01008033,625,468,368,86,14,157,50,23,12,8,3,27,99,62,45,12,5,37,116,82,72,9,1,34,66,54,40,14,0,12,294,247,199,43,5,47
S01008034,599,461,370,75,16,138,55,19,11,7,1,36,88,59,40,16,3,29,101,75,65,7,3,26,59,52,46,4,2,7,296,256,208,41,7,40
S01008035,531,332,278,34,20,199,82,27,20,3,4,55,98,55,41,7,7,43,99,64,56,5,3,35,56,38,31,6,1,18,196,148,130,13,5,48
S01008036,567,357,300,38,19,210,96,34,23,10,1,62,104,68,55,7,6,36,87,61,47,6,8,26,67,51,44,5,2,16,213,143,131,10,2,70
S01008037,833,512,422,57,33,321,262,92,75,13,4,170,212,141,114,17,10,71,133,103,83,9,11,30,64,49,44,1,4,15,162,127,106,17,4,35
S01008038,592,400,323,47,30,192,175,74,55,15,4,101,156,110,81,17,12,46,83,64,49,7,8,19,65,58,55,0,3,7,113,94,83,8,3,19
S01008039,715,467,381,46,40,248,164,65,53,8,4,99,169,120,92,11,17,49,121,94,76,8,10,27,83,57,44,8,5,26,178,131,116,11,4,47
S01008040,653,376,300,57,19,277,102,36,24,10,2,66,105,61,48,9,4,44,101,61,48,8,5,40,63,44,36,2,6,19,282,174,144,28,2,108
S01008041,600,320,266,41,13,280,144,24,16,7,1,120,93,54,43,6,5,39,80,50,43,7,0,30,52,38,32,4,2,14,231,154,132,17,5,77
S01008042,480,265,200,58,7,215,65,14,10,2,2,51,56,27,15,8,4,29,69,41,34,7,0,28,29,22,18,4,0,7,261,161,123,37,1,100
S01008043,767,449,339,102,8,318,78,20,9,11,0,58,79,29,21,6,2,50,111,71,51,19,1,40,76,52,37,12,3,24,423,277,221,54,2,146
S01008044,815,487,388,87,12,328,91,25,15,9,1,66,115,64,47,15,2,51,115,69,57,9,3,46,82,62,52,8,2,20,412,267,217,46,4,145
S01008045,828,449,310,111,28,379,162,37,25,10,2,125,121,73,36,26,11,48,128,72,50,14,8,56,44,29,22,6,1,15,373,238,177,55,6,135
S01008046,755,347,276,38,33,408,241,47,35,6,6,194,132,73,60,6,7,59,94,54,46,4,4,40,57,37,24,4,9,20,231,136,111,18,7,95
S01008047,581,319,251,55,13,262,86,17,16,1,0,69,78,31,21,9,1,47,101,53,40,6,7,48,43,30,25,4,1,13,273,188,149,35,4,85
S01008048,488,252,213,29,10,236,63,10,4,4,2,53,67,33,26,4,3,34,85,51,44,5,2,34,54,35,31,3,1,19,219,123,108,13,2,96
S01008049,709,382,309,63,10,327,105,15,11,3,1,90,100,56,46,10,0,44,113,69,56,9,4,44,65,44,37,6,1,21,326,198,159,35,4,128
S01008050,508,273,220,45,8,235,56,13,9,3,1,43,67,26,16,8,2,41,68,43,34,7,2,25,52,38,33,4,1,14,265,153,128,23,2,112
S01008051,690,445,379,51,15,245,55,12,9,3,0,43,93,51,45,3,3,42,108,66,56,6,4,42,61,43,37,5,1,18,373,273,232,34,7,100
S01008052,668,448,368,67,13,220,73,21,14,6,1,52,82,45,35,8,2,37,90,60,48,8,4,30,61,45,40,4,1,16,362,277,231,41,5,85
S01008053,507,261,210,41,10,246,76,18,10,6,2,58,60,27,21,5,1,33,66,40,30,6,4,26,39,19,16,2,1,20,266,157,133,22,2,109
S01008054,662,360,275,75,10,302,81,13,11,2,0,68,83,37,24,8,5,46,103,48,38,10,0,55,47,35,29,6,0,12,348,227,173,49,5,121
S01008055,835,507,408,85,14,328,45,15,8,7,0,30,102,50,41,7,2,52,124,65,54,8,3,59,65,42,33,8,1,23,499,335,272,55,8,164
S01008056,623,321,261,53,7,302,80,7,6,1,0,73,72,35,28,6,1,37,85,38,28,8,2,47,34,18,13,5,0,16,352,223,186,33,4,129
S01008057,758,449,364,74,11,309,79,19,10,9,0,60,78,53,37,13,3,25,107,61,54,6,1,46,69,46,36,9,1,23,425,270,227,37,6,155
S01008058,718,507,377,111,19,211,59,25,15,8,2,34,112,72,45,24,3,40,128,93,73,14,6,35,55,45,29,15,1,10,364,272,215,50,7,92
S01008059,559,359,294,55,10,200,77,27,18,9,0,50,83,54,40,12,2,29,112,77,61,13,3,35,78,55,46,9,0,23,209,146,129,12,5,63
S01008060,725,481,401,62,18,244,79,20,16,4,0,59,118,70,56,11,3,48,147,104,92,8,4,43,67,53,41,6,6,14,314,234,196,33,5,80
S01008061,627,399,330,52,17,228,124,23,13,7,3,101,96,56,41,12,3,40,120,92,81,6,5,28,63,48,40,4,4,15,224,180,155,23,2,44
S01008062,714,444,387,43,14,270,127,48,40,8,0,79,139,76,59,13,4,63,115,78,71,5,2,37,88,66,55,6,5,22,245,176,162,11,3,69
S01008063,764,471,394,63,14,293,103,37,27,9,1,66,134,74,60,12,2,60,95,55,44,9,2,40,82,61,55,2,4,21,350,244,208,31,5,106
S01008064,568,365,286,32,47,203,127,53,42,6,5,74,143,93,65,9,19,50,93,58,44,3,11,35,67,52,41,4,7,15,138,109,94,10,5,29
S01008065,775,510,410,76,24,265,72,29,20,7,2,43,92,56,43,8,5,36,129,89,70,13,6,40,70,48,43,5,0,22,412,288,234,43,11,124
S01008066,727,445,318,108,19,282,46,16,6,6,4,30,58,33,12,18,3,25,121,61,43,13,5,60,39,26,19,5,2,13,463,309,238,66,5,154
S01008067,524,318,251,59,8,206,54,20,13,7,0,34,60,33,25,8,0,27,65,40,30,6,4,25,37,23,20,3,0,14,308,202,163,35,4,106
S01008068,777,489,392,76,21,288,140,55,43,8,4,85,115,68,54,11,3,47,118,74,65,5,4,44,77,54,44,6,4,23,327,238,186,46,6,89
S01008069,777,521,437,49,35,256,177,58,42,9,7,119,165,112,95,10,7,53,139,109,87,9,13,30,92,71,60,6,5,21,204,171,153,15,3,33
S01008070,742,506,436,43,27,236,165,57,47,9,1,108,175,129,99,17,13,46,148,115,105,6,4,33,89,67,59,4,4,22,165,138,126,7,5,27
S01008071,580,396,342,42,12,184,84,27,19,8,0,57,103,67,52,11,4,36,109,77,65,7,5,32,63,50,47,3,0,13,221,175,159,13,3,46
S01008072,706,422,335,68,19,284,101,23,11,9,3,78,92,54,42,8,4,38,102,50,43,7,0,52,73,55,44,5,6,18,338,240,195,39,6,98
S01008073,403,247,187,50,10,156,39,17,8,8,1,22,49,24,14,8,2,25,61,39,32,5,2,22,36,18,16,2,0,18,218,149,117,27,5,69
S01008074,809,519,409,93,17,290,81,27,15,12,0,54,102,61,44,15,2,41,133,90,69,15,6,43,62,42,35,4,3,20,431,299,246,47,6,132
S01008075,492,237,174,59,4,255,54,8,3,5,0,46,63,21,11,10,0,42,83,37,28,7,2,46,47,26,22,4,0,21,245,145,110,33,2,100
S01008076,582,241,172,61,8,341,94,14,6,8,0,80,82,29,24,5,0,53,69,23,16,6,1,46,39,19,12,5,2,20,298,156,114,37,5,142
S01008077,679,372,265,87,20,307,78,24,9,14,1,54,67,26,19,4,3,41,94,45,32,7,6,49,52,37,28,7,2,15,388,240,177,55,8,148
S01008078,699,392,306,72,14,307,112,21,14,5,2,91,105,62,44,15,3,43,126,85,67,16,2,41,56,38,31,6,1,18,300,186,150,30,6,114
S01008079,735,415,324,70,21,320,86,15,11,3,1,71,88,48,33,13,2,40,109,70,56,11,3,39,56,35,25,9,1,21,396,247,199,34,14,149
S01008080,560,352,272,67,13,208,76,25,17,8,0,51,86,46,30,12,4,40,79,50,37,11,2,29,49,39,28,8,3,10,270,192,160,28,4,78
S01008081,492,296,231,48,17,196,58,17,12,4,1,41,63,29,17,7,5,34,81,42,36,4,2,39,42,32,24,6,2,10,248,176,142,27,7,72
S01008082,686,423,355,54,14,263,93,31,17,12,2,62,85,46,37,6,3,39,106,71,65,4,2,35,73,46,35,9,2,27,329,229,201,23,5,100
S01008083,586,352,296,46,10,234,70,14,8,5,1,56,91,48,40,8,0,43,105,65,54,5,6,40,52,36,29,4,3,16,268,189,165,24,0,79
S01008084,712,451,348,72,31,261,132,44,23,17,4,88,157,108,86,14,8,49,103,67,51,7,9,36,71,46,36,7,3,25,249,186,152,27,7,63
S01008085,794,550,429,106,15,244,105,41,21,19,1,64,132,80,54,21,5,52,147,97,75,18,4,50,86,68,56,11,1,18,324,264,223,37,4,60
S01008086,861,614,489,90,35,247,154,65,50,7,8,89,187,120,86,21,13,67,155,132,94,29,9,23,91,69,54,11,4,22,274,228,205,22,1,46
S01008087,694,389,330,43,16,305,135,31,25,4,2,104,148,81,60,12,9,67,101,65,55,7,3,36,79,46,41,5,0,33,231,166,149,15,2,65
S01008088,780,447,389,39,19,333,162,46,36,8,2,116,148,91,73,13,5,57,141,88,78,4,6,53,79,54,48,4,2,25,250,168,154,10,4,82
S01008089,543,331,280,30,21,212,103,25,16,4,5,78,119,72,58,11,3,47,104,70,61,5,4,34,53,41,35,2,4,12,164,123,110,8,5,41
S01008090,622,405,344,38,23,217,119,39,33,5,1,80,112,70,53,10,7,42,106,83,64,10,9,23,73,61,56,4,1,12,212,152,138,9,5,60
S01008091,332,197,169,22,6,135,79,25,18,6,1,54,56,35,29,5,1,21,55,33,31,1,1,22,26,21,19,2,0,5,116,83,72,8,3,33
S01008092,767,422,354,47,21,345,121,22,14,7,1,99,131,61,42,14,5,70,160,111,94,12,5,49,73,48,42,4,2,25,282,180,162,10,8,102
S01008093,672,378,325,36,17,294,125,27,22,5,0,98,137,87,72,11,4,50,130,75,60,9,6,55,59,46,40,5,1,13,221,143,131,6,6,78
S01008094,555,332,257,61,14,223,106,40,26,11,3,66,117,72,51,17,4,45,94,56,44,11,1,38,54,36,30,3,3,18,184,128,106,19,3,56
S01008095,645,373,316,38,19,272,173,53,41,8,4,120,143,90,75,10,5,53,112,72,62,8,2,40,74,53,43,6,4,21,143,105,95,6,4,38
S01008096,676,358,298,41,19,318,174,41,30,9,2,133,110,59,49,6,4,51,122,84,70,6,8,38,62,41,34,4,3,21,208,133,115,16,2,75
S01008097,543,294,233,43,18,249,117,28,16,10,2,89,97,50,34,11,5,47,86,58,47,4,7,28,52,35,29,3,3,17,191,123,107,15,1,68
S01008098,620,394,337,42,15,226,131,50,40,8,2,81,121,75,61,8,6,46,106,69,56,9,4,37,70,54,50,2,2,16,192,146,130,15,1,46
S01008099,444,289,235,36,18,155,109,50,36,10,4,59,116,72,55,11,6,44,81,62,56,3,3,19,42,35,27,4,4,7,96,70,61,8,1,26
S01008100,800,432,332,70,30,368,162,35,20,11,4,127,150,78,57,12,9,72,112,65,52,9,4,47,69,44,32,8,4,25,307,210,171,30,9,97
S01008101,629,459,379,46,34,170,129,66,45,15,6,63,128,82,62,11,9,46,106,85,67,7,11,21,81,68,62,4,2,13,185,158,143,9,6,27
S01008102,695,414,335,45,34,281,209,54,42,7,5,155,152,108,81,15,12,44,105,77,62,9,6,28,64,50,39,5,6,14,165,125,111,9,5,40
S01008103,524,314,254,38,22,210,174,56,41,10,5,118,106,63,49,7,7,43,68,50,40,7,3,18,59,47,40,4,3,12,117,98,84,10,4,19
S01008104,718,451,365,42,44,267,241,92,67,10,15,149,176,132,103,17,12,44,94,64,53,6,5,30,69,56,47,2,7,13,138,107,95,7,5,31
S01008105,856,531,420,44,67,325,306,110,80,7,23,196,237,171,130,18,23,66,110,83,72,4,7,27,70,59,48,7,4,11,133,108,90,8,10,25
S01008106,639,361,287,28,46,278,259,82,64,4,14,177,148,99,69,10,20,49,78,61,50,6,5,17,57,46,43,1,2,11,97,73,61,7,5,24
S01008107,625,509,401,86,22,116,103,60,40,19,1,43,129,100,73,22,5,29,98,83,65,10,8,15,77,66,51,12,3,11,218,200,172,23,5,18
S01008108,540,410,343,51,16,130,98,55,36,14,5,43,114,81,66,9,6,33,104,86,75,9,2,18,63,56,50,4,2,7,161,132,116,15,1,29
S01008109,756,514,438,49,27,242,156,59,41,14,4,97,185,125,108,11,6,60,159,120,103,8,9,39,80,72,61,8,3,8,176,138,125,8,5,38
S01008110,697,513,434,50,29,184,139,64,45,16,3,75,170,127,106,13,8,43,120,95,81,7,7,25,72,61,55,1,5,11,196,166,147,13,6,30
S01008111,751,445,395,42,8,306,166,34,22,12,0,132,138,84,75,7,2,54,122,84,73,9,2,38,83,61,54,5,2,22,242,182,171,9,2,60
S01008112,713,413,350,36,27,300,179,51,41,8,2,128,126,82,71,8,3,44,130,93,75,5,13,37,85,62,49,9,4,23,193,125,114,6,5,68
S01008113,779,471,402,48,21,308,138,39,34,3,2,99,163,109,92,10,7,54,145,99,82,10,7,46,91,71,58,9,4,20,242,153,136,16,1,89
S01008114,578,357,301,37,19,221,119,37,27,8,2,82,120,73,61,8,4,47,125,89,77,7,5,36,61,51,40,7,4,10,153,107,96,7,4,46
S01008115,761,551,462,54,35,210,160,81,61,18,2,79,190,139,113,15,11,51,156,131,117,5,9,25,84,68,56,3,9,16,171,132,115,13,4,39
S01008116,753,500,430,46,24,253,106,42,32,8,2,64,144,94,85,5,4,50,144,97,83,5,9,47,73,53,45,6,2,20,286,214,185,22,7,72
S01008117,676,402,323,54,25,274,103,34,26,4,4,69,132,73,50,10,13,59,104,66,57,7,2,38,67,54,44,9,1,13,270,175,146,24,5,95
S01008118,690,421,340,50,31,269,176,53,39,10,4,123,133,83,63,11,9,50,105,74,59,7,8,31,56,48,38,6,4,8,220,163,141,16,6,57
S01008119,542,316,261,18,37,226,172,68,60,3,5,104,163,111,84,7,20,52,82,50,43,3,4,32,47,31,24,4,3,16,78,56,50,1,5,22
S01008120,518,290,237,37,16,228,98,19,15,3,1,79,89,52,41,6,5,37,78,52,43,7,2,26,50,35,33,0,2,15,203,132,105,21,6,71
S01008121,556,316,264,44,8,240,67,16,10,6,0,51,64,31,25,2,4,33,78,47,41,3,3,31,53,39,32,6,1,14,294,183,156,27,0,111
S01008122,592,366,272,75,19,226,62,14,6,6,2,48,73,40,29,7,4,33,110,65,45,11,9,45,41,32,24,6,2,9,306,215,168,45,2,91
S01008123,763,451,354,85,12,312,74,15,12,3,0,59,97,45,32,10,3,52,125,78,65,10,3,47,63,45,37,6,2,18,404,268,208,56,4,136
S01008124,667,448,392,41,15,219,84,28,22,5,1,56,140,89,71,12,6,51,130,91,79,8,4,39,58,48,43,4,1,10,255,192,177,12,3,63
S01008125,728,468,404,51,13,260,94,27,20,6,1,67,139,79,66,12,1,60,125,87,75,11,1,38,79,54,49,5,0,25,291,221,194,17,10,70
S01008126,668,477,398,61,18,191,69,33,18,13,2,36,105,66,55,7,4,39,159,110,98,10,2,49,83,71,60,8,3,12,252,197,167,23,7,55
S01008127,411,267,225,26,16,144,48,14,9,4,1,34,51,33,28,1,4,18,64,44,35,3,6,20,37,26,23,1,2,11,211,150,130,17,3,61
S01008128,750,464,391,52,21,286,108,27,17,6,4,81,160,105,90,9,6,55,166,116,103,10,3,50,81,52,43,8,1,29,235,164,138,19,7,71
S01008129,748,474,385,49,40,274,215,74,60,12,2,141,179,121,82,15,24,58,102,82,71,8,3,20,83,71,62,2,7,12,169,126,110,12,4,43
S01008130,815,537,429,46,62,278,215,76,58,7,11,139,199,140,110,12,18,59,143,108,85,7,16,35,93,76,63,4,9,17,165,137,113,16,8,28
S01008131,642,395,320,33,42,247,179,66,46,6,14,113,163,107,83,9,15,56,78,53,46,3,4,25,66,52,42,6,4,14,156,117,103,9,5,39
S01008132,850,490,400,70,20,360,136,30,21,7,2,106,167,94,72,15,7,73,150,105,91,10,4,45,77,55,46,6,3,22,320,206,170,32,4,114
S01008133,540,268,211,40,17,272,160,37,27,5,5,123,94,55,45,4,6,39,67,46,36,5,5,21,49,30,27,3,0,19,170,100,76,23,1,70
S01008134,520,348,289,36,23,172,104,34,21,6,7,70,100,66,55,4,7,34,96,76,64,7,5,20,57,43,37,4,2,14,163,129,112,15,2,34
S01008135,916,639,539,59,41,277,204,54,40,11,3,150,177,139,109,14,16,38,165,137,116,14,7,28,128,107,100,3,4,21,242,202,174,17,11,40
S01008136,756,469,392,42,35,287,232,70,51,11,8,162,200,147,120,12,15,53,102,84,72,4,8,18,69,55,53,2,0,14,153,113,96,13,4,40
S01008137,667,394,301,24,69,273,266,110,74,6,30,156,182,123,94,7,22,59,73,58,47,3,8,15,61,38,33,1,4,23,85,65,53,7,5,20
S01008138,645,390,304,25,61,255,268,105,73,6,26,163,197,139,111,7,21,58,75,61,50,6,5,14,44,36,25,3,8,8,61,49,45,3,1,12
S01008139,713,427,333,32,62,286,232,90,66,9,15,142,189,116,86,5,25,73,95,74,62,7,5,21,79,66,52,3,11,13,118,81,67,8,6,37
S01008140,407,236,194,13,29,171,151,59,38,5,16,92,98,59,50,1,8,39,53,39,34,3,2,14,42,35,31,1,3,7,63,44,41,3,0,19
S01008141,712,446,373,54,19,266,138,53,41,10,2,85,187,123,103,15,5,64,127,87,70,11,6,40,75,55,43,8,4,20,185,128,116,10,2,57
S01008142,664,477,408,37,32,187,111,53,42,9,2,58,147,101,83,8,10,46,140,108,94,4,10,32,83,70,63,2,5,13,183,145,126,14,5,38
S01008143,755,452,359,35,58,303,214,92,65,10,17,122,200,123,92,9,22,77,112,75,65,3,7,37,57,48,44,1,3,9,172,114,93,12,9,58
S01008144,505,326,257,53,16,179,86,29,18,8,3,57,125,96,73,15,8,29,93,64,50,13,1,29,56,40,29,7,4,16,145,97,87,10,0,48
S01008145,646,432,343,40,49,214,263,126,96,11,19,137,146,114,89,10,15,32,103,80,65,9,6,23,55,50,42,2,6,5,79,62,51,8,3,17
S01008146,414,236,188,23,25,178,159,60,46,7,7,99,106,66,48,9,9,40,58,45,37,5,3,13,31,26,22,0,4,5,60,39,35,2,2,21
S01008147,664,437,366,40,31,227,210,88,69,9,10,122,181,140,120,9,11,41,104,83,66,11,6,21,62,54,49,2,3,8,107,72,62,9,1,35
S01008148,648,445,379,41,25,203,128,58,44,8,6,70,176,115,97,12,6,61,138,112,95,9,8,26,71,60,53,3,4,11,135,100,90,9,1,35
S01008149,568,373,312,23,38,195,159,53,44,4,5,106,168,121,94,8,19,47,88,70,65,1,4,18,54,48,40,3,5,6,99,81,69,7,5,18
S01008150,764,447,375,32,40,317,226,55,41,6,8,171,222,151,122,12,17,71,117,91,80,3,8,26,65,55,49,3,3,10,134,95,83,8,4,39
S01008151,589,354,295,23,36,235,208,74,54,11,9,134,143,94,80,3,11,49,108,79,62,6,11,29,48,42,38,1,3,6,82,65,61,2,2,17
S01008152,891,498,407,36,55,393,332,96,72,10,14,236,195,143,115,9,19,52,131,98,78,5,15,33,86,58,53,3,2,28,147,103,89,9,5,44
S01008153,769,501,423,48,30,268,147,44,28,12,4,103,173,121,103,11,7,52,149,110,93,7,10,39,76,62,51,5,6,14,224,164,148,13,3,60
S01008154,710,407,333,46,28,303,139,38,30,6,2,101,146,80,65,9,6,66,95,70,55,8,7,25,87,66,54,7,5,21,243,153,129,16,8,90
S01008155,576,379,309,41,29,197,119,48,34,8,6,71,111,68,57,4,7,43,104,76,63,8,5,28,65,54,45,5,4,11,177,133,110,16,7,44
S01008156,771,487,364,79,44,284,206,90,52,27,11,116,178,117,82,18,17,61,130,88,69,12,7,42,77,58,48,5,5,19,180,134,113,17,4,46
S01008157,592,415,343,42,30,177,95,37,25,8,4,58,125,87,64,11,12,38,103,76,63,7,6,27,78,62,56,5,1,16,191,153,135,11,7,38
S01008158,627,486,416,46,24,141,69,39,29,8,2,30,157,117,91,16,10,40,126,101,87,7,7,25,81,71,64,6,1,10,194,158,145,9,4,36
S01008159,781,448,347,40,61,333,253,79,59,5,15,174,190,132,97,15,20,58,108,80,63,4,13,28,74,52,41,3,8,22,156,105,87,13,5,51
S01008160,771,449,354,39,56,322,259,89,66,6,17,170,192,123,87,11,25,69,90,69,56,5,8,21,78,61,55,4,2,17,152,107,90,13,4,45
S01008161,815,627,513,90,24,188,117,57,39,16,2,60,200,147,107,27,13,53,126,100,80,18,2,26,94,84,71,9,4,10,278,239,216,20,3,39
S01008162,831,547,463,60,24,284,195,63,52,6,5,132,185,142,122,12,8,43,106,77,58,11,8,29,73,64,61,3,0,9,272,201,170,28,3,71
S01008163,601,368,290,43,35,233,241,88,68,16,4,153,176,129,100,10,19,47,72,61,50,5,6,11,45,38,28,5,5,7,67,52,44,7,1,15
S01008164,1318,731,490,42,199,587,171,76,63,7,6,95,260,170,105,15,50,90,442,246,162,5,79,196,100,68,46,5,17,32,345,171,114,10,47,174
S01008165,580,459,372,70,17,121,107,57,37,16,4,50,143,115,89,21,5,28,85,67,56,10,1,18,76,70,58,10,2,6,169,150,132,13,5,19
S01008166,443,293,233,26,34,150,170,73,53,11,9,97,143,111,86,6,19,32,51,42,34,3,5,9,32,27,24,2,1,5,47,40,36,4,0,7
S01008167,561,362,285,25,52,199,242,106,86,7,13,136,182,138,101,9,28,44,59,55,45,4,6,4,31,25,22,2,1,6,47,38,31,3,4,9
S01008168,668,412,348,24,40,256,242,84,70,5,9,158,194,148,121,7,20,46,87,64,53,6,5,23,45,36,30,3,3,9,100,80,74,3,3,20
S01008169,584,409,350,30,29,175,214,106,87,13,6,108,164,126,106,7,13,38,67,55,47,2,6,12,52,49,44,4,1,3,87,73,66,4,3,14
S01008170,492,341,282,46,13,151,95,32,24,8,0,63,135,89,74,11,4,46,100,81,64,13,4,19,46,39,34,3,2,7,116,100,86,11,3,16
S01008171,616,373,325,25,23,243,207,52,42,4,6,155,143,103,91,6,6,40,88,65,56,5,4,23,49,42,38,1,3,7,129,111,98,9,4,18
S01008172,457,284,238,29,17,173,143,53,40,9,4,90,131,93,79,8,6,38,46,36,30,2,4,10,44,33,27,3,3,11,93,69,62,7,0,24
S01008173,521,376,329,29,18,145,111,45,37,7,1,66,164,120,101,8,11,44,80,71,63,6,2,9,60,53,49,3,1,7,106,87,79,5,3,19
S01008174,448,319,270,36,13,129,120,46,39,7,0,74,121,97,83,9,5,24,88,74,65,4,5,14,38,34,29,4,1,4,81,68,54,12,2,13
S01008175,615,439,372,38,29,176,156,57,46,7,4,99,154,123,98,12,13,31,91,73,64,6,3,18,60,54,49,4,1,6,154,132,115,9,8,22
S01008176,610,403,315,70,18,207,95,33,27,4,2,62,99,63,48,10,5,36,98,65,57,6,2,33,47,35,31,4,0,12,271,207,152,46,9,64
S01008177,635,365,310,31,24,270,224,66,54,7,5,158,143,98,81,6,11,45,88,64,52,7,5,24,55,41,35,6,0,14,125,96,88,5,3,29
S01008178,560,325,285,25,15,235,136,45,37,4,4,91,147,92,74,11,7,55,101,75,65,7,3,26,64,42,40,2,0,22,112,71,69,1,1,41
S01008179,390,308,252,42,14,82,42,16,10,3,3,26,115,85,68,14,3,30,85,75,62,9,4,10,30,26,22,3,1,4,118,106,90,13,3,12
S01008180,381,295,245,41,9,86,35,18,13,4,1,17,105,81,62,16,3,24,89,64,57,5,2,25,44,40,34,3,3,4,108,92,79,13,0,16
S01008181,579,354,289,48,17,225,106,38,26,11,1,68,140,85,63,13,9,55,111,71,62,6,3,40,61,45,40,2,3,16,161,115,98,16,1,46
S01008182,833,576,478,47,51,257,214,81,63,9,9,133,181,133,101,7,25,48,113,89,77,7,5,24,68,55,45,5,5,13,257,218,192,19,7,39
S01008183,521,377,309,33,35,144,106,32,20,3,9,74,115,83,63,8,12,32,87,76,60,6,10,11,59,51,47,3,1,8,154,135,119,13,3,19
S01008184,735,442,351,50,41,293,211,51,38,8,5,160,158,110,78,14,18,48,107,76,63,7,6,31,62,50,42,5,3,12,197,155,130,16,9,42
S01008185,887,562,456,52,54,325,236,61,49,5,7,175,219,167,130,13,24,52,107,81,65,7,9,26,96,79,62,8,9,17,229,174,150,19,5,55
S01008186,722,370,287,40,43,352,157,28,16,3,9,129,170,80,62,5,13,90,152,79,59,12,8,73,59,45,41,3,1,14,184,138,109,17,12,46
S01008187,501,326,266,32,28,175,164,66,51,8,7,98,137,101,77,11,13,36,58,49,45,0,4,9,28,24,17,5,2,4,114,86,76,8,2,28
S01008188,769,433,350,38,45,336,275,78,63,6,9,197,188,123,92,10,21,65,96,69,61,3,5,27,74,52,44,4,4,22,136,111,90,15,6,25
S01008189,491,294,231,43,20,197,130,43,31,11,1,87,124,79,56,11,12,45,82,58,49,6,3,24,56,39,32,4,3,17,99,75,63,11,1,24
S01008190,709,446,365,38,43,263,282,120,103,9,8,162,230,165,131,9,25,65,69,56,42,8,6,13,43,39,34,4,1,4,85,66,55,8,3,19
S01008191,387,249,201,23,25,138,127,60,47,4,9,67,115,80,68,4,8,35,51,38,29,5,4,13,32,26,23,1,2,6,62,45,34,9,2,17
S01008192,680,471,395,38,38,209,177,77,61,8,8,100,170,130,115,5,10,40,94,72,54,9,9,22,57,46,39,3,4,11,182,146,126,13,7,36
S01008193,678,421,342,49,30,257,195,55,42,7,6,140,170,128,107,6,15,42,91,70,59,6,5,21,46,40,34,5,1,6,176,128,100,25,3,48
S01008194,509,321,268,29,24,188,140,57,43,6,8,83,131,91,77,6,8,40,63,44,31,7,6,19,37,30,27,2,1,7,138,99,90,8,1,39
S01008195,623,433,342,44,47,190,200,100,77,9,14,100,200,149,114,15,20,51,91,73,61,5,7,18,58,49,44,2,3,9,74,62,46,13,3,12
S01008196,596,409,321,35,53,187,176,82,65,8,9,94,223,169,132,14,23,54,80,63,47,4,12,17,47,39,30,4,5,8,70,56,47,5,4,14
S01008197,740,636,549,47,40,104,83,45,33,5,7,38,211,180,144,23,13,31,131,118,102,6,10,13,88,75,70,4,1,13,227,218,200,9,9,9
S01008198,575,347,293,27,27,228,224,93,71,12,10,131,172,119,100,9,10,53,67,53,49,0,4,14,50,40,37,2,1,10,62,42,36,4,2,20
S01008199,608,379,308,24,47,229,248,113,87,7,19,135,211,150,119,10,21,61,65,45,38,3,4,20,40,32,28,1,3,8,44,39,36,3,0,5
S01008200,511,276,225,24,27,235,241,77,65,7,5,164,139,99,73,10,16,40,49,36,31,4,1,13,27,21,19,0,2,6,55,43,37,3,3,12
S01008201,632,386,312,17,57,246,265,112,84,5,23,153,169,122,97,3,22,47,86,66,55,5,6,20,42,35,32,0,3,7,70,51,44,4,3,19
S01008202,487,288,247,22,19,199,164,41,31,3,7,123,135,101,87,6,8,34,80,60,52,5,3,20,38,27,22,4,1,11,70,59,55,4,0,11
S01008203,460,295,213,28,54,165,165,70,45,5,20,95,137,96,67,8,21,41,48,41,33,6,2,7,43,37,29,3,5,6,67,51,39,6,6,16
S01008204,776,373,302,41,30,403,340,67,59,4,4,273,170,116,88,15,13,54,85,60,50,7,3,25,53,40,30,4,6,13,128,90,75,11,4,38
S01008205,565,367,300,36,31,198,226,98,72,13,13,128,170,127,107,11,9,43,59,51,44,4,3,8,40,34,28,2,4,6,70,57,49,6,2,13
S01008206,529,318,265,31,22,211,231,94,73,14,7,137,152,110,90,8,12,42,50,40,38,1,1,10,34,25,24,1,0,9,62,49,40,7,2,13
S01008207,453,310,246,31,33,143,158,71,57,8,6,87,174,135,104,11,20,39,50,41,28,6,7,9,29,24,20,4,0,5,42,39,37,2,0,3
S01008208,622,514,436,42,36,108,109,63,51,7,5,46,197,167,136,11,20,30,91,81,68,8,5,10,71,61,53,6,2,10,154,142,128,10,4,12
S01008209,412,342,276,53,13,70,53,27,23,3,1,26,143,121,91,23,7,22,75,67,56,7,4,8,46,44,36,8,0,2,95,83,70,12,1,12
S01008210,753,495,397,60,38,258,223,81,62,16,3,142,210,158,119,18,21,52,117,88,68,10,10,29,67,58,53,4,1,9,136,110,95,12,3,26
S01008211,744,479,372,66,41,265,205,71,45,16,10,134,196,140,96,19,25,56,85,64,57,4,3,21,62,55,49,4,2,7,196,149,125,23,1,47
S01008212,447,354,305,36,13,93,56,26,20,5,1,30,142,115,94,12,9,27,82,70,65,4,1,12,52,47,40,6,1,5,115,96,86,9,1,19
S01008213,777,566,471,60,35,211,147,53,42,5,6,94,232,177,141,22,14,55,145,116,93,14,9,29,76,66,57,7,2,10,177,154,138,12,4,23
S01008214,611,318,259,32,27,293,237,59,43,5,11,178,167,102,77,12,13,65,59,47,38,8,1,12,47,36,34,1,1,11,101,74,67,6,1,27
S01008215,620,408,348,33,27,212,194,75,61,8,6,119,174,123,101,13,9,51,78,61,51,3,7,17,48,38,35,1,2,10,126,111,100,8,3,15
S01008216,419,307,254,38,15,112,86,43,26,14,3,43,115,84,75,6,3,31,80,59,47,6,6,21,46,39,36,2,1,7,92,82,70,10,2,10
S01008217,472,333,267,54,12,139,78,38,26,10,2,40,95,64,55,7,2,31,94,74,61,9,4,20,31,22,17,3,2,9,174,135,108,25,2,39
S01008218,821,674,547,99,28,147,90,50,21,24,5,40,243,204,162,30,12,39,156,130,107,13,10,26,90,79,73,6,0,11,242,211,184,26,1,31
S01008219,857,571,448,78,45,286,265,100,72,18,10,165,232,177,133,20,24,55,116,96,76,16,4,20,79,63,54,6,3,16,165,135,113,18,4,30
S01008220,459,298,240,25,33,161,153,70,60,4,6,83,160,114,81,13,20,46,46,37,31,3,3,9,45,38,32,2,4,7,55,39,36,3,0,16
S01008221,539,355,257,28,70,184,175,72,50,4,18,103,202,150,102,9,39,52,57,48,36,4,8,9,35,29,28,0,1,6,70,56,41,11,4,14
S01008222,506,275,224,19,32,231,205,61,52,2,7,144,171,124,99,11,14,47,44,32,25,4,3,12,32,23,15,2,6,9,54,35,33,0,2,19
S01008223,510,270,235,15,20,240,209,51,42,4,5,158,143,98,85,5,8,45,64,45,41,1,3,19,35,30,26,2,2,5,59,46,41,3,2,13
S01008224,783,583,503,51,29,200,190,82,62,16,4,108,228,193,160,18,15,35,131,112,100,9,3,19,84,70,67,2,1,14,150,126,114,6,6,24
S01008225,594,396,349,31,16,198,160,64,53,8,3,96,202,147,129,12,6,55,88,71,61,4,6,17,51,43,40,3,0,8,93,71,66,4,1,22
S01008226,638,367,293,30,44,271,294,96,85,5,6,198,202,156,117,13,26,46,64,53,42,5,6,11,28,23,17,1,5,5,50,39,32,6,1,11
S01008227,681,396,348,27,21,285,266,91,77,7,7,175,215,154,137,9,8,61,87,66,57,6,3,21,41,32,30,1,1,9,72,53,47,4,2,19
S01008228,539,360,289,51,20,179,124,52,35,12,5,72,143,97,77,15,5,46,84,69,57,9,3,15,53,34,30,4,0,19,135,108,90,11,7,27
S01008229,551,347,301,25,21,204,197,69,61,6,2,128,187,139,121,7,11,48,77,67,56,6,5,10,35,30,26,2,2,5,55,42,37,4,1,13
S01008230,614,511,427,61,23,103,84,45,36,7,2,39,215,177,136,28,13,38,111,97,78,14,5,14,52,50,45,3,2,2,152,142,132,9,1,10
S01008231,524,460,385,59,16,64,60,43,33,9,1,17,171,147,114,26,7,24,116,105,94,5,6,11,59,54,45,8,1,5,118,111,99,11,1,7
S01008232,486,423,355,35,33,63,41,24,18,2,4,17,172,150,119,13,18,22,98,87,72,10,5,11,62,57,53,2,2,5,113,105,93,8,4,8
S01008233,350,285,239,33,13,65,38,20,15,4,1,18,120,96,75,12,9,24,49,42,36,4,2,7,37,32,28,4,0,5,106,95,85,9,1,11
S01008234,340,184,156,18,10,156,143,46,40,4,2,97,94,60,47,9,4,34,35,24,23,1,0,11,21,17,12,2,3,4,47,37,34,2,1,10
S01008235,690,420,352,51,17,270,241,81,67,8,6,160,183,129,107,14,8,54,96,75,66,8,1,21,50,43,39,4,0,7,120,92,73,17,2,28
S01008236,691,454,347,69,38,237,168,67,52,12,3,101,184,130,90,20,20,54,90,64,51,9,4,26,69,55,45,5,5,14,180,138,109,23,6,42
S01008237,695,467,351,79,37,228,177,73,48,16,9,104,203,148,114,18,16,55,79,62,52,5,5,17,68,54,46,4,4,14,168,130,91,36,3,38
S01008238,631,383,309,35,39,248,228,74,60,10,4,154,180,137,106,10,21,43,79,61,48,7,6,18,57,44,39,2,3,13,87,67,56,6,5,20
S01008239,630,422,341,70,11,208,195,66,47,19,0,129,178,135,105,22,8,43,92,80,70,10,0,12,40,36,34,1,1,4,125,105,85,18,2,20
S01008240,732,423,337,62,24,309,111,33,20,12,1,78,136,91,69,18,4,45,123,73,57,8,8,50,71,53,41,9,3,18,291,173,150,15,8,118
S01008241,557,317,247,56,14,240,51,16,10,6,0,35,110,61,44,11,6,49,86,51,38,10,3,35,53,38,30,5,3,15,257,151,125,24,2,106
S01008242,787,416,315,74,27,371,227,55,40,12,3,172,173,100,74,18,8,73,91,63,49,13,1,28,55,42,32,3,7,13,241,156,120,28,8,85
S01008243,705,473,355,107,11,232,133,54,40,13,1,79,135,88,66,19,3,47,98,67,40,23,4,31,69,46,37,9,0,23,270,218,172,43,3,52
S01008244,470,258,183,61,14,212,93,22,15,2,5,71,72,46,29,16,1,26,67,34,24,8,2,33,37,27,19,6,2,10,201,129,96,29,4,72
S01008245,790,522,410,98,14,268,149,46,34,10,2,103,134,79,54,19,6,55,101,86,69,13,4,15,70,60,48,11,1,10,336,251,205,45,1,85
S01008246,787,540,419,106,15,247,131,49,31,14,4,82,138,84,63,18,3,54,111,83,63,18,2,28,69,54,47,4,3,15,338,270,215,52,3,68
S01008247,642,456,323,116,17,186,105,55,29,21,5,50,140,99,73,23,3,41,79,51,34,15,2,28,55,45,34,10,1,10,263,206,153,47,6,57
S01008248,742,449,328,100,21,293,158,55,36,17,2,103,150,98,77,13,8,52,84,55,39,13,3,29,62,48,31,13,4,14,288,193,145,44,4,95
S01008249,747,466,327,122,17,281,109,35,20,14,1,74,136,92,64,23,5,44,103,59,33,18,8,44,64,47,37,9,1,17,335,233,173,58,2,102
S01008250,835,555,403,133,19,280,118,45,33,9,3,73,145,92,68,19,5,53,114,78,60,15,3,36,82,67,47,19,1,15,376,273,195,71,7,103
S01008251,544,395,329,56,10,149,49,21,17,4,0,28,90,61,46,13,2,29,97,67,50,12,5,30,49,40,35,3,2,9,259,206,181,24,1,53
S01008252,689,423,348,60,15,266,104,36,25,8,3,68,134,80,63,14,3,54,104,74,65,6,3,30,71,54,47,5,2,17,276,179,148,27,4,97
S01008253,648,378,315,37,26,270,223,71,65,5,1,152,171,123,96,16,11,48,76,56,45,6,5,20,63,49,41,4,4,14,115,79,68,6,5,36
S01008254,819,478,397,48,33,341,274,78,64,7,7,196,209,148,117,15,16,61,102,75,61,7,7,27,68,52,46,4,2,16,166,125,109,15,1,41
S01008255,576,385,307,53,25,191,126,51,43,5,3,75,145,112,81,14,17,33,81,60,49,9,2,21,48,33,30,3,0,15,176,129,104,22,3,47
S01008256,665,439,341,59,39,226,169,77,62,6,9,92,198,136,101,17,18,62,93,69,52,12,5,24,71,56,44,10,2,15,134,101,82,14,5,33
S01008257,581,272,204,55,13,309,187,33,25,6,2,154,105,60,43,10,7,45,71,51,38,11,2,20,43,29,24,5,0,14,175,99,74,23,2,76
S01008258,710,499,427,50,22,211,121,46,37,5,4,75,184,139,112,19,8,45,106,82,70,6,6,24,70,57,47,8,2,13,229,175,161,12,2,54
S01008259,637,417,320,74,23,220,137,48,34,8,6,89,128,95,70,15,10,33,73,50,39,9,2,23,62,55,42,10,3,7,237,169,135,32,2,68
S01008260,650,422,355,35,32,228,152,60,48,8,4,92,181,128,105,10,13,53,103,78,69,3,6,25,53,44,37,3,4,9,161,112,96,11,5,49
S01008261,708,475,385,53,37,233,237,114,90,13,11,123,207,152,115,19,18,55,89,73,65,5,3,16,58,49,45,2,2,9,117,87,70,14,3,30
S01008262,493,348,249,86,13,145,83,30,17,11,2,53,104,78,65,11,2,26,77,63,45,15,3,14,39,34,28,6,0,5,190,143,94,43,6,47
S01008263,522,297,223,64,10,225,105,24,20,4,0,81,61,32,24,5,3,29,56,37,26,8,3,19,52,34,27,6,1,18,248,170,126,41,3,78
S01008264,575,364,304,41,19,211,161,58,47,8,3,103,140,97,81,8,8,43,70,59,53,3,3,11,53,45,38,5,2,8,151,105,85,17,3,46
S01008265,563,292,219,63,10,271,81,19,13,6,0,62,78,35,22,8,5,43,78,47,37,8,2,31,38,21,15,5,1,17,288,170,132,36,2,118
S01008266,577,296,209,78,9,281,63,13,7,6,0,50,83,39,23,12,4,44,76,46,33,13,0,30,42,28,24,3,1,14,313,170,122,44,4,143
S01008267,667,424,312,96,16,243,118,47,36,9,2,71,115,78,61,13,4,37,89,60,47,9,4,29,61,43,33,8,2,18,284,196,135,57,4,88
S01008268,724,382,257,112,13,342,69,19,12,6,1,50,121,67,52,11,4,54,93,40,27,10,3,53,47,29,15,14,0,18,394,227,151,71,5,167
S01008269,754,299,234,54,11,455,156,20,18,2,0,136,110,39,30,7,2,71,108,51,35,14,2,57,77,38,36,2,0,39,303,151,115,29,7,152
S01008270,705,320,226,75,19,385,119,16,10,5,1,103,114,49,29,12,8,65,88,44,30,11,3,44,49,18,11,4,3,31,335,193,146,43,4,142
S01008271,586,353,246,72,35,233,116,37,24,5,8,79,112,79,55,13,11,33,93,68,47,19,2,25,52,43,32,8,3,9,213,126,88,27,11,87
S01008272,816,500,401,83,16,316,153,51,41,10,0,102,167,114,90,17,7,53,126,83,62,15,6,43,55,35,25,9,1,20,315,217,183,32,2,98
S01008273,673,388,300,71,17,285,92,21,15,3,3,71,122,75,62,10,3,47,90,57,46,8,3,33,50,31,25,5,1,19,319,204,152,45,7,115
S01008274,593,343,264,40,39,250,183,67,44,9,14,116,165,107,84,10,13,58,80,64,49,9,6,16,38,27,22,3,2,11,127,78,65,9,4,49
S01008275,462,270,192,66,12,192,96,27,22,5,0,69,70,43,32,4,7,27,60,40,29,10,1,20,28,16,13,2,1,12,208,144,96,45,3,64
S01008276,423,288,216,61,11,135,57,27,19,7,1,30,72,45,34,6,5,27,53,32,26,4,2,21,39,27,15,11,1,12,202,157,122,33,2,45
S01008277,408,280,170,97,13,128,48,18,7,8,3,30,72,42,22,16,4,30,69,49,34,13,2,20,31,26,15,10,1,5,188,145,92,50,3,43
S01008278,637,386,282,91,13,251,76,25,15,8,2,51,88,50,38,10,2,38,89,57,42,13,2,32,61,43,31,8,4,18,323,211,156,52,3,112
S01008279,605,357,283,54,20,248,160,55,40,8,7,105,136,94,74,12,8,42,79,54,45,5,4,25,50,37,32,4,1,13,180,117,92,25,0,63
S01008280,778,511,350,138,23,267,154,47,31,13,3,107,136,99,68,22,9,37,115,81,54,22,5,34,74,57,41,14,2,17,299,227,156,67,4,72
S01008281,584,417,300,97,20,167,90,47,33,14,0,43,115,81,58,17,6,34,81,58,40,13,5,23,68,56,45,9,2,12,230,175,124,44,7,55
S01008282,587,390,259,109,22,197,154,62,37,22,3,92,121,87,55,22,10,34,87,62,40,19,3,25,60,53,41,9,3,7,165,126,86,37,3,39
S01008283,395,303,231,49,23,92,51,30,15,11,4,21,84,61,45,10,6,23,55,45,39,0,6,10,50,42,36,3,3,8,155,125,96,25,4,30
S01008284,672,460,373,65,22,212,156,62,52,6,4,94,164,112,80,22,10,52,86,62,52,8,2,24,49,43,35,7,1,6,217,181,154,22,5,36
S01008285,628,355,274,42,39,273,249,81,56,15,10,168,174,119,94,11,14,55,74,58,47,7,4,16,41,32,28,1,3,9,90,65,49,8,8,25
S01008286,620,374,307,47,20,246,207,73,61,7,5,134,169,117,92,15,10,52,84,65,58,6,1,19,42,33,30,1,2,9,118,86,66,18,2,32
S01008287,617,418,336,43,39,199,144,50,41,6,3,94,160,117,84,8,25,43,73,61,47,8,6,12,48,39,32,4,3,9,192,151,132,17,2,41
S01008288,753,432,334,69,29,321,191,55,38,15,2,136,160,108,83,8,17,52,88,63,50,11,2,25,58,40,30,6,4,18,256,166,133,29,4,90
S01008289,525,366,290,53,23,159,123,53,38,13,2,70,142,102,83,7,12,40,82,66,50,10,6,16,46,39,35,4,0,7,132,106,84,19,3,26
S01008290,737,455,337,82,36,282,138,41,31,4,6,97,160,108,84,15,9,52,106,67,47,13,7,39,62,46,30,8,8,16,271,193,145,42,6,78
S01008291,644,334,291,25,18,310,184,45,34,8,3,139,173,100,88,6,6,73,72,47,45,1,1,25,67,51,47,0,4,16,148,91,77,10,4,57
S01008292,592,428,354,35,39,164,164,86,69,10,7,78,179,129,106,3,20,50,91,75,57,11,7,16,40,37,34,0,3,3,118,101,88,11,2,17
S01008293,428,305,256,41,8,123,44,17,12,5,0,27,87,54,40,13,1,33,64,48,40,5,3,16,56,48,37,7,4,8,177,138,127,11,0,39
S01008294,683,491,402,63,26,192,136,43,36,5,2,93,144,108,79,16,13,36,119,98,81,10,7,21,65,61,52,8,1,4,219,181,154,24,3,38
S01008295,795,582,519,35,28,213,180,96,81,10,5,84,175,140,122,10,8,35,157,119,101,5,13,38,102,83,79,4,0,19,181,144,136,6,2,37
S01008296,567,317,247,37,33,250,215,61,50,6,5,154,135,86,62,8,16,49,64,45,32,8,5,19,49,41,32,5,4,8,104,84,71,10,3,20
S01008297,586,409,352,41,16,177,95,34,27,5,2,61,146,97,74,16,7,49,108,87,76,7,4,21,66,55,51,2,2,11,171,136,124,11,1,35
S01008298,608,403,333,52,18,205,132,34,25,8,1,98,138,97,79,13,5,41,110,83,68,9,6,27,65,50,40,8,2,15,163,139,121,14,4,24
S01008299,616,334,245,36,53,282,237,71,44,12,15,166,145,94,68,8,18,51,83,62,41,4,17,21,61,44,39,3,2,17,90,63,53,9,1,27
S01008300,710,405,318,45,42,305,212,56,46,4,6,156,195,130,91,16,23,65,112,80,64,9,7,32,70,54,48,4,2,16,121,85,69,12,4,36
S01008301,687,492,410,54,28,195,107,51,39,11,1,56,179,129,109,11,9,50,138,103,82,10,11,35,83,71,63,6,2,12,180,138,117,16,5,42
S01008302,617,391,293,78,20,226,91,37,26,8,3,54,96,63,43,16,4,33,111,78,57,14,7,33,65,53,43,9,1,12,254,160,124,31,5,94
S01008303,471,299,248,27,24,172,128,38,30,3,5,90,108,77,62,9,6,31,89,68,48,10,10,21,50,37,33,1,3,13,96,79,75,4,0,17
S01008304,411,252,209,23,20,159,81,17,14,1,2,64,74,47,36,5,6,27,74,54,45,5,4,20,50,40,32,3,5,10,132,94,82,9,3,38
S01008305,678,450,394,35,21,228,125,31,24,6,1,94,147,99,79,14,6,48,135,100,89,5,6,35,92,76,69,4,3,16,179,144,133,6,5,35
S01008306,538,369,314,37,18,169,95,29,22,5,2,66,120,86,73,9,4,34,106,80,66,7,7,26,68,53,46,5,2,15,149,121,107,11,3,28
S01008307,493,331,283,30,18,162,118,31,25,2,4,87,110,84,69,10,5,26,97,73,67,3,3,24,48,44,38,3,3,4,120,99,84,12,3,21
S01008308,501,294,254,28,12,207,86,21,17,3,1,65,84,53,47,5,1,31,98,64,57,3,4,34,53,38,34,3,1,15,180,118,99,14,5,62
S01008309,603,323,254,19,50,280,219,58,44,4,10,161,149,93,67,6,20,56,92,65,55,2,8,27,64,52,41,2,9,12,79,55,47,5,3,24
S01008310,818,482,406,38,38,336,282,77,54,9,14,205,168,113,95,9,9,55,133,104,86,9,9,29,85,71,63,6,2,14,150,117,108,5,4,33
S01008311,313,212,176,13,23,101,93,34,26,3,5,59,93,68,55,2,11,25,57,47,42,2,3,10,24,23,19,1,3,1,46,40,34,5,1,6
S01008312,329,222,190,17,15,107,75,19,15,1,3,56,83,60,52,3,5,23,57,52,47,1,4,5,50,43,36,5,2,7,64,48,40,7,1,16
S01008313,748,391,307,31,53,357,352,112,79,10,23,240,163,107,78,11,18,56,65,50,45,0,5,15,68,56,47,6,3,12,100,66,58,4,4,34
S01008314,470,312,250,21,41,158,130,57,48,4,5,73,148,101,77,6,18,47,66,55,47,2,6,11,51,38,28,3,7,13,75,61,50,6,5,14
S01008315,617,367,288,29,50,250,193,67,49,8,10,126,188,119,86,5,28,69,90,69,58,4,7,21,77,56,49,5,2,21,69,56,46,7,3,13
S01008316,421,234,178,15,41,187,166,58,41,2,15,108,113,66,49,2,15,47,42,30,18,4,8,12,41,31,30,1,0,10,59,49,40,6,3,10
S01008317,560,389,317,37,35,171,137,58,41,7,10,79,136,83,59,9,15,53,93,79,66,7,6,14,68,55,49,5,1,13,126,114,102,9,3,12
S01008318,799,505,422,66,17,294,161,54,38,11,5,107,163,100,84,13,3,63,118,88,72,11,5,30,105,76,66,8,2,29,252,187,162,23,2,65
S01008319,622,336,286,27,23,286,220,49,40,4,5,171,148,98,77,12,9,50,86,61,54,4,3,25,70,57,52,0,5,13,98,71,63,7,1,27
S01008320,574,281,240,28,13,293,175,45,37,8,0,130,127,75,62,4,9,52,84,57,50,6,1,27,62,44,39,4,1,18,126,60,52,6,2,66
S01008321,436,321,272,31,18,115,68,23,17,5,1,45,99,70,58,5,7,29,94,75,61,9,5,19,42,36,32,3,1,6,133,117,104,9,4,16
S01008322,839,516,436,38,42,323,233,87,70,7,10,146,219,142,112,12,18,77,122,87,80,3,4,35,95,65,56,4,5,30,170,135,118,12,5,35
S01008323,610,353,266,39,48,257,232,76,49,6,21,156,165,113,87,11,15,52,78,58,45,5,8,20,56,41,37,3,1,15,79,65,48,14,3,14
S01008324,496,311,252,30,29,185,171,72,46,10,16,99,130,93,74,9,10,37,67,46,43,3,0,21,48,35,29,4,2,13,80,65,60,4,1,15
S01008325,554,367,298,10,59,187,166,72,55,0,17,94,156,111,84,4,23,45,81,56,40,3,13,25,60,51,50,0,1,9,91,77,69,3,5,14
S01008326,753,459,371,27,61,294,264,100,76,9,15,164,227,165,124,11,30,62,86,61,52,1,8,25,80,66,55,5,6,14,96,67,64,1,2,29
S01008327,712,424,346,29,49,288,282,102,85,5,12,180,185,134,103,8,23,51,111,83,73,3,7,28,51,42,37,1,4,9,83,63,48,12,3,20
S01008328,501,384,303,60,21,117,59,35,18,10,7,24,83,54,42,7,5,29,97,81,68,9,4,16,61,49,39,9,1,12,201,165,136,25,4,36
S01008329,679,488,391,70,27,191,69,24,19,3,2,45,99,70,51,14,5,29,150,109,85,13,11,41,98,77,60,10,7,21,263,208,176,30,2,55
S01008330,685,496,399,59,38,189,89,35,26,5,4,54,143,96,65,19,12,47,141,109,92,10,7,32,81,61,54,5,2,20,231,195,162,20,13,36
S01008331,477,360,287,58,15,117,65,28,17,6,5,37,106,80,58,19,3,26,87,67,56,8,3,20,50,43,38,4,1,7,169,142,118,21,3,27
S01008332,814,446,350,80,16,368,167,31,25,6,0,136,117,65,46,15,4,52,134,77,58,11,8,57,79,55,47,7,1,24,317,218,174,41,3,99
S01008333,859,413,308,87,18,446,224,40,22,17,1,184,115,54,36,11,7,61,133,73,61,9,3,60,79,50,34,15,1,29,308,196,155,35,6,112
S01008334,602,345,278,49,18,257,98,20,14,5,1,78,91,52,40,6,6,39,99,67,57,8,2,32,59,40,29,6,5,19,255,166,138,24,4,89
S01008335,590,332,267,41,24,258,162,40,32,3,5,122,98,60,45,8,7,38,97,59,47,8,4,38,53,43,34,6,3,10,180,130,109,16,5,50
S01008336,508,326,241,61,24,182,138,35,24,7,4,103,86,53,38,7,8,33,85,68,56,6,6,17,39,34,20,13,1,5,160,136,103,28,5,24
S01008337,663,492,436,31,25,171,95,33,25,3,5,62,105,73,60,8,5,32,115,88,76,5,7,27,70,57,51,4,2,13,278,241,224,11,6,37
S01008338,620,480,397,55,28,140,66,32,21,11,0,34,97,61,44,9,8,36,112,91,69,11,11,21,64,46,40,5,1,18,281,250,223,19,8,31
S01008339,493,405,335,43,27,88,39,24,17,7,0,15,78,62,48,7,7,16,118,100,83,8,9,18,50,40,32,6,2,10,208,179,155,15,9,29
S01008340,643,491,403,69,19,152,58,31,23,7,1,27,105,66,55,10,1,39,135,106,84,15,7,29,65,53,44,7,2,12,280,235,197,30,8,45
S01008341,484,391,297,72,22,93,37,19,13,6,0,18,71,54,34,16,4,17,95,71,53,11,7,24,38,32,26,5,1,6,243,215,171,34,10,28
S01008342,694,439,348,62,29,255,126,35,21,13,1,91,123,78,56,8,14,45,120,80,66,8,6,40,61,41,37,3,1,20,264,205,168,30,7,59
S01008343,702,428,318,83,27,274,69,12,8,4,0,57,95,45,31,12,2,50,147,94,61,17,16,53,56,46,36,8,2,10,335,231,182,42,7,104
S01008344,711,436,288,130,18,275,84,36,22,12,2,48,95,44,31,11,2,51,116,67,45,18,4,49,63,44,30,11,3,19,353,245,160,78,7,108
S01008345,765,416,280,115,21,349,92,27,14,13,0,65,101,46,28,15,3,55,143,74,45,19,10,69,52,22,18,3,1,30,377,247,175,65,7,130
S01008346,774,477,344,108,25,297,70,15,10,3,2,55,111,59,44,13,2,52,160,105,66,30,9,55,63,42,28,11,3,21,370,256,196,51,9,114
S01008347,832,439,328,76,35,393,154,35,20,12,3,119,115,44,32,8,4,71,138,83,60,12,11,55,79,53,37,13,3,26,346,224,179,31,14,122
S01008348,618,342,257,60,25,276,83,25,12,12,1,58,94,45,27,9,9,49,118,70,55,10,5,48,47,25,20,2,3,22,276,177,143,27,7,99
S01008349,696,405,303,91,11,291,72,15,10,5,0,57,122,58,35,18,5,64,121,84,71,10,3,37,54,35,26,8,1,19,327,213,161,50,2,114
S01008350,504,255,190,55,10,249,83,16,8,8,0,67,79,36,25,7,4,43,66,39,31,6,2,27,43,25,17,6,2,18,233,139,109,28,2,94
S01008351,727,453,359,67,27,274,81,19,12,5,2,62,108,54,41,11,2,54,129,87,70,5,12,42,70,49,39,8,2,21,339,244,197,38,9,95
S01008352,529,304,241,51,12,225,65,16,10,6,0,49,59,26,17,7,2,33,89,58,47,7,4,31,54,30,26,4,0,24,262,174,141,27,6,88
S01008353,406,242,168,60,14,164,50,15,5,10,0,35,66,23,17,5,1,43,85,60,40,13,7,25,23,14,11,3,0,9,182,130,95,29,6,52
S01008354,540,357,251,91,15,183,109,44,23,21,0,65,100,65,38,22,5,35,76,49,41,7,1,27,38,27,24,1,2,11,217,172,125,40,7,45
S01008355,540,301,231,49,21,239,148,36,26,5,5,112,95,51,34,13,4,44,80,62,48,5,9,18,48,30,26,4,0,18,169,122,97,22,3,47
S01008356,457,342,274,54,14,115,47,26,20,5,1,21,89,66,45,15,6,23,80,64,52,9,3,16,60,50,44,3,3,10,181,136,113,22,1,45
S01008357,566,355,292,53,10,211,76,20,18,2,0,56,109,64,52,8,4,45,95,71,57,11,3,24,58,40,35,5,0,18,228,160,130,27,3,68
S01008358,582,333,260,45,28,249,170,49,37,6,6,121,100,61,39,12,10,39,95,60,43,12,5,35,58,40,36,2,2,18,159,123,105,13,5,36
S01008359,492,324,239,73,12,168,68,16,8,7,1,52,90,62,43,15,4,28,108,80,57,17,6,28,46,37,23,14,0,9,180,129,108,20,1,51
S01008360,687,437,331,87,19,250,84,25,12,12,1,59,118,69,53,11,5,49,136,100,79,14,7,36,59,41,28,11,2,18,290,202,159,39,4,88
S01008361,424,289,245,31,13,135,56,30,20,10,0,26,85,51,40,3,8,34,79,62,56,5,1,17,52,37,31,5,1,15,152,109,98,8,3,43
S01008362,721,523,431,67,25,198,85,25,19,5,1,60,120,82,64,11,7,38,136,106,90,8,8,30,92,72,57,13,2,20,288,238,201,30,7,50
S01008363,601,388,328,43,17,213,63,15,11,3,1,48,105,62,53,6,3,43,114,87,69,11,7,27,59,48,37,8,3,11,260,176,158,15,3,84
S01008364,628,390,297,71,22,238,90,25,17,5,3,65,98,60,41,14,5,38,108,67,52,12,3,41,48,31,21,5,5,17,284,207,166,35,6,77
S01008365,567,313,217,76,20,254,62,13,7,5,1,49,97,46,16,19,11,51,102,58,38,18,2,44,48,26,19,4,3,22,258,170,137,30,3,88
S01008366,746,396,330,37,29,350,211,53,41,10,2,158,143,81,67,6,8,62,132,87,73,6,8,45,76,62,52,6,4,14,184,113,97,9,7,71
S01008367,617,370,306,34,30,247,172,60,39,10,11,112,118,64,54,5,5,54,96,66,58,4,4,30,77,57,48,3,6,20,154,123,107,12,4,31
S01008368,541,361,304,41,16,180,108,39,32,6,1,69,88,63,50,8,5,25,104,78,69,5,4,26,50,39,34,4,1,11,191,142,119,18,5,49
S01008369,421,268,227,23,18,153,97,36,26,3,7,61,72,46,36,4,6,26,68,53,45,6,2,15,48,33,28,3,2,15,136,100,92,7,1,36
S01008370,553,373,288,64,21,180,78,14,9,3,2,64,80,53,37,12,4,27,104,78,58,12,8,26,71,51,36,11,4,20,220,177,148,26,3,43
S01008371,618,404,340,49,15,214,58,11,6,5,0,47,113,64,54,7,3,49,121,87,70,10,7,34,56,47,42,2,3,9,270,195,168,25,2,75
S01008372,613,412,355,39,18,201,71,31,23,6,2,40,126,73,60,6,7,53,112,84,71,10,3,28,77,47,38,7,2,30,227,177,163,10,4,50
S01008373,614,437,378,39,20,177,55,21,15,5,1,34,104,66,53,11,2,38,112,82,69,8,5,30,48,36,33,1,2,12,295,232,208,14,10,63
S01008374,558,370,322,40,8,188,74,24,17,6,1,50,93,59,51,6,2,34,118,87,79,6,2,31,83,60,49,10,1,23,190,140,126,12,2,50
S01008375,633,418,356,46,16,215,72,19,17,2,0,53,97,59,47,9,3,38,122,84,71,9,4,38,58,40,33,5,2,18,284,216,188,21,7,68
S01008376,415,284,222,43,19,131,55,23,13,8,2,32,59,40,31,4,5,19,76,50,40,6,4,26,42,34,27,5,2,8,183,137,111,20,6,46
S01008377,584,404,332,50,22,180,76,11,10,1,0,65,99,66,44,15,7,33,113,77,59,13,5,36,48,42,34,5,3,6,248,208,185,16,7,40
S01008378,811,494,406,72,16,317,123,19,16,3,0,104,122,66,48,10,8,56,147,102,87,10,5,45,70,50,43,6,1,20,349,257,212,43,2,92
S01008379,434,238,191,30,17,196,63,13,8,5,0,50,63,34,25,5,4,29,97,57,44,8,5,40,48,31,27,2,2,17,163,103,87,10,6,60
S01008380,512,354,292,45,17,158,52,12,9,3,0,40,70,41,31,5,5,29,107,81,62,14,5,26,62,44,39,3,2,18,221,176,151,20,5,45
S01008381,489,370,305,54,11,119,48,21,11,9,1,27,78,50,36,9,5,28,88,57,49,6,2,31,40,32,26,5,1,8,235,210,183,25,2,25
S01008382,502,310,255,43,12,192,67,17,13,4,0,50,80,38,30,5,3,42,111,72,53,13,6,39,50,34,29,4,1,16,194,149,130,17,2,45
S01008383,378,265,214,35,16,113,31,7,3,3,1,24,62,30,24,6,0,32,69,61,51,1,9,8,40,33,28,5,0,7,176,134,108,20,6,42
S01008384,779,521,454,49,18,258,122,32,27,5,0,90,170,100,83,12,5,70,144,117,97,8,12,27,75,60,54,6,0,15,268,212,193,18,1,56
S01008385,542,332,260,57,15,210,71,17,10,6,1,54,60,30,25,5,0,30,104,66,47,13,6,38,57,39,31,5,3,18,250,180,147,28,5,70
S01008386,661,446,378,45,23,215,113,34,29,3,2,79,143,99,82,13,4,44,133,95,76,8,11,38,60,47,39,6,2,13,212,171,152,15,4,41
S01008387,476,342,297,32,13,134,75,26,19,4,3,49,95,59,39,15,5,36,97,84,77,3,4,13,66,58,55,3,0,8,143,115,107,7,1,28
S01008388,488,381,326,41,14,107,66,44,36,7,1,22,102,74,63,8,3,28,90,67,51,9,7,23,76,56,51,3,2,20,154,140,125,14,1,14
S01008389,570,218,173,39,6,352,149,20,16,4,0,129,91,38,28,10,0,53,86,40,31,5,4,46,34,17,12,4,1,17,210,103,86,16,1,107
S01008390,515,327,269,45,13,188,65,15,11,4,0,50,81,48,36,9,3,33,77,50,40,5,5,27,46,29,22,5,2,17,246,185,160,22,3,61
S01008391,627,333,273,41,19,294,113,17,14,2,1,96,95,35,28,3,4,60,116,77,60,11,6,39,50,29,24,4,1,21,253,175,147,21,7,78
S01008392,707,500,421,65,14,207,58,13,8,5,0,45,95,48,35,12,1,47,108,78,70,5,3,30,62,49,42,6,1,13,384,312,266,37,9,72
S01008393,669,358,296,49,13,311,111,14,11,3,0,97,77,28,21,3,4,49,98,62,50,8,4,36,42,21,18,3,0,21,341,233,196,32,5,108
S01008394,600,415,343,62,10,185,57,20,11,8,1,37,89,41,31,8,2,48,85,43,35,6,2,42,31,24,22,2,0,7,338,287,244,38,5,51
S01008395,413,303,269,27,7,110,53,21,13,6,2,32,74,47,44,3,0,27,82,61,57,2,2,21,43,33,31,2,0,10,161,141,124,14,3,20
S01008396,554,274,208,50,16,280,120,28,16,9,3,92,89,47,32,9,6,42,92,41,34,3,4,51,57,32,25,6,1,25,196,126,101,23,2,70
S01008397,762,498,408,62,28,264,62,14,8,5,1,48,115,66,46,10,10,49,141,83,73,7,3,58,68,44,38,6,0,24,376,291,243,34,14,85
S01008398,479,276,224,41,11,203,58,13,8,3,2,45,74,33,26,5,2,41,80,40,30,6,4,40,45,29,26,3,0,16,222,161,134,24,3,61
S01008399,463,237,191,37,9,226,102,17,9,7,1,85,57,20,16,4,0,37,78,50,41,5,4,28,43,21,15,5,1,22,183,129,110,16,3,54
S01008400,536,335,274,41,20,201,86,26,19,5,2,60,84,45,29,7,9,39,75,55,42,7,6,20,53,36,30,5,1,17,238,173,154,17,2,65
S01008401,807,468,388,60,20,339,151,41,29,10,2,110,100,55,44,9,2,45,147,90,69,14,7,57,83,56,44,7,5,27,326,226,202,20,4,100
S01008402,900,513,337,162,14,387,120,30,15,14,1,90,96,32,18,13,1,64,173,103,68,29,6,70,52,38,23,11,4,14,459,310,213,95,2,149
S01008403,473,293,227,54,12,180,61,15,7,5,3,46,57,27,17,8,2,30,83,56,50,5,1,27,47,32,25,5,2,15,225,163,128,31,4,62
S01008404,799,431,339,77,15,368,161,35,21,10,4,126,103,42,36,4,2,61,103,52,41,8,3,51,79,58,42,14,2,21,353,244,199,41,4,109
S01008405,584,407,293,96,18,177,47,13,7,5,1,34,64,34,24,6,4,30,93,65,51,10,4,28,45,31,20,9,2,14,335,264,191,66,7,71
S01008406,791,392,306,67,19,399,207,23,13,9,1,184,96,43,32,8,3,53,113,66,48,13,5,47,57,39,24,11,4,18,318,221,189,26,6,97
S01008407,456,226,184,31,11,230,128,17,12,5,0,111,57,34,27,4,3,23,55,32,22,7,3,23,44,33,28,3,2,11,172,110,95,12,3,62
S01008408,512,368,299,44,25,144,96,32,22,6,4,64,86,61,42,15,4,25,94,69,56,5,8,25,52,45,33,6,6,7,184,161,146,12,3,23
S01008409,719,417,351,28,38,302,205,45,39,3,3,160,174,118,90,5,23,56,92,64,55,5,4,28,86,68,59,2,7,18,162,122,108,13,1,40
S01008410,495,261,196,44,21,234,108,19,12,4,3,89,86,45,33,7,5,41,73,46,33,8,5,27,42,26,23,1,2,16,186,125,95,24,6,61
S01008411,500,332,275,41,16,168,103,37,23,11,3,66,119,82,67,6,9,37,82,55,46,8,1,27,46,37,32,3,2,9,150,121,107,13,1,29
S01008412,561,347,283,43,21,214,103,32,24,6,2,71,103,67,53,11,3,36,100,69,59,4,6,31,58,43,38,2,3,15,197,136,109,20,7,61
S01008413,442,283,224,41,18,159,96,29,24,4,1,67,97,66,52,8,6,31,69,43,36,6,1,26,45,40,35,3,2,5,135,105,77,20,8,30
S01008414,361,232,185,34,13,129,36,8,6,2,0,28,58,38,32,4,2,20,75,47,33,7,7,28,25,19,14,3,2,6,167,120,100,18,2,47
S01008415,680,468,383,52,33,212,153,53,42,9,2,100,151,99,79,7,13,52,114,88,72,12,4,26,80,65,55,4,6,15,182,163,135,20,8,19
S01008416,780,491,386,46,59,289,225,87,58,16,13,138,184,124,99,6,19,60,123,90,79,2,9,33,85,62,48,8,6,23,163,128,102,14,12,35
S01008417,586,363,288,65,10,223,62,24,13,9,2,38,103,59,48,11,0,44,94,60,52,5,3,34,45,34,27,5,2,11,282,186,148,35,3,96
S01008418,584,386,323,55,8,198,64,18,11,7,0,46,119,73,55,15,3,46,87,62,55,6,1,25,54,40,37,3,0,14,260,193,165,24,4,67
S01008419,373,250,199,43,8,123,52,13,8,4,1,39,46,29,19,8,2,17,51,34,28,4,2,17,22,16,14,2,0,6,202,158,130,25,3,44
S01008420,396,249,214,26,9,147,56,13,9,2,2,43,65,42,34,4,4,23,60,39,33,5,1,21,38,27,24,3,0,11,177,128,114,12,2,49
S01008421,687,465,393,38,34,222,183,66,49,10,7,117,156,111,90,8,13,45,85,72,61,7,4,13,67,59,52,2,5,8,196,157,141,11,5,39
S01008422,490,273,220,51,2,217,44,5,3,2,0,39,78,33,28,4,1,45,73,33,28,5,0,40,43,29,22,7,0,14,252,173,139,33,1,79
S01008423,826,517,395,95,27,309,78,24,17,7,0,54,121,63,52,4,7,58,128,78,52,21,5,50,64,44,31,11,2,20,435,308,243,52,13,127
S01008424,698,346,279,55,12,352,71,19,13,5,1,52,110,45,29,10,6,65,104,62,50,8,4,42,45,17,14,3,0,28,368,203,173,29,1,165
S01008425,2308,861,612,70,179,1447,146,50,25,18,7,96,302,138,108,14,16,164,778,303,201,17,85,475,154,78,55,4,19,76,928,292,223,17,52,636
S01008426,482,274,232,24,18,208,152,48,44,4,0,104,151,95,74,10,11,56,56,41,34,5,2,15,35,24,21,1,2,11,88,66,59,4,3,22
S01008427,868,671,570,78,23,197,92,39,32,6,1,53,221,168,136,23,9,53,169,130,107,19,4,39,87,75,63,9,3,12,299,259,232,21,6,40
S01008428,561,317,269,34,14,244,185,60,42,15,3,125,151,102,90,7,5,49,69,41,35,3,3,28,31,24,22,2,0,7,125,90,80,7,3,35
S01008429,707,407,353,41,13,300,113,31,23,6,2,82,165,81,70,10,1,84,126,87,72,8,7,39,53,36,30,6,0,17,250,172,158,11,3,78
S01008430,555,330,270,34,26,225,91,23,17,4,2,68,104,56,40,6,10,48,103,68,56,5,7,35,40,28,23,3,2,12,217,155,134,16,5,62
S01008431,698,406,349,41,16,292,101,33,29,2,2,68,146,74,56,14,4,72,112,79,67,8,4,33,73,44,42,2,0,29,266,176,155,15,6,90
S01008432,590,320,256,46,18,270,96,24,19,3,2,72,128,71,49,17,5,57,98,62,53,7,2,36,57,29,24,4,1,28,211,134,111,15,8,77
S01008433,685,461,395,56,10,224,116,47,33,13,1,69,207,126,104,18,4,81,119,95,82,11,2,24,77,65,62,3,0,12,166,128,114,11,3,38
S01008434,661,437,365,50,22,224,114,42,30,10,2,72,176,113,92,13,8,63,131,93,77,8,8,38,60,40,35,5,0,20,180,149,131,14,4,31
S01008435,652,376,329,39,8,276,96,26,20,5,1,70,182,102,81,18,3,80,109,69,66,1,2,40,66,48,46,1,1,18,199,131,116,14,1,68
S01008436,723,432,350,62,20,291,122,26,16,6,4,96,139,76,59,10,7,63,98,73,60,8,5,25,57,39,30,6,3,18,307,218,185,32,1,89
S01008437,606,371,299,52,20,235,119,17,13,4,0,102,96,57,44,7,6,39,79,55,45,5,5,24,36,25,19,5,1,11,276,217,178,31,8,59
S01008438,363,251,199,48,4,112,41,18,13,5,0,23,49,36,31,5,0,13,46,27,18,7,2,19,27,19,13,5,1,8,200,151,124,26,1,49
S01008439,848,544,451,81,12,304,43,13,11,2,0,30,108,57,46,8,3,51,96,56,45,9,2,40,66,45,35,9,1,21,535,373,314,53,6,162
S01008440,808,460,360,85,15,348,48,15,10,5,0,33,92,36,28,4,4,56,97,41,32,6,3,56,44,32,23,7,2,12,527,336,267,63,6,191
S01008441,374,229,183,41,5,145,43,12,7,5,0,31,47,19,12,6,1,28,51,36,28,6,2,15,25,18,18,0,0,7,208,144,118,24,2,64
S01008442,554,403,316,71,16,151,36,11,5,5,1,25,64,36,27,5,4,28,74,58,44,11,3,16,32,27,19,7,1,5,348,271,221,43,7,77
S01008443,486,274,208,50,16,212,55,11,6,5,0,44,83,47,33,8,6,36,61,25,22,1,2,36,24,17,16,1,0,7,263,174,131,35,8,89
S01008444,513,357,293,44,20,156,62,28,24,2,2,34,118,71,56,10,5,47,79,57,43,9,5,22,49,40,35,4,1,9,205,161,135,19,7,44
S01008445,690,327,280,32,15,363,178,28,21,6,1,150,148,82,70,6,6,66,83,55,44,6,5,28,50,22,22,0,0,28,231,140,123,14,3,91
S01008446,810,410,326,76,8,400,77,16,9,6,1,61,156,43,33,7,3,113,134,46,34,8,4,88,47,29,24,5,0,18,396,276,226,50,0,120
S01008447,556,354,274,67,13,202,48,17,10,5,2,31,106,67,53,12,2,39,67,45,35,8,2,22,27,21,13,5,3,6,308,204,163,37,4,104
S01008448,637,386,297,70,19,251,116,39,19,17,3,77,147,92,71,16,5,55,96,57,46,8,3,39,51,37,30,3,4,14,227,161,131,26,4,66
S01008449,594,377,279,31,67,217,163,69,54,3,12,94,199,129,86,10,33,70,69,55,39,4,12,14,44,35,25,5,5,9,119,89,75,9,5,30
S01008450,429,254,203,21,30,175,122,44,33,4,7,78,127,83,64,4,15,44,52,41,35,3,3,11,49,31,26,3,2,18,79,55,45,7,3,24
S01008451,505,308,218,14,76,197,179,80,56,2,22,99,152,98,72,3,23,54,61,43,30,5,8,18,41,35,25,0,10,6,72,52,35,4,13,20
S01008452,442,275,212,22,41,167,135,60,43,2,15,75,153,94,76,5,13,59,47,34,27,2,5,13,26,22,16,3,3,4,81,65,50,10,5,16
S01008453,379,295,245,26,24,84,66,31,25,4,2,35,108,83,66,7,10,25,38,31,27,1,3,7,32,25,19,2,4,7,135,125,108,12,5,10
S01008454,688,426,326,30,70,262,168,74,62,3,9,94,279,169,123,8,38,110,88,68,43,9,16,20,61,43,39,1,3,18,92,72,59,9,4,20
S01008455,806,447,333,31,83,359,269,103,63,8,32,166,219,126,98,6,22,93,116,75,56,3,16,41,58,45,33,5,7,13,144,98,83,9,6,46
S01008456,775,467,327,33,107,308,237,91,56,7,28,146,261,165,109,6,50,96,85,68,46,7,15,17,58,37,27,4,6,21,134,106,89,9,8,28
S01008457,534,283,234,11,38,251,224,74,65,1,8,150,162,110,88,5,17,52,49,35,27,4,4,14,33,24,22,0,2,9,66,40,32,1,7,26
S01008458,779,516,429,36,51,263,223,93,72,3,18,130,259,188,156,13,19,71,103,76,61,8,7,27,62,52,43,5,4,10,132,107,97,7,3,25
S01008459,606,382,278,21,83,224,180,73,54,4,15,107,224,157,102,5,50,67,71,55,46,2,7,16,43,29,21,5,3,14,88,68,55,5,8,20
S01008460,567,344,244,15,85,223,205,89,56,5,28,116,195,130,89,6,35,65,58,40,28,1,11,18,40,32,26,0,6,8,69,53,45,3,5,16
S01008461,708,440,339,21,80,268,239,104,83,5,16,135,243,160,118,5,37,83,79,66,49,0,17,13,47,38,34,1,3,9,100,72,55,10,7,28
S01008462,486,239,178,11,50,247,225,84,67,4,13,141,126,73,52,1,20,53,51,34,25,2,7,17,26,16,9,1,6,10,58,32,25,3,4,26
S01008463,552,339,255,23,61,213,178,71,51,2,18,107,199,134,93,11,30,65,37,26,21,1,4,11,33,24,21,2,1,9,105,84,69,7,8,21
S01008464,695,458,394,27,37,237,201,86,74,6,6,115,222,166,140,7,19,56,102,79,70,4,5,23,55,46,41,3,2,9,115,81,69,7,5,34
S01008465,610,414,358,31,25,196,170,80,64,8,8,90,183,136,115,13,8,47,111,86,78,4,4,25,42,35,33,1,1,7,104,77,68,5,4,27
S01008466,596,387,332,20,35,209,160,83,71,6,6,77,225,147,118,8,21,78,62,45,42,1,2,17,46,34,28,3,3,12,103,78,73,2,3,25
S01008467,639,412,333,41,38,227,187,82,59,12,11,105,248,169,141,12,16,79,77,63,52,6,5,14,58,44,37,3,4,14,69,54,44,8,2,15
S01008468,529,283,236,22,25,246,173,53,44,6,3,120,182,122,101,6,15,60,57,39,32,5,2,18,26,15,15,0,0,11,91,54,44,5,5,37
S01008469,480,311,262,29,20,169,136,58,46,10,2,78,126,95,81,5,9,31,49,32,26,3,3,17,42,36,33,2,1,6,127,90,76,9,5,37
S01008470,586,336,260,23,53,250,219,92,70,1,21,127,183,117,88,8,21,66,60,35,29,0,6,25,34,23,17,5,1,11,90,69,56,9,4,21
S01008471,626,412,325,24,63,214,207,104,87,4,13,103,233,157,120,9,28,76,48,40,30,2,8,8,49,42,34,2,6,7,89,69,54,7,8,20
S01008472,541,328,252,35,41,213,169,73,49,13,11,96,165,101,77,12,12,64,69,51,39,6,6,18,44,36,28,3,5,8,94,67,59,1,7,27
S01008473,550,340,285,22,33,210,170,67,54,5,8,103,162,109,90,6,13,53,64,45,38,3,4,19,48,42,38,2,2,6,106,77,65,6,6,29
S01008474,666,372,314,16,42,294,247,73,60,4,9,174,182,124,103,5,16,58,68,47,37,4,6,21,55,42,40,0,2,13,114,86,74,3,9,28
S01008475,500,284,237,19,28,216,177,51,40,8,3,126,131,90,73,5,12,41,61,44,40,1,3,17,37,25,21,2,2,12,94,74,63,3,8,20
S01008476,614,336,283,26,27,278,227,58,43,4,11,169,152,104,89,7,8,48,57,32,24,6,2,25,47,41,36,4,1,6,131,101,91,5,5,30
S01008477,680,383,337,25,21,297,261,77,69,4,4,184,167,108,92,8,8,59,75,55,52,1,2,20,46,33,27,4,2,13,131,110,97,8,5,21
S01008478,706,355,289,30,36,351,234,41,31,4,6,193,189,115,90,10,15,74,79,45,44,1,0,34,51,36,26,2,8,15,153,118,98,13,7,35
S01008479,660,371,301,21,49,289,259,79,63,7,9,180,170,109,89,3,17,61,76,60,47,5,8,16,43,32,27,3,2,11,112,91,75,3,13,21
S01008480,503,334,289,11,34,169,109,38,28,1,9,71,139,101,85,4,12,38,68,48,43,1,4,20,45,36,33,1,2,9,142,111,100,4,7,31
S01008481,1408,520,418,60,42,888,492,99,74,14,11,393,494,202,169,15,18,292,163,93,78,11,4,70,103,41,32,5,4,62,156,85,65,15,5,71
S01008482,522,280,231,24,25,242,196,53,43,6,4,143,149,89,71,8,10,60,49,37,28,6,3,12,46,35,30,2,3,11,82,66,59,2,5,16
S01008483,531,299,250,32,17,232,170,49,40,6,3,121,164,102,81,11,10,62,58,43,36,6,1,15,42,37,34,2,1,5,97,68,59,7,2,29
S01008484,628,389,315,46,28,239,181,57,38,12,7,124,198,140,114,11,15,58,82,64,53,8,3,18,54,40,36,3,1,14,113,88,74,12,2,25
S01008485,798,539,451,49,39,259,154,71,55,12,4,83,269,181,150,11,20,88,134,98,81,8,9,36,58,41,35,4,2,17,183,148,130,14,4,35
S01008486,777,414,341,47,26,363,256,61,47,10,4,195,190,105,83,14,8,85,118,78,64,7,7,40,44,34,27,6,1,10,169,136,120,10,6,33
S01008487,678,522,461,46,15,156,72,25,19,2,4,47,118,86,77,6,3,32,124,89,75,13,1,35,57,52,43,8,1,5,307,270,247,17,6,37
S01008488,675,409,353,36,20,266,159,38,33,2,3,121,141,88,77,5,6,53,106,68,60,6,2,38,48,39,32,4,3,9,221,176,151,19,6,45
S01008489,544,342,281,24,37,202,148,59,44,5,10,89,159,102,82,7,13,57,80,63,52,4,7,17,48,37,33,1,3,11,109,81,70,7,4,28
S01008490,795,584,500,44,40,211,154,48,41,2,5,106,151,115,95,8,12,36,104,87,74,9,4,17,72,61,55,1,5,11,314,273,235,24,14,41
S01008491,826,539,458,39,42,287,131,44,31,6,7,87,121,86,72,4,10,35,126,85,67,5,13,41,70,55,49,4,2,15,378,269,239,20,10,109
S01008492,814,619,545,39,35,195,125,52,35,8,9,73,131,89,80,3,6,42,115,94,86,3,5,21,78,64,56,5,3,14,365,320,288,20,12,45
S01008493,693,422,362,26,34,271,169,50,38,6,6,119,158,96,79,8,9,62,101,68,56,3,9,33,67,54,46,3,5,13,198,154,143,6,5,44
S01008494,598,413,343,33,37,185,120,41,30,5,6,79,105,72,53,10,9,33,71,53,48,0,5,18,76,50,43,3,4,26,226,197,169,15,13,29
S01008495,850,650,548,32,70,200,101,43,33,4,6,58,99,78,63,3,12,21,126,94,75,9,10,32,88,77,68,3,6,11,436,358,309,13,36,78
S01008496,929,719,622,38,59,210,78,38,27,3,8,40,116,82,62,6,14,34,112,88,80,3,5,24,94,75,67,3,5,19,529,436,386,23,27,93
S01008497,754,617,539,28,50,137,86,43,39,3,1,43,102,86,71,4,11,16,76,63,54,2,7,13,86,79,68,3,8,7,404,346,307,16,23,58
S01008498,732,555,463,45,47,177,102,45,31,6,8,57,101,68,57,4,7,33,108,84,70,7,7,24,71,61,52,5,4,10,350,297,253,23,21,53
S01008499,935,683,583,40,60,252,76,25,19,3,3,51,110,81,59,7,15,29,168,106,86,2,18,62,70,58,49,3,6,12,511,413,370,25,18,98
S01008500,352,236,197,15,24,116,59,23,18,4,1,36,71,47,33,1,13,24,63,36,30,1,5,27,31,24,19,4,1,7,128,106,97,5,4,22
S01008501,556,433,383,25,25,123,25,17,14,0,3,8,55,36,31,1,4,19,89,54,51,0,3,35,37,29,25,2,2,8,350,297,262,22,13,53
S01008502,604,463,420,20,23,141,31,17,16,1,0,14,59,35,27,4,4,24,87,72,67,1,4,15,46,37,33,3,1,9,381,302,277,11,14,79
S01008503,751,615,536,48,31,136,40,14,12,1,1,26,73,50,44,4,2,23,114,87,72,4,11,27,61,54,47,2,5,7,463,410,361,37,12,53
S01008504,950,733,630,69,34,217,73,19,14,3,2,54,104,65,48,6,11,39,140,99,85,9,5,41,63,53,47,2,4,10,570,497,436,49,12,73
S01008505,599,471,397,47,27,128,42,16,13,2,1,26,73,44,36,3,5,29,69,56,44,5,7,13,45,37,31,3,3,8,370,318,273,34,11,52
S01008506,760,439,368,56,15,321,109,10,8,1,1,99,86,19,16,2,1,67,86,50,40,5,5,36,47,38,30,4,4,9,432,322,274,44,4,110
S01008507,801,587,484,50,53,214,39,15,9,4,2,24,100,62,46,5,11,38,163,82,56,7,19,81,58,43,33,5,5,15,441,385,340,29,16,56
S01008508,682,450,367,70,13,232,59,12,6,5,1,47,98,59,38,18,3,39,91,57,46,10,1,34,36,24,19,5,0,12,398,298,258,32,8,100
S01008509,862,533,437,79,17,329,88,15,9,4,2,73,84,45,37,4,4,39,122,68,58,6,4,54,51,37,30,6,1,14,517,368,303,59,6,149
S01008510,755,474,390,67,17,281,109,26,17,6,3,83,133,76,59,12,5,57,123,79,63,11,5,44,70,55,46,8,1,15,320,238,205,30,3,82
S01008511,709,419,326,83,10,290,63,16,5,9,2,47,105,54,38,11,5,51,102,57,44,11,2,45,65,44,38,6,0,21,374,248,201,46,1,126
S01008512,410,253,191,50,12,157,38,8,5,1,2,30,67,28,16,8,4,39,48,30,25,3,2,18,26,17,13,3,1,9,231,170,132,35,3,61
S01008513,567,304,235,58,11,263,66,14,9,4,1,52,76,28,25,2,1,48,74,40,31,6,3,34,35,26,11,12,3,9,316,196,159,34,3,120
S01008514,757,412,321,77,14,345,103,9,5,3,1,94,64,26,20,4,2,38,71,39,27,6,6,32,35,22,20,2,0,13,484,316,249,62,5,168
S01008515,563,414,342,59,13,149,24,12,5,6,1,12,51,23,19,3,1,28,54,37,28,4,5,17,41,29,20,7,2,12,393,313,270,39,4,80
S01008516,827,572,496,46,30,255,82,37,26,8,3,45,77,46,41,3,2,31,95,58,48,5,5,37,91,68,54,7,7,23,482,363,327,23,13,119
S01008517,789,503,436,46,21,286,48,9,8,1,0,39,56,22,21,0,1,34,118,70,55,7,8,48,47,34,28,4,2,13,520,368,324,34,10,152
S01008518,733,478,385,76,17,255,40,6,4,2,0,34,61,25,23,2,0,36,100,48,37,6,5,52,34,24,18,5,1,10,498,375,303,61,11,123
S01008519,625,399,303,80,16,226,36,7,3,4,0,29,50,14,8,5,1,36,70,37,26,8,3,33,30,21,17,2,2,9,439,320,249,61,10,119
S01008520,868,500,377,105,18,368,50,11,8,2,1,39,86,41,32,6,3,45,114,60,43,13,4,54,37,26,19,7,0,11,581,362,275,77,10,219
S01008521,706,424,335,81,8,282,48,15,11,3,1,33,82,36,23,12,1,46,91,46,38,7,1,45,44,28,23,2,3,16,441,299,240,57,2,142
S01008522,434,258,195,52,11,176,18,4,3,1,0,14,37,12,9,3,0,25,44,22,12,7,3,22,25,18,14,4,0,7,310,202,157,37,8,108
S01008523,756,496,398,80,18,260,38,10,4,6,0,28,84,43,34,4,5,41,91,51,34,8,9,40,33,22,18,4,0,11,510,370,308,58,4,140
S01008524,714,436,350,39,47,278,210,64,42,11,11,146,208,138,110,5,23,70,84,68,55,7,6,16,67,42,35,4,3,25,145,124,108,12,4,21
S01008525,602,326,259,24,43,276,175,41,26,7,8,134,188,107,88,5,14,81,77,56,43,4,9,21,47,34,28,1,5,13,115,88,74,7,7,27
S01008526,737,454,384,39,31,283,181,60,46,9,5,121,206,134,107,15,12,72,112,80,70,3,7,32,43,27,24,3,0,16,195,153,137,9,7,42
S01008527,595,412,366,26,20,183,107,36,29,4,3,71,198,151,136,7,8,47,83,57,50,4,3,26,67,54,47,3,4,13,140,114,104,8,2,26
S01008528,540,386,316,39,31,154,107,42,33,5,4,65,134,101,84,8,9,33,95,77,61,7,9,18,54,42,36,5,1,12,150,124,102,14,8,26
S01008529,623,400,333,39,28,223,166,40,32,2,6,126,172,121,99,12,10,51,101,82,67,11,4,19,57,48,42,2,4,9,127,109,93,12,4,18
S01008530,570,347,288,25,34,223,175,62,50,6,6,113,187,124,103,4,17,63,53,34,31,2,1,19,57,44,34,6,4,13,98,83,70,7,6,15
S01008531,619,368,306,29,33,251,208,77,63,5,9,131,185,124,99,11,14,61,65,52,45,5,2,13,53,39,35,1,3,14,108,76,64,7,5,32
S01008532,369,208,166,20,22,161,134,39,31,6,2,95,89,60,43,9,8,29,47,30,24,2,4,17,36,28,22,1,5,8,63,51,46,2,3,12
S01008533,372,267,238,16,13,105,48,21,17,2,2,27,167,122,111,3,8,45,48,37,34,3,0,11,27,24,21,2,1,3,82,63,55,6,2,19
S01008534,576,413,340,47,26,163,50,20,14,3,3,30,145,99,83,7,9,46,118,87,73,5,9,31,63,52,44,8,0,11,200,155,126,24,5,45
S01008535,597,392,315,55,22,205,71,20,11,7,2,51,124,73,57,11,5,51,124,85,69,8,8,39,51,38,34,4,0,13,227,176,144,25,7,51
S01008536,484,273,227,37,9,211,68,21,16,5,0,47,66,30,19,6,5,36,70,50,40,8,2,20,36,20,19,1,0,16,244,152,133,17,2,92
S01008537,570,330,275,45,10,240,47,8,7,0,1,39,86,38,27,10,1,48,87,48,41,4,3,39,37,31,27,3,1,6,313,205,173,28,4,108
S01008538,467,239,193,39,7,228,32,6,2,4,0,26,58,21,12,7,2,37,68,34,28,4,2,34,28,16,13,3,0,12,281,162,138,21,3,119
S01008539,691,455,379,60,16,236,54,15,10,5,0,39,83,39,28,8,3,44,99,69,58,7,4,30,56,41,34,4,3,15,399,291,249,36,6,108
S01008540,728,415,322,84,9,313,89,17,10,7,0,72,96,49,35,12,2,47,95,49,34,10,5,46,63,38,33,5,0,25,385,262,210,50,2,123
S01008541,676,456,380,58,18,220,57,18,11,7,0,39,113,65,50,11,4,48,114,78,64,8,6,36,68,47,41,4,2,21,324,248,214,28,6,76
S01008542,721,498,421,58,19,223,66,29,20,9,0,37,130,77,60,12,5,53,110,72,63,5,4,38,62,49,44,3,2,13,353,271,234,29,8,82
S01008543,563,416,354,52,10,147,63,26,16,9,1,37,108,78,60,14,4,30,95,72,64,6,2,23,46,38,33,4,1,8,251,202,181,19,2,49
S01008544,479,375,307,52,16,104,26,8,2,4,2,18,71,46,30,10,6,25,80,57,46,7,4,23,29,26,25,1,0,3,273,238,204,30,4,35
S01008545,689,420,326,84,10,269,59,17,11,6,0,42,80,40,28,10,2,40,108,64,50,12,2,44,36,26,23,3,0,10,406,273,214,53,6,133
S01008546,701,412,313,77,22,289,62,16,8,8,0,46,95,42,27,12,3,53,90,55,33,12,10,35,56,35,33,1,1,21,398,264,212,44,8,134
S01008547,817,624,520,68,36,193,139,73,58,12,3,66,187,140,105,20,15,47,125,105,88,13,4,20,75,63,53,8,2,12,291,243,216,15,12,48
S01008548,653,521,432,60,29,132,122,71,50,15,6,51,178,145,117,15,13,33,99,80,67,8,5,19,49,43,38,5,0,6,205,182,160,17,5,23
S01008549,801,540,430,80,30,261,199,82,61,12,9,117,214,153,116,29,8,61,130,101,83,13,5,29,76,62,53,7,2,14,182,142,117,19,6,40
S01008550,660,443,375,53,15,217,95,37,25,11,1,58,141,89,71,12,6,52,93,60,53,6,1,33,61,50,43,6,1,11,270,207,183,18,6,63
S01008551,873,555,455,84,16,318,178,57,39,13,5,121,230,155,120,29,6,75,111,85,71,11,3,26,73,59,53,6,0,14,281,199,172,25,2,82
S01008552,745,462,379,59,24,283,116,40,19,16,5,76,171,98,75,15,8,73,121,81,66,10,5,40,65,49,46,3,0,16,272,194,173,15,6,78
S01008553,460,272,218,35,19,188,130,35,24,5,6,95,122,79,65,9,5,43,59,41,31,7,3,18,40,29,22,5,2,11,109,88,76,9,3,21
S01008554,765,464,342,40,82,301,290,118,86,5,27,172,230,163,108,21,34,67,74,55,42,5,8,19,55,34,27,1,6,21,116,94,79,8,7,22
S01008555,796,470,366,31,73,326,276,100,73,4,23,176,234,141,102,11,28,93,89,68,57,2,9,21,50,36,25,6,5,14,147,125,109,8,8,22
S01008556,590,324,256,27,41,266,196,60,39,9,12,136,191,108,88,5,15,83,72,52,39,7,6,20,48,38,32,1,5,10,83,66,58,5,3,17
S01008557,682,357,281,27,49,325,270,81,55,6,20,189,217,130,101,12,17,87,44,35,31,3,1,9,41,29,27,1,1,12,110,82,67,5,10,28
S01008558,712,400,326,38,36,312,226,70,51,9,10,156,214,125,97,11,17,89,85,62,54,4,4,23,47,38,32,4,2,9,140,105,92,10,3,35
S01008559,554,326,265,27,34,228,227,83,67,6,10,144,170,116,93,10,13,54,65,50,39,6,5,15,30,26,22,0,4,4,62,51,44,5,2,11
S01008560,550,332,275,25,32,218,208,71,56,6,9,137,161,110,89,7,14,51,58,48,38,5,5,10,38,30,28,2,0,8,85,73,64,5,4,12
S01008561,528,324,269,22,33,204,175,69,54,6,9,106,157,111,94,7,10,46,65,49,40,1,8,16,33,28,24,2,2,5,98,67,57,6,4,31
S01008562,489,247,188,20,39,242,188,35,26,4,5,153,146,100,75,4,21,46,50,35,27,1,7,15,32,19,15,2,2,13,73,58,45,9,4,15
S01008563,652,400,329,32,39,252,223,91,68,8,15,132,184,116,97,5,14,68,66,48,40,4,4,18,41,33,32,1,0,8,138,112,92,14,6,26
S01008564,527,290,244,25,21,237,184,50,36,3,11,134,153,102,82,14,6,51,56,43,39,3,1,13,41,27,26,1,0,14,93,68,61,4,3,25
S01008565,721,414,328,36,50,307,256,88,61,11,16,168,202,130,101,9,20,72,90,70,59,5,6,20,49,33,25,2,6,16,124,93,82,9,2,31
S01008566,817,497,395,55,47,320,298,113,86,15,12,185,269,183,145,21,17,86,89,65,59,2,4,24,49,45,36,4,5,4,112,91,69,13,9,21
S01008567,574,351,287,35,29,223,176,57,47,6,4,119,171,124,95,13,16,47,57,45,36,6,3,12,42,31,26,2,3,11,128,94,83,8,3,34
S01008568,627,444,372,46,26,183,134,57,43,10,4,77,169,124,100,16,8,45,102,84,69,10,5,18,50,38,36,1,1,12,172,141,124,9,8,31
S01008569,517,319,210,29,80,198,186,72,42,7,23,114,169,117,73,11,33,52,41,33,22,3,8,8,24,19,16,0,3,5,97,78,57,8,13,19
S01008570,719,420,312,45,63,299,266,109,87,6,16,157,223,146,98,16,32,77,63,41,29,7,5,22,54,41,22,12,7,13,113,83,76,4,3,30
S01008571,564,311,251,34,26,253,179,48,35,12,1,131,172,122,98,11,13,50,71,48,37,5,6,23,47,32,29,2,1,15,95,61,52,4,5,34
S01008572,735,395,317,48,30,340,245,78,59,13,6,167,199,127,99,19,9,72,78,52,43,5,4,26,41,25,18,3,4,16,172,113,98,8,7,59
S01008573,700,453,355,81,17,247,157,46,32,12,2,111,160,111,88,17,6,49,88,61,54,6,1,27,63,49,38,10,1,14,232,186,143,36,7,46
S01008574,624,447,386,44,17,177,92,34,22,9,3,58,154,103,84,14,5,51,108,82,74,4,4,26,59,51,44,6,1,8,211,177,162,11,4,34
S01008575,644,415,323,70,22,229,87,33,20,12,1,54,119,68,45,16,7,51,115,71,55,7,9,44,49,31,25,4,2,18,274,212,178,31,3,62
S01008576,725,460,383,63,14,265,127,48,39,8,1,79,177,111,90,17,4,66,104,68,56,11,1,36,57,49,42,5,2,8,260,184,156,22,6,76
S01008577,787,402,296,79,27,385,184,33,19,12,2,151,148,66,45,15,6,82,97,66,49,11,6,31,55,43,27,10,6,12,303,194,156,31,7,109
S01008578,659,371,289,70,12,288,86,17,12,4,1,69,75,33,24,6,3,42,68,35,27,6,2,33,40,24,19,5,0,16,390,262,207,49,6,128
S01008579,677,299,232,59,8,378,139,25,13,11,1,114,103,35,26,6,3,68,78,40,22,15,3,38,42,22,20,2,0,20,315,177,151,25,1,138
S01008580,466,299,250,29,20,167,88,26,22,1,3,62,112,66,54,7,5,46,70,47,32,8,7,23,35,30,28,1,1,5,161,130,114,12,4,31
S01008581,771,436,359,32,45,335,269,80,57,10,13,189,203,136,110,8,18,67,90,66,54,5,7,24,57,40,36,2,2,17,152,114,102,7,5,38
S01008582,837,504,410,48,46,333,268,98,77,8,13,170,202,136,107,12,17,66,99,73,57,9,7,26,55,40,35,1,4,15,213,157,134,18,5,56
S01008583,595,331,279,29,23,264,168,42,31,10,1,126,131,90,74,7,9,41,69,40,34,2,4,29,42,29,25,2,2,13,185,130,115,8,7,55
S01008584,685,393,320,38,35,292,163,49,39,2,8,114,172,105,83,12,10,67,82,53,46,3,4,29,44,36,31,0,5,8,224,150,121,21,8,74
S01008585,469,289,244,21,24,180,131,37,29,1,7,94,119,81,64,7,10,38,52,41,37,2,2,11,36,28,21,6,1,8,131,102,93,5,4,29
S01008586,665,366,301,29,36,299,249,82,60,12,10,167,174,111,91,6,14,63,70,49,39,4,6,21,39,25,21,2,2,14,133,99,90,5,4,34
S01008587,802,410,317,53,40,392,86,21,13,5,3,65,100,36,24,3,9,64,104,61,48,8,5,43,36,26,19,3,4,10,476,266,213,34,19,210
S01008588,621,366,298,48,20,255,43,10,9,1,0,33,73,33,23,7,3,40,87,42,32,5,5,45,49,25,19,3,3,24,369,256,215,32,9,113
S01008589,313,180,152,20,8,133,67,17,14,2,1,50,48,17,13,3,1,31,30,20,19,0,1,10,24,20,19,0,1,4,144,106,87,15,4,38
S01008590,646,316,280,29,7,330,86,11,8,2,1,75,89,26,21,4,1,63,73,26,21,2,3,47,33,20,17,3,0,13,365,233,213,18,2,132
S01008591,677,413,336,57,20,264,77,25,22,2,1,52,80,38,33,4,1,42,98,47,30,10,7,51,44,35,24,10,1,9,378,268,227,31,10,110
S01008592,612,334,282,36,16,278,98,21,16,4,1,77,111,53,45,6,2,58,101,61,49,7,5,40,42,30,26,2,2,12,260,169,146,17,6,91
S01008593,622,377,281,84,12,245,45,9,4,4,1,36,57,32,16,12,4,25,62,22,17,5,0,40,31,25,20,5,0,6,427,289,224,58,7,138
S01008594,881,516,401,92,23,365,57,19,8,8,3,38,104,50,33,11,6,54,119,50,35,11,4,69,48,24,16,7,1,24,553,373,309,55,9,180
S01008595,818,368,315,24,29,450,314,55,50,3,2,259,144,83,65,5,13,61,78,53,43,3,7,25,61,38,35,2,1,23,221,139,122,11,6,82
S01008596,746,394,317,28,49,352,217,47,32,1,14,170,144,77,58,6,13,67,116,58,50,3,5,58,30,24,20,1,3,6,239,188,157,17,14,51
S01008597,740,450,357,74,19,290,144,40,27,12,1,104,142,69,53,11,5,73,93,61,45,8,8,32,52,44,40,3,1,8,309,236,192,40,4,73
S01008598,746,381,304,40,37,365,83,21,17,1,3,62,94,39,30,5,4,55,210,70,56,4,10,140,52,34,27,4,3,18,307,217,174,26,17,90
S01008599,806,485,381,75,29,321,41,14,7,6,1,27,70,32,24,4,4,38,161,58,45,5,8,103,42,31,21,5,5,11,492,350,284,55,11,142
S01008600,665,356,241,93,22,309,63,11,7,4,0,52,48,25,11,11,3,23,101,53,33,11,9,48,31,20,12,7,1,11,422,247,178,60,9,175
S01008601,2471,693,455,45,193,1778,57,16,11,4,1,41,327,57,31,6,20,270,1500,371,209,12,150,1129,108,28,20,7,1,80,479,221,184,16,21,258
S01008602,608,336,252,44,40,272,24,7,3,2,2,17,74,31,21,5,5,43,178,81,52,9,20,97,32,21,17,2,2,11,300,196,159,26,11,104
S01008603,1069,582,472,53,57,487,70,17,12,2,3,53,98,44,29,3,12,54,345,116,92,8,16,229,53,35,28,2,5,18,503,370,311,38,21,133
S01008604,830,459,351,80,28,371,48,16,10,6,0,32,69,31,19,8,4,38,151,63,48,5,10,88,44,30,25,2,3,14,518,319,249,59,11,199
S01008605,629,401,315,58,28,228,23,10,8,2,0,13,43,21,14,3,4,22,138,55,38,6,11,83,41,24,15,6,3,17,384,291,240,41,10,93
S01008606,607,393,302,79,12,214,26,3,2,1,0,23,50,30,19,10,1,20,84,37,32,3,2,47,32,26,24,2,0,6,415,297,225,63,9,118
S01008607,513,285,194,77,14,228,45,4,1,3,0,41,36,12,9,0,3,24,45,16,14,0,2,29,10,5,5,0,0,5,377,248,165,74,9,129
S01008608,637,326,251,66,9,311,59,10,7,2,1,49,60,20,15,3,2,40,71,32,25,6,1,39,27,11,11,0,0,16,420,253,193,55,5,167
S01008609,800,403,302,89,12,397,90,10,4,6,0,80,92,30,16,11,3,62,102,52,36,15,1,50,33,15,12,3,0,18,483,296,234,54,8,187
S01008610,734,350,279,62,9,384,71,4,2,2,0,67,60,14,10,3,1,46,117,42,33,5,4,75,38,21,18,3,0,17,448,269,216,49,4,179
S01008611,1329,664,511,73,80,665,54,11,10,1,0,43,134,42,26,7,9,92,398,148,109,7,32,250,70,34,23,3,8,36,673,429,343,55,31,244
S01008612,725,409,338,40,31,316,27,9,8,1,0,18,45,17,9,2,6,28,224,78,63,3,12,146,43,30,23,5,2,13,386,275,235,29,11,111
S01008613,693,383,307,57,19,310,52,10,7,1,2,42,46,14,12,0,2,32,156,58,49,5,4,98,31,23,18,3,2,8,408,278,221,48,9,130
S01008614,643,320,263,33,24,323,27,5,2,2,1,22,35,15,9,1,5,20,226,76,61,6,9,150,19,11,10,0,1,8,336,213,181,24,8,123
S01008615,782,392,317,51,24,390,39,7,4,2,1,32,67,20,13,4,3,47,259,93,75,7,11,166,45,29,22,4,3,16,372,243,203,34,6,129
S01008616,676,342,278,41,23,334,7,4,2,2,0,3,35,18,13,3,2,17,297,89,76,6,7,208,29,19,16,2,1,10,308,212,171,28,13,96
S01008617,754,338,254,52,32,416,18,4,2,0,2,14,51,20,15,4,1,31,337,87,65,6,16,250,40,25,18,5,2,15,308,202,154,37,11,106
S01008618,681,330,270,27,33,351,13,7,6,0,1,6,38,14,12,0,2,24,310,96,73,5,18,214,33,18,14,1,3,15,287,195,165,21,9,92
S01008619,493,282,226,34,22,211,17,3,2,1,0,14,29,16,14,1,1,13,166,58,42,6,10,108,24,18,13,1,4,6,257,187,155,25,7,70
S01008620,766,398,314,47,37,368,12,5,2,1,2,7,45,11,3,6,2,34,300,91,68,4,19,209,33,19,19,0,0,14,376,272,222,36,14,104
S01008621,710,362,272,56,34,348,8,1,1,0,0,7,47,23,16,3,4,24,292,96,80,9,7,196,27,20,14,5,1,7,336,222,161,39,22,114
S01008622,468,276,219,34,23,192,11,2,2,0,0,9,23,11,8,2,1,12,134,42,28,4,10,92,23,20,18,1,1,3,277,201,163,27,11,76
S01008623,858,425,308,77,40,433,40,13,5,7,1,27,62,15,14,0,1,47,230,82,59,9,14,148,27,15,10,4,1,12,499,300,220,57,23,199
S01008624,670,278,207,64,7,392,100,10,6,4,0,90,64,14,10,4,0,50,64,21,14,7,0,43,28,13,12,1,0,15,414,220,165,48,7,194
S01008625,464,274,207,57,10,190,25,9,3,4,2,16,32,15,11,2,2,17,54,25,21,4,0,29,14,9,5,2,2,5,339,216,167,45,4,123
S01008626,744,498,410,75,13,246,33,8,8,0,0,25,52,19,11,7,1,33,91,50,40,8,2,41,38,27,25,1,1,11,530,394,326,59,9,136
S01008627,581,348,259,78,11,233,42,2,1,0,1,40,55,29,20,6,3,26,60,34,26,7,1,26,24,13,9,3,1,11,400,270,203,62,5,130
S01008628,551,348,283,51,14,203,53,10,7,1,2,43,37,14,11,2,1,23,65,44,34,7,3,21,28,18,14,2,2,10,368,262,217,39,6,106
S01008629,492,312,260,37,15,180,38,13,8,4,1,25,57,25,17,3,5,32,68,32,28,2,2,36,28,17,15,1,1,11,301,225,192,27,6,76
S01008630,503,318,261,34,23,185,20,4,3,0,1,16,47,23,14,5,4,24,90,44,37,2,5,46,43,33,25,4,4,10,303,214,182,23,9,89
S01008631,712,538,447,65,26,174,44,16,14,2,0,28,51,31,20,7,4,20,97,63,50,6,7,34,52,43,34,8,1,9,468,385,329,42,14,83
S01008632,865,495,401,59,35,370,185,12,8,0,4,173,90,34,27,5,2,56,91,57,38,10,9,34,64,43,34,6,3,21,435,349,294,38,17,86
S01008633,785,390,292,76,22,395,87,13,8,3,2,74,55,20,10,3,7,35,101,49,35,9,5,52,34,20,17,2,1,14,508,288,222,59,7,220
S01008634,612,376,282,72,22,236,29,2,0,2,0,27,47,19,14,4,1,28,104,58,41,9,8,46,43,32,24,7,1,11,389,265,203,50,12,124
S01008635,746,479,365,89,25,267,39,13,5,6,2,26,59,21,12,6,3,38,119,51,37,8,6,68,45,27,19,5,3,18,484,367,292,64,11,117
S01008636,749,452,354,76,22,297,38,9,8,1,0,29,59,28,21,5,2,31,129,59,51,2,6,70,47,31,24,3,4,16,476,325,250,65,10,151
S01008637,608,360,286,59,15,248,47,11,4,7,0,36,37,20,15,2,3,17,78,30,23,4,3,48,45,21,18,2,1,24,401,278,226,44,8,123
S01008638,775,391,321,50,20,384,132,13,8,4,1,119,61,23,20,2,1,38,170,59,52,5,2,111,42,24,16,5,3,18,370,272,225,34,13,98
S01008639,795,596,484,74,38,199,46,14,5,6,3,32,55,29,18,8,3,26,112,74,55,9,10,38,45,33,24,5,4,12,537,446,382,46,18,91
S01008640,699,484,400,57,27,215,22,8,7,0,1,14,44,24,21,1,2,20,154,56,43,6,7,98,40,31,24,6,1,9,439,365,305,44,16,74
S01008641,784,472,406,41,25,312,16,6,6,0,0,10,45,28,21,2,5,17,236,66,58,3,5,170,55,41,29,6,6,14,432,331,292,30,9,101
S01008642,830,593,493,65,35,237,23,7,4,3,0,16,58,40,34,3,3,18,169,89,72,7,10,80,52,35,30,3,2,17,528,422,353,49,20,106
S01008643,608,461,374,64,23,147,25,10,7,1,2,15,37,18,12,3,3,19,106,60,45,5,10,46,43,31,21,8,2,12,397,342,289,47,6,55
S01008644,706,445,380,40,25,261,76,14,8,5,1,62,60,37,28,5,4,23,154,58,53,2,3,96,47,34,28,3,3,13,369,302,263,25,14,67
S01008645,730,489,427,34,28,241,56,17,13,3,1,39,71,38,32,3,3,33,152,83,72,3,8,69,53,42,35,4,3,11,398,309,275,21,13,89
S01008646,739,560,482,44,34,179,61,19,16,1,2,42,79,54,38,7,9,25,114,74,58,7,9,40,79,65,59,5,1,14,406,348,311,24,13,58
S01008647,548,439,391,31,17,109,32,14,9,4,1,18,38,32,29,1,2,6,85,57,51,2,4,28,36,32,24,5,3,4,357,304,278,19,7,53
S01008648,572,419,376,19,24,153,65,15,13,2,0,50,50,31,25,3,3,19,98,51,45,1,5,47,41,35,29,0,6,6,318,287,264,13,10,31
S01008649,869,628,553,31,44,241,125,26,22,1,3,99,96,60,45,7,8,36,96,75,68,1,6,21,66,52,48,1,3,14,486,415,370,21,24,71
S01008650,703,546,483,32,31,157,52,22,20,2,0,30,76,51,48,2,1,25,99,62,53,3,6,37,59,42,36,3,3,17,417,369,326,22,21,48
S01008651,946,583,461,51,71,363,80,33,23,3,7,47,106,62,47,4,11,44,249,127,87,6,34,122,55,37,32,3,2,18,456,324,272,35,17,132
S01008652,548,423,350,31,42,125,77,36,24,2,10,41,80,63,50,4,9,17,88,62,52,4,6,26,56,44,37,3,4,12,247,218,187,18,13,29
S01008653,640,435,367,23,45,205,96,39,28,0,11,57,95,63,48,6,9,32,132,80,66,5,9,52,56,30,23,5,2,26,261,223,202,7,14,38
S01008654,887,647,547,44,56,240,75,14,12,0,2,61,105,79,62,8,9,26,151,93,70,6,17,58,65,58,51,3,4,7,491,403,352,27,24,88
S01008655,754,545,478,36,31,209,61,17,13,3,1,44,56,36,31,5,0,20,129,78,66,2,10,51,62,50,39,3,8,12,446,364,329,23,12,82
S01008656,606,427,348,35,44,179,90,34,21,4,9,56,92,74,58,6,10,18,106,62,53,4,5,44,56,45,36,3,6,11,262,212,180,18,14,50
S01008657,690,458,375,39,44,232,63,19,17,0,2,44,107,55,47,2,6,52,127,80,62,5,13,47,54,38,29,5,4,16,339,266,220,27,19,73
S01008658,1066,667,520,41,106,399,131,45,29,3,13,86,131,73,53,3,17,58,222,118,90,7,21,104,106,73,54,5,14,33,476,358,294,23,41,118
S01008659,784,521,422,37,62,263,70,25,19,0,6,45,96,59,48,3,8,37,219,109,92,2,15,110,61,49,30,5,14,12,338,279,233,27,19,59
S01008660,877,575,445,62,68,302,44,23,15,1,7,21,81,39,35,0,4,42,207,94,77,4,13,113,61,48,37,7,4,13,484,371,281,50,40,113
S01008661,948,532,415,47,70,416,99,33,24,2,7,66,118,70,53,7,10,48,258,128,89,11,28,130,86,51,44,2,5,35,387,250,205,25,20,137
S01008662,727,421,310,31,80,306,37,16,9,4,3,21,62,34,24,2,8,28,273,135,97,3,35,138,72,48,36,1,11,24,283,188,144,21,23,95
S01008663,817,466,362,58,46,351,97,27,21,2,4,70,80,43,28,6,9,37,215,94,77,7,10,121,54,40,30,6,4,14,371,262,206,37,19,109
S01008664,671,470,384,50,36,201,50,13,12,1,0,37,52,35,26,1,8,17,148,77,61,7,9,71,40,30,28,1,1,10,381,315,257,40,18,66
S01008665,1113,727,545,70,112,386,80,25,18,3,4,55,138,72,46,8,18,66,270,145,88,6,51,125,96,69,51,9,9,27,529,416,342,44,30,113
S01008666,941,483,379,56,48,458,27,4,3,1,0,23,80,30,24,2,4,50,268,109,77,12,20,159,55,32,28,1,3,23,511,308,247,40,21,203
S01008667,922,423,315,47,61,499,33,7,4,3,0,26,99,37,28,4,5,62,273,93,67,6,20,180,40,23,14,3,6,17,477,263,202,31,30,214
S01008668,593,311,247,44,20,282,34,14,11,2,1,20,58,29,19,5,5,29,150,53,44,7,2,97,26,18,9,7,2,8,325,197,164,23,10,128
S01008669,544,206,168,9,29,338,12,4,2,1,1,8,43,14,10,0,4,29,312,89,70,3,16,223,22,16,11,2,3,6,155,83,75,3,5,72
S01008670,844,342,265,31,46,502,36,7,6,1,0,29,93,34,19,8,7,59,392,119,86,7,26,273,49,29,23,3,3,20,274,153,131,12,10,121
S01008671,738,326,260,27,39,412,46,13,10,2,1,33,57,22,16,3,3,35,330,100,80,6,14,230,31,11,7,0,4,20,274,180,147,16,17,94
S01008672,654,308,259,22,27,346,55,16,14,1,1,39,68,18,16,2,0,50,202,64,49,1,14,138,29,18,11,5,2,11,300,192,169,13,10,108
S01008673,990,472,349,72,51,518,57,15,11,2,2,42,97,47,35,6,6,50,268,79,54,5,20,189,54,29,25,4,0,25,514,302,224,55,23,212
S01008674,929,448,338,52,58,481,64,25,19,1,5,39,72,37,29,5,3,35,247,92,71,6,15,155,58,38,30,6,2,20,488,256,189,34,33,232
S01008675,691,421,322,56,43,270,72,21,14,1,6,51,75,37,26,7,4,38,102,54,38,6,10,48,49,32,26,5,1,17,393,277,218,37,22,116
S01008676,739,468,359,77,32,271,32,13,7,1,5,19,73,41,28,8,5,32,163,72,60,7,5,91,48,32,22,3,7,16,423,310,242,58,10,113
S01008677,791,486,378,62,46,305,66,31,25,2,4,35,71,45,30,5,10,26,173,89,71,4,14,84,48,38,29,5,4,10,433,283,223,46,14,150
S01008678,1163,488,340,50,98,675,61,15,11,1,3,46,130,43,30,3,10,87,410,166,102,13,51,244,64,30,26,2,2,34,498,234,171,31,32,264
S01008679,1132,492,349,55,88,640,136,31,23,4,4,105,177,72,42,9,21,105,365,130,90,7,33,235,91,46,31,6,9,45,363,213,163,29,21,150
S01008680,600,302,235,23,44,298,58,23,17,4,2,35,75,28,22,0,6,47,172,72,51,5,16,100,34,23,12,5,6,11,261,156,133,9,14,105
S01008681,933,384,300,31,53,549,134,23,18,2,3,111,114,44,29,5,10,70,311,74,55,2,17,237,42,26,21,3,2,16,332,217,177,19,21,115
S01008682,717,417,331,44,42,300,81,25,19,3,3,56,104,62,43,7,12,42,130,44,31,4,9,86,30,26,20,5,1,4,372,260,218,25,17,112
S01008683,1370,510,360,49,101,860,231,67,48,2,17,164,218,99,61,10,28,119,193,75,49,6,20,118,90,55,43,2,10,35,638,214,159,29,26,424
S01008684,862,483,353,49,81,379,182,75,58,3,14,107,165,91,60,9,22,74,130,71,50,3,18,59,62,36,31,0,5,26,323,210,154,34,22,113
S01008685,975,522,390,50,82,453,153,48,31,4,13,105,180,78,51,10,17,102,201,91,64,7,20,110,70,47,35,5,7,23,371,258,209,24,25,113
S01008686,878,490,383,59,48,388,219,45,31,7,7,174,143,82,61,8,13,61,130,74,61,6,7,56,74,56,44,10,2,18,312,233,186,28,19,79
S01008687,621,473,412,36,25,148,49,20,17,1,2,29,65,50,39,6,5,15,76,47,37,3,7,29,50,31,27,3,1,19,381,325,292,23,10,56
S01008688,811,587,473,70,44,224,124,29,19,4,6,95,90,63,46,8,9,27,84,61,45,7,9,23,73,56,45,6,5,17,440,378,318,45,15,62
S01008689,805,613,511,53,49,192,105,20,16,1,3,85,107,75,60,3,12,32,110,87,70,5,12,23,61,50,43,6,1,11,422,381,322,38,21,41
S01008690,910,713,590,83,40,197,113,36,28,3,5,77,123,93,75,13,5,30,77,66,53,5,8,11,76,64,48,11,5,12,521,454,386,51,17,67
S01008691,989,789,660,79,50,200,96,43,27,7,9,53,116,86,71,8,7,30,121,89,65,10,14,32,107,96,85,6,5,11,549,475,412,48,15,74
S01008692,656,464,389,34,41,192,120,31,26,2,3,89,115,77,59,6,12,38,79,67,57,2,8,12,38,33,29,1,3,5,304,256,218,23,15,48
S01008693,422,249,200,40,9,173,128,36,27,8,1,92,121,85,68,12,5,36,54,39,32,6,1,15,33,20,19,1,0,13,86,69,54,13,2,17
S01008694,898,722,620,57,45,176,107,50,40,3,7,57,126,97,81,8,8,29,97,78,66,5,7,19,87,80,66,4,10,7,481,417,367,37,13,64
S01008695,578,436,372,34,30,142,74,19,14,4,1,55,70,47,36,5,6,23,74,57,48,3,6,17,58,48,41,2,5,10,302,265,233,20,12,37
S01008696,550,392,319,52,21,158,72,23,15,6,2,49,99,63,45,12,6,36,72,47,38,5,4,25,58,48,41,4,3,10,249,211,180,25,6,38
S01008697,907,555,461,75,19,352,123,37,23,13,1,86,168,91,78,10,3,77,161,101,79,12,10,60,65,44,37,6,1,21,390,282,244,34,4,108
S01008698,420,273,218,41,14,147,52,25,18,5,2,27,95,56,40,13,3,39,71,41,34,5,2,30,40,30,27,1,2,10,162,121,99,17,5,41
S01008699,762,433,362,36,35,329,241,62,48,9,5,179,185,113,89,6,18,72,97,70,60,5,5,27,52,37,34,2,1,15,187,151,131,14,6,36
S01008700,469,256,187,52,17,213,78,21,6,11,4,57,78,37,32,5,0,41,56,28,19,5,4,28,31,21,18,2,1,10,226,149,112,29,8,77
S01008701,304,196,147,10,39,108,113,53,41,2,10,60,87,59,36,1,22,28,20,16,15,0,1,4,20,14,12,0,2,6,64,54,43,7,4,10
S01008702,496,353,294,25,34,143,83,41,20,6,15,42,107,73,62,3,8,34,84,52,45,2,5,32,40,39,37,1,1,1,182,148,130,13,5,34
S01008703,757,426,322,37,67,331,291,108,69,8,31,183,191,118,80,12,26,73,69,51,46,1,4,18,51,36,34,2,0,15,155,113,93,14,6,42
S01008704,535,303,238,30,35,232,186,60,46,8,6,126,141,90,63,10,17,51,45,28,22,3,3,17,36,30,26,1,3,6,127,95,81,8,6,32
S01008705,395,215,178,20,17,180,157,47,41,5,1,110,91,67,53,7,7,24,37,19,17,2,0,18,23,18,16,0,2,5,87,64,51,6,7,23
S01008706,404,254,189,21,44,150,153,51,34,3,14,102,122,89,61,8,20,33,34,29,23,0,6,5,34,30,22,5,3,4,61,55,49,5,1,6
S01008707,604,325,244,27,54,279,242,98,67,9,22,144,188,100,76,3,21,88,63,43,33,3,7,20,32,22,19,1,2,10,79,62,49,11,2,17
S01008708,733,374,271,22,81,359,294,101,66,8,27,193,222,141,109,6,26,81,66,35,20,1,14,31,55,28,18,3,7,27,96,69,58,4,7,27
S01008709,546,320,261,23,36,226,238,98,79,6,13,140,163,107,86,9,12,56,61,51,39,7,5,10,19,16,15,1,0,3,65,48,42,0,6,17
S01008710,365,222,168,18,36,143,114,43,32,4,7,71,106,77,49,7,21,29,42,29,25,0,4,13,26,16,14,1,1,10,77,57,48,6,3,20
S01008711,570,305,259,18,28,265,262,88,82,5,1,174,143,94,77,5,12,49,44,31,25,1,5,13,36,26,20,1,5,10,85,66,55,6,5,19
S01008712,928,385,281,30,74,543,481,132,102,8,22,349,224,129,85,8,36,95,60,28,21,1,6,32,59,45,36,5,4,14,104,51,37,8,6,53
S01008713,470,295,223,26,46,175,179,79,50,10,19,100,171,121,96,8,17,50,54,45,35,4,6,9,39,30,24,3,3,9,27,20,18,1,1,7
S01008714,485,267,204,22,41,218,177,55,43,2,10,122,125,77,56,7,14,48,61,51,38,1,12,10,40,28,25,1,2,12,82,56,42,11,3,26
S01008715,648,346,289,27,30,302,281,86,72,5,9,195,192,133,109,11,13,59,65,45,36,5,4,20,35,24,19,2,3,11,75,58,53,4,1,17
S01008716,468,241,194,27,20,227,209,51,43,5,3,158,110,75,59,6,10,35,67,48,38,8,2,19,23,20,17,1,2,3,59,47,37,7,3,12
S01008717,339,245,204,24,17,94,70,33,26,6,1,37,122,92,75,9,8,30,57,49,43,4,2,8,25,19,13,4,2,6,65,52,47,1,4,13
S01008718,429,293,239,36,18,136,116,54,40,7,7,62,159,115,88,19,8,44,46,34,32,1,1,12,35,28,24,4,0,7,73,62,55,5,2,11
S01008719,783,547,421,88,38,236,210,98,63,26,9,112,265,201,148,36,17,64,104,79,64,8,7,25,59,52,46,6,0,7,145,117,100,12,5,28
S01008720,443,274,210,37,27,169,151,59,37,13,9,92,115,89,71,10,8,26,63,40,34,2,4,23,27,20,17,3,0,7,87,66,51,9,6,21
S01008721,641,506,426,69,11,135,96,49,35,14,0,47,189,152,122,25,5,37,113,92,80,8,4,21,74,64,61,3,0,10,169,149,128,19,2,20
S01008722,903,470,364,84,22,433,216,39,30,8,1,177,162,80,61,14,5,82,139,94,66,21,7,45,59,38,31,5,2,21,327,219,176,36,7,108
S01008723,581,392,322,54,16,189,86,28,19,8,1,58,143,99,80,14,5,44,118,80,71,6,3,38,68,49,42,4,3,19,166,136,110,22,4,30
S01008724,780,460,353,91,16,320,155,35,25,6,4,120,119,65,47,15,3,54,112,71,48,21,2,41,54,37,28,9,0,17,340,252,205,40,7,88
S01008725,614,420,321,72,27,194,112,40,26,10,4,72,97,61,42,12,7,36,75,55,41,10,4,20,52,40,34,5,1,12,278,224,178,35,11,54
S01008726,452,315,242,64,9,137,30,11,5,6,0,19,60,31,22,9,0,29,61,44,36,5,3,17,29,22,20,2,0,7,272,207,159,42,6,65
S01008727,910,538,422,95,21,372,131,34,26,7,1,97,123,60,43,13,4,63,118,71,53,10,8,47,70,48,41,4,3,22,468,325,259,61,5,143
S01008728,400,252,195,36,21,148,107,31,26,1,4,76,93,60,46,6,8,33,39,25,20,5,0,14,29,21,14,2,5,8,132,115,89,22,4,17
S01008729,551,373,283,77,13,178,62,9,8,1,0,53,76,41,29,7,5,35,82,59,43,13,3,23,24,19,15,3,1,5,307,245,188,53,4,62
S01008730,649,494,398,56,40,155,99,29,18,4,7,70,104,79,54,9,16,25,69,61,50,8,3,8,49,40,32,5,3,9,328,285,244,30,11,43
S01008731,386,199,159,21,19,187,153,29,20,7,2,124,76,55,45,3,7,21,32,18,17,0,1,14,23,15,11,1,3,8,102,82,66,10,6,20
S01008732,503,317,241,43,33,186,115,29,18,6,5,86,122,78,56,9,13,44,80,56,45,5,6,24,42,26,20,3,3,16,144,128,102,20,6,16
S01008733,716,536,470,43,23,180,167,67,56,11,0,100,129,98,84,6,8,31,85,77,69,3,5,8,80,70,61,3,6,10,255,224,200,20,4,31
S01008734,467,286,231,43,12,181,89,16,13,2,1,73,83,48,36,10,2,35,75,47,41,4,2,28,37,30,23,4,3,7,183,145,118,23,4,38
S01008735,806,469,354,94,21,337,127,38,23,14,1,89,148,83,56,21,6,65,150,93,75,13,5,57,57,36,28,4,4,21,324,219,172,42,5,105
S01008736,606,340,279,43,18,266,133,34,27,2,5,99,144,78,58,13,7,66,117,69,58,10,1,48,39,30,26,3,1,9,173,129,110,15,4,44
S01008737,674,391,322,54,15,283,124,34,24,8,2,90,168,94,75,16,3,74,122,75,62,8,5,47,59,43,36,6,1,16,201,145,125,16,4,56
S01008738,648,350,279,57,14,298,124,34,19,12,3,90,136,61,42,14,5,75,117,80,67,10,3,37,64,38,35,2,1,26,207,137,116,19,2,70
S01008739,471,303,250,39,14,168,93,36,27,7,2,57,151,99,75,17,7,52,97,72,65,3,4,25,45,36,32,4,0,9,85,60,51,8,1,25
S01008740,465,279,238,33,8,186,98,36,26,10,0,62,148,93,80,8,5,55,83,52,46,4,2,31,41,31,26,5,0,10,95,67,60,6,1,28
S01008741,792,473,390,58,25,319,194,56,37,16,3,138,236,144,121,11,12,92,130,98,87,7,4,32,70,54,46,5,3,16,162,121,99,19,3,41
S01008742,446,225,189,29,7,221,138,28,22,4,2,110,130,71,59,10,2,59,46,33,29,3,1,13,34,22,20,2,0,12,98,71,59,10,2,27
S01008743,773,481,392,41,48,292,221,57,34,9,14,164,208,145,118,10,17,63,127,99,82,7,10,28,49,41,38,1,2,8,168,139,120,14,5,29
S01008744,881,532,449,42,41,349,259,72,55,6,11,187,229,154,125,12,17,75,114,82,69,8,5,32,84,67,59,3,5,17,195,157,141,13,3,38
S01008745,402,259,218,26,15,143,79,18,14,2,2,61,78,45,40,3,2,33,57,47,40,3,4,10,32,29,25,2,2,3,156,120,99,16,5,36
S01008746,895,555,450,35,70,340,259,95,73,3,19,164,221,128,90,14,24,93,96,70,61,4,5,26,70,50,39,5,6,20,249,212,187,9,16,37
S01008747,421,246,192,44,10,175,80,18,9,8,1,62,121,61,46,12,3,60,52,38,29,5,4,14,36,24,21,3,0,12,132,105,87,16,2,27
S01008748,567,327,270,42,15,240,111,31,22,5,4,80,159,85,65,17,3,74,83,55,45,5,5,28,50,30,28,2,0,20,164,126,110,13,3,38
S01008749,841,494,390,79,25,347,195,67,40,25,2,128,225,124,88,23,13,101,134,97,81,9,7,37,77,48,44,3,1,29,210,158,137,19,2,52
S01008750,611,343,278,46,19,268,137,34,22,11,1,103,155,95,76,11,8,60,112,77,62,9,6,35,51,31,26,4,1,20,156,106,92,11,3,50
S01008751,504,289,230,36,23,215,159,36,26,6,4,123,145,86,65,14,7,59,60,50,38,6,6,10,36,30,25,2,3,6,104,87,76,8,3,17
S01008752,664,354,283,22,49,310,272,73,55,2,16,199,177,115,81,9,25,62,76,52,47,3,2,24,42,38,30,3,5,4,97,76,70,5,1,21
S01008753,458,260,212,18,30,198,179,58,43,4,11,121,136,91,69,7,15,45,50,35,31,2,2,15,17,13,12,1,0,4,76,63,57,4,2,13
S01008754,543,378,327,28,23,165,144,50,43,2,5,94,143,101,77,14,10,42,64,53,47,2,4,11,39,37,36,1,0,2,153,137,124,9,4,16
S01008755,815,563,466,42,55,252,241,97,67,9,21,144,224,165,128,14,23,59,83,67,62,2,3,16,68,62,55,4,3,6,199,172,154,13,5,27
S01008756,624,384,307,31,46,240,240,82,63,3,16,158,148,107,82,7,18,41,55,42,33,5,4,13,47,40,32,2,6,7,134,113,97,14,2,21
S01008757,539,257,190,17,50,282,264,71,50,5,16,193,138,85,66,5,14,53,45,31,18,4,9,14,31,25,18,1,6,6,61,45,38,2,5,16
S01008758,694,385,299,43,43,309,265,81,57,10,14,184,182,125,97,16,12,57,70,44,35,2,7,26,58,40,30,5,5,18,119,95,80,10,5,24
S01008759,464,256,197,21,38,208,185,61,41,9,11,124,139,90,70,6,14,49,42,31,25,2,4,11,38,30,23,1,6,8,60,44,38,3,3,16
S01008760,763,434,345,27,62,329,287,116,90,6,20,171,237,144,110,7,27,93,80,54,42,4,8,26,56,43,36,4,3,13,103,77,67,6,4,26
S01008761,599,438,368,51,19,161,151,58,47,10,1,93,126,101,80,12,9,25,86,71,65,4,2,15,68,59,49,8,2,9,168,149,127,17,5,19
S01008762,527,336,289,33,14,191,166,51,43,6,2,115,141,104,82,14,8,37,72,55,50,5,0,17,31,23,22,0,1,8,117,103,92,8,3,14
S01008763,766,606,520,63,23,160,121,42,35,6,1,79,147,111,90,14,7,36,106,95,89,2,4,11,52,45,33,8,4,7,340,313,273,33,7,27
S01008764,586,429,356,51,22,157,107,32,22,6,4,75,125,96,72,13,11,29,67,49,40,9,0,18,44,36,27,6,3,8,243,216,195,17,4,27
S01008765,688,526,421,76,29,162,92,33,23,5,5,59,131,100,79,11,10,31,85,70,57,9,4,15,76,57,46,7,4,19,304,266,216,44,6,38
S01008766,863,552,428,100,24,311,195,64,42,20,2,131,195,115,95,15,5,80,136,101,78,15,8,35,68,51,36,12,3,17,269,221,177,38,6,48
S01008767,462,306,250,35,21,156,85,32,25,5,2,53,133,92,77,9,6,41,76,58,49,5,4,18,48,31,23,4,4,17,120,93,76,12,5,27
S01008768,453,280,234,32,14,173,131,34,27,4,3,97,81,47,40,6,1,34,40,30,25,2,3,10,56,43,40,1,2,13,145,126,102,19,5,19
S01008769,621,545,456,65,24,76,18,10,7,1,2,8,68,53,45,6,2,15,76,65,51,11,3,11,65,53,42,6,5,12,394,364,311,41,12,30
S01008770,725,594,492,75,27,131,38,22,13,7,2,16,86,65,55,6,4,21,110,87,70,8,9,23,85,75,62,8,5,10,406,345,292,46,7,61
S01008771,644,479,373,76,30,165,90,30,15,5,10,60,86,61,45,9,7,25,78,58,50,5,3,20,64,58,46,8,4,6,326,272,217,49,6,54
S01008772,669,439,355,60,24,230,135,32,28,2,2,103,115,67,51,9,7,48,73,53,38,10,5,20,54,33,27,3,3,21,292,254,211,36,7,38
S01008773,908,654,557,54,43,254,167,49,36,8,5,118,181,122,98,12,12,59,121,95,85,6,4,26,96,78,66,2,10,18,343,310,272,26,12,33
S01008774,789,565,467,54,44,224,139,47,32,5,10,92,191,124,101,8,15,67,112,83,69,9,5,29,66,63,54,5,4,3,281,248,211,27,10,33
S01008775,412,299,236,46,17,113,57,15,12,2,1,42,80,49,32,9,8,31,53,41,32,6,3,12,22,17,12,5,0,5,200,177,148,24,5,23
S01008776,755,487,374,47,66,268,144,32,26,3,3,112,149,80,53,6,21,69,94,63,42,7,14,31,69,57,47,4,6,12,299,255,206,27,22,44
S01008777,949,564,443,51,70,385,310,93,75,3,15,217,195,115,82,9,24,80,88,58,43,5,10,30,78,65,50,6,9,13,278,233,193,28,12,45
S01008778,999,837,680,107,50,162,84,32,24,4,4,52,146,110,91,10,9,36,128,108,85,15,8,20,94,82,66,9,7,12,547,505,414,69,22,42
S01008779,662,578,479,71,28,84,42,25,13,8,4,17,80,63,46,12,5,17,78,69,54,6,9,9,67,64,55,7,2,3,395,357,311,38,8,38
S01008780,529,437,366,54,17,92,37,13,9,3,1,24,77,58,47,7,4,19,74,56,47,6,3,18,64,60,51,9,0,4,277,250,212,29,9,27
S01008781,787,669,573,45,51,118,93,46,32,4,10,47,143,111,90,8,13,32,98,88,74,3,11,10,83,72,63,4,5,11,370,352,314,26,12,18
S01008782,697,543,447,64,32,154,103,22,17,3,2,81,79,63,42,11,10,16,81,70,60,9,1,11,75,60,44,7,9,15,359,328,284,34,10,31
S01008783,366,317,265,43,9,49,24,13,13,0,0,11,65,56,43,9,4,9,56,45,38,7,0,11,24,21,20,1,0,3,197,182,151,26,5,15
S01008784,395,342,285,37,20,53,37,20,15,2,3,17,69,54,41,8,5,15,43,38,34,2,2,5,35,34,31,2,1,1,211,196,164,23,9,15
S01008785,732,452,350,45,57,280,221,70,47,6,17,151,154,89,66,6,17,65,62,48,41,6,1,14,54,44,33,3,8,10,241,201,163,24,14,40
S01008786,857,684,559,66,59,173,97,30,16,2,12,67,136,97,76,5,16,39,89,79,65,4,10,10,83,68,55,8,5,15,452,410,347,47,16,42
S01008787,280,151,111,12,28,129,103,39,29,3,7,64,71,43,29,1,13,28,21,15,11,0,4,6,31,22,17,3,2,9,54,32,25,5,2,22
S01008788,614,513,434,53,26,101,58,25,17,4,4,33,91,68,62,2,4,23,72,62,49,4,9,10,56,45,40,5,0,11,337,313,266,38,9,24
S01008789,582,303,254,30,19,279,192,28,24,3,1,164,127,69,57,4,8,58,64,41,36,2,3,23,35,28,28,0,0,7,164,137,109,21,7,27
S01008790,576,421,323,41,57,155,108,41,24,7,10,67,98,67,47,6,14,31,75,60,49,6,5,15,66,53,44,6,3,13,229,200,159,16,25,29
S01008791,779,608,510,57,41,171,118,51,37,6,8,67,135,109,85,16,8,26,77,55,48,4,3,22,89,74,58,9,7,15,360,319,282,22,15,41
S01008792,685,514,422,56,36,171,123,38,26,5,7,85,120,91,72,9,10,29,82,66,56,5,5,16,60,50,40,10,0,10,300,269,228,27,14,31
S01008793,388,239,172,21,46,149,104,27,16,4,7,77,71,45,32,4,9,26,40,29,18,1,10,11,41,34,26,1,7,7,132,104,80,11,13,28
S01008794,773,468,399,33,36,305,248,54,40,5,9,194,165,103,85,7,11,62,63,52,46,2,4,11,69,53,47,3,3,16,228,206,181,16,9,22
S01008795,1000,795,667,74,54,205,118,42,32,6,4,76,158,122,92,16,14,36,139,111,85,14,12,28,97,85,80,4,1,12,488,435,378,34,23,53
S01008796,950,670,568,54,48,280,226,82,67,9,6,144,160,113,87,7,19,47,104,79,67,5,7,25,89,70,60,7,3,19,371,326,287,26,13,45
S01008797,888,660,573,44,43,228,153,38,29,4,5,115,134,93,73,6,14,41,117,96,87,6,3,21,79,69,60,5,4,10,405,364,324,23,17,41
S01008798,724,509,420,43,46,215,151,51,39,3,9,100,102,58,49,6,3,44,98,71,62,3,6,27,64,54,39,6,9,10,309,275,231,25,19,34
S01008799,565,435,373,33,29,130,85,31,25,5,1,54,121,94,75,8,11,27,89,66,58,0,8,23,63,60,52,3,5,3,207,184,163,17,4,23
S01008800,970,831,704,64,63,139,82,42,28,5,9,40,145,116,93,11,12,29,127,111,99,4,8,16,103,92,81,7,4,11,513,470,403,37,30,43
S01008801,870,706,604,49,53,164,120,62,49,6,7,58,120,96,83,6,7,24,103,82,72,3,7,21,82,74,62,6,6,8,445,392,338,28,26,53
S01008802,892,666,549,60,57,226,140,57,40,12,5,83,156,118,89,11,18,38,98,70,54,12,4,28,102,91,76,4,11,11,396,330,290,21,19,66
S01008803,862,640,510,66,64,222,145,61,50,1,10,84,163,117,75,13,29,46,99,75,59,7,9,24,90,71,55,8,8,19,365,316,271,37,8,49
S01008804,608,372,317,23,32,236,145,27,21,1,5,118,107,79,58,8,13,28,53,37,30,2,5,16,63,47,37,4,6,16,240,182,171,8,3,58
S01008805,589,441,374,31,36,148,42,20,15,2,3,22,65,40,30,3,7,25,77,58,54,1,3,19,66,53,43,8,2,13,339,270,232,17,21,69
S01008806,919,751,649,67,35,168,76,35,26,7,2,41,121,84,70,7,7,37,104,87,77,4,6,17,74,64,52,8,4,10,544,481,424,41,16,63
S01008807,742,559,471,57,31,183,102,36,31,2,3,66,98,65,56,3,6,33,90,64,51,4,9,26,70,55,47,8,0,15,382,339,286,40,13,43
S01008808,614,445,344,75,26,169,105,26,18,5,3,79,68,42,29,11,2,26,75,51,33,9,9,24,39,35,29,3,3,4,327,291,235,47,9,36
S01008809,570,402,287,90,25,168,42,13,10,1,2,29,48,35,20,6,9,13,88,49,32,10,7,39,42,37,28,8,1,5,350,268,197,65,6,82
S01008810,654,515,418,68,29,139,35,10,8,2,0,25,68,48,30,9,9,20,80,53,46,4,3,27,41,37,29,4,4,4,430,367,305,49,13,63
S01008811,794,600,478,86,36,194,68,31,21,6,4,37,99,71,57,8,6,28,135,76,60,8,8,59,51,44,36,5,3,7,441,378,304,59,15,63
S01008812,436,338,272,42,24,98,31,8,5,2,1,23,48,33,25,3,5,15,53,38,30,6,2,15,36,26,19,1,6,10,268,233,193,30,10,35
S01008813,828,592,440,74,78,236,176,76,55,6,15,100,150,107,70,9,28,43,98,66,41,15,10,32,77,61,53,4,4,16,327,282,221,40,21,45
S01008814,732,567,457,62,48,165,99,42,24,12,6,57,109,79,64,2,13,30,104,80,67,6,7,24,49,46,37,8,1,3,371,320,265,34,21,51
S01008815,806,617,518,51,48,189,115,52,34,6,12,63,125,94,71,13,10,31,91,69,63,3,3,22,91,77,72,1,4,14,384,325,278,28,19,59
S01008816,473,316,264,22,30,157,87,22,12,3,7,65,75,42,31,2,9,33,69,54,48,3,3,15,40,32,25,3,4,8,202,166,148,11,7,36
S01008817,658,492,419,40,33,166,114,35,26,3,6,79,121,82,67,8,7,39,79,68,60,6,2,11,66,56,42,5,9,10,278,251,224,18,9,27
S01008818,641,514,445,50,19,127,54,23,19,3,1,31,139,95,77,9,9,44,73,57,50,4,3,16,61,55,45,7,3,6,314,284,254,27,3,30
S01008819,646,470,385,64,21,176,94,13,9,2,2,81,100,65,57,4,4,35,68,48,36,9,3,20,38,36,28,4,4,2,346,308,255,45,8,38
S01008820,962,692,542,79,71,270,197,64,44,10,10,133,173,118,73,12,33,55,100,86,71,10,5,14,82,63,55,5,3,19,410,361,299,42,20,49
S01008821,550,409,339,51,19,141,49,16,10,4,2,33,83,50,39,4,7,33,68,43,33,6,4,25,39,27,21,4,2,12,311,273,236,33,4,38
S01008822,585,396,304,70,22,189,63,14,10,4,0,49,61,33,22,9,2,28,75,47,33,6,8,28,41,35,26,8,1,6,345,267,213,43,11,78
S01008823,556,350,265,71,14,206,101,18,7,8,3,83,70,37,21,12,4,33,55,41,34,6,1,14,31,21,17,4,0,10,299,233,186,41,6,66
S01008824,833,581,482,74,25,252,115,29,16,9,4,86,104,51,41,8,2,53,85,66,58,3,5,19,74,60,49,6,5,14,455,375,318,48,9,80
S01008825,512,361,297,58,6,151,62,15,12,3,0,47,69,39,29,9,1,30,55,43,40,3,0,12,30,26,23,3,0,4,296,238,193,40,5,58
S01008826,589,427,334,63,30,162,78,23,15,4,4,55,106,72,55,6,11,34,62,48,41,3,4,14,42,27,24,2,1,15,301,257,199,48,10,44
S01008827,570,337,255,71,11,233,26,5,3,2,0,21,62,20,12,7,1,42,47,30,22,5,3,17,37,20,16,3,1,17,398,262,202,54,6,136
S01008828,751,498,393,85,20,253,86,24,16,8,0,62,103,59,48,4,7,44,99,63,52,9,2,36,65,53,45,5,3,12,398,299,232,59,8,99
S01008829,564,344,277,46,21,220,111,31,25,3,3,80,95,58,49,5,4,37,62,39,29,5,5,23,38,28,24,1,3,10,258,188,150,32,6,70
S01008830,561,358,288,59,11,203,71,14,10,4,0,57,62,25,19,5,1,37,71,41,34,2,5,30,37,28,21,6,1,9,320,250,204,42,4,70
S01008831,658,367,271,80,16,291,74,15,9,6,0,59,96,41,28,12,1,55,92,38,29,5,4,54,60,40,31,6,3,20,336,233,174,51,8,103
S01008832,655,335,242,61,32,320,102,24,10,8,6,78,76,42,27,7,8,34,71,36,27,5,4,35,31,21,16,3,2,10,375,212,162,38,12,163
S01008833,863,542,435,80,27,321,94,11,8,1,2,83,81,40,33,4,3,41,110,71,55,13,3,39,52,34,22,3,9,18,526,386,317,59,10,140
S01008834,977,608,468,118,22,369,122,23,16,6,1,99,116,54,39,12,3,62,116,63,44,15,4,53,56,40,32,4,4,16,567,428,337,81,10,139
S01008835,695,434,372,40,22,261,148,37,31,4,2,111,126,68,50,8,10,58,103,76,69,4,3,27,45,33,32,0,1,12,273,220,190,24,6,53
S01008836,606,432,359,44,29,174,128,32,27,2,3,96,108,79,66,8,5,29,73,61,45,8,8,12,49,46,39,4,3,3,248,214,182,22,10,34
S01008837,939,767,646,77,44,172,85,28,19,1,8,57,104,75,58,8,9,29,110,88,69,13,6,22,72,65,53,7,5,7,568,511,447,48,16,57
S01008838,933,716,600,81,35,217,94,32,24,5,3,62,109,74,67,4,3,35,122,95,79,8,8,27,81,67,59,3,5,14,527,448,371,61,16,79
S01008839,918,680,575,81,24,238,75,21,17,3,1,54,118,78,64,8,6,40,140,93,83,9,1,47,77,70,57,6,7,7,508,418,354,55,9,90
S01008840,934,688,569,81,38,246,89,31,24,5,2,58,121,73,48,12,13,48,129,79,59,11,9,50,61,49,43,4,2,12,534,456,395,49,12,78
S01008841,502,389,331,48,10,113,54,22,17,3,2,32,73,42,34,7,1,31,51,39,32,5,2,12,54,49,40,8,1,5,270,237,208,25,4,33
S01008842,789,648,530,70,48,141,53,26,15,9,2,27,114,87,61,14,12,27,87,65,58,2,5,22,71,57,50,4,3,14,464,413,346,41,26,51
S01008843,912,685,565,66,54,227,62,15,8,6,1,47,101,64,52,5,7,37,111,83,70,5,8,28,77,64,47,11,6,13,561,459,388,39,32,102
S01008844,617,479,400,45,34,138,28,11,10,0,1,17,74,50,33,6,11,24,79,48,36,8,4,31,45,31,25,3,3,14,391,339,296,28,15,52
S01008845,795,531,429,73,29,264,31,8,3,2,3,23,54,22,15,6,1,32,168,86,70,9,7,82,50,37,25,8,4,13,492,378,316,48,14,114
S01008846,741,508,383,100,25,233,45,9,7,2,0,36,82,44,30,9,5,38,137,66,54,12,0,71,48,35,32,2,1,13,429,354,260,75,19,75
S01008847,537,360,267,71,22,177,20,8,3,5,0,12,44,21,17,4,0,23,95,38,24,6,8,57,34,27,18,8,1,7,344,266,205,48,13,78
S01008848,711,482,353,104,25,229,32,10,9,0,1,22,54,31,20,7,4,23,149,53,38,12,3,96,44,36,24,8,4,8,432,352,262,77,13,80
S01008849,663,465,343,105,17,198,11,5,1,4,0,6,51,30,22,4,4,21,110,43,33,9,1,67,25,19,14,4,1,6,466,368,273,84,11,98
S01008850,739,442,315,109,18,297,27,7,2,4,1,20,41,18,9,8,1,23,157,55,36,16,3,102,28,17,13,4,0,11,486,345,255,77,13,141
S01008851,952,628,464,124,40,324,109,31,27,4,0,78,93,37,25,5,7,56,120,64,45,9,10,56,63,46,29,10,7,17,567,450,338,96,16,117
S01008852,884,576,389,164,23,308,37,13,11,2,0,24,56,24,17,4,3,32,110,46,31,10,5,64,42,28,17,10,1,14,639,465,313,138,14,174
S01008853,607,476,380,72,24,131,5,2,2,0,0,3,49,35,25,8,2,14,95,45,39,4,2,50,22,17,16,0,1,5,436,377,298,60,19,59
S01008854,846,577,407,137,33,269,19,5,4,0,1,14,65,36,30,3,3,29,153,61,43,10,8,92,36,23,17,4,2,13,573,452,313,120,19,121
S01008855,985,739,595,119,25,246,36,7,3,4,0,29,61,37,27,6,4,24,107,53,40,10,3,54,58,44,30,12,2,14,723,598,495,87,16,125
S01008856,507,410,338,53,19,97,22,4,3,0,1,18,58,39,29,7,3,19,49,34,23,6,5,15,39,31,26,4,1,8,339,302,257,36,9,37
S01008857,693,547,440,85,22,146,38,18,13,2,3,20,64,39,32,5,2,25,76,49,41,2,6,27,48,44,37,6,1,4,467,397,317,70,10,70
S01008858,499,367,275,82,10,132,25,8,3,4,1,17,37,18,12,5,1,19,41,25,20,4,1,16,23,19,16,2,1,4,373,297,224,67,6,76
S01008859,1041,747,590,123,34,294,115,11,5,3,3,104,94,49,34,13,2,45,101,69,50,13,6,32,68,52,39,7,6,16,663,566,462,87,17,97
S01008860,806,597,488,69,40,209,71,15,10,5,0,56,76,52,42,1,9,24,88,63,49,7,7,25,58,44,29,4,11,14,513,423,358,52,13,90
S01008861,639,430,296,123,11,209,28,11,4,7,0,17,43,19,14,5,0,24,69,35,28,7,0,34,34,22,12,9,1,12,465,343,238,95,10,122
S01008862,828,662,527,104,31,166,49,9,6,2,1,40,78,56,36,13,7,22,88,69,55,11,3,19,45,38,30,6,2,7,568,490,400,72,18,78
S01008863,641,487,401,74,12,154,54,16,14,2,0,38,58,29,22,4,3,29,52,35,28,7,0,17,37,31,24,6,1,6,440,376,313,55,8,64
S01008864,880,436,370,50,16,444,78,5,2,2,1,73,197,21,19,1,1,176,137,41,36,4,1,96,34,28,21,4,3,6,434,341,292,39,10,93
S01008865,744,528,446,59,23,216,64,13,8,2,3,51,76,39,35,1,3,37,66,46,43,1,2,20,48,36,32,4,0,12,490,394,328,51,15,96
S01008866,711,573,466,86,21,138,41,14,5,7,2,27,34,16,10,3,3,18,62,42,28,11,3,20,51,37,28,7,2,14,523,464,395,58,11,59
S01008867,697,504,389,100,15,193,29,9,6,2,1,20,50,29,23,4,2,21,62,34,22,9,3,28,40,29,26,3,0,11,516,403,312,82,9,113
S01008868,728,559,432,95,32,169,17,11,7,3,1,6,68,49,36,7,6,19,90,45,35,8,2,45,73,52,42,9,1,21,480,402,312,68,22,78
S01008869,937,653,493,130,30,284,47,15,11,4,0,32,79,42,31,7,4,37,83,46,26,16,4,37,54,35,25,7,3,19,674,515,400,96,19,159
S01008870,697,498,394,93,11,199,50,15,10,5,0,35,60,39,30,6,3,21,54,35,26,8,1,19,46,39,31,8,0,7,487,370,297,66,7,117
S01008871,973,683,524,123,36,290,29,8,5,3,0,21,68,36,26,7,3,32,187,90,65,14,11,97,73,55,43,6,6,18,616,494,385,93,16,122
S01008872,767,544,417,91,36,223,45,13,9,4,0,32,58,41,29,10,2,17,167,108,78,10,20,59,36,27,24,1,2,9,461,355,277,66,12,106
S01008873,588,418,300,106,12,170,23,6,4,2,0,17,48,27,16,9,2,21,72,45,35,8,2,27,37,28,23,4,1,9,408,312,222,83,7,96
S01008874,774,533,437,77,19,241,93,19,10,8,1,74,83,45,34,8,3,38,92,69,54,9,6,23,52,36,32,3,1,16,454,364,307,49,8,90
S01008875,756,529,443,56,30,227,83,18,14,4,0,65,121,67,50,4,13,54,109,73,65,6,2,36,49,44,34,7,3,5,394,327,280,35,12,67
S01008876,497,294,236,44,14,203,84,16,10,2,4,68,80,39,25,12,2,41,72,60,47,9,4,12,42,32,26,3,3,10,219,147,128,18,1,72
S01008877,444,306,244,51,11,138,43,10,7,3,0,33,79,44,32,8,4,35,60,42,34,4,4,18,45,32,25,5,2,13,217,178,146,31,1,39
S01008878,778,444,358,64,22,334,251,61,45,10,6,190,152,88,71,11,6,64,98,74,62,9,3,24,60,42,32,9,1,18,217,179,148,25,6,38
S01008879,696,448,385,44,19,248,159,49,39,6,4,110,131,90,76,9,5,41,103,72,66,3,3,31,61,47,41,5,1,14,242,190,163,21,6,52
S01008880,533,344,296,36,12,189,85,15,11,2,2,70,74,42,31,7,4,32,72,49,44,2,3,23,51,42,39,2,1,9,251,196,171,23,2,55
S01008881,518,266,191,57,18,252,58,6,4,2,0,52,71,30,18,6,6,41,63,27,17,8,2,36,36,29,24,3,2,7,290,174,128,38,8,116
S01008882,851,504,369,124,11,347,55,10,8,1,1,45,87,26,23,3,0,61,122,60,49,8,3,62,32,24,19,5,0,8,555,384,270,107,7,171
S01008883,790,400,279,110,11,390,80,15,10,5,0,65,68,21,9,12,0,47,79,28,22,4,2,51,34,20,13,7,0,14,529,316,225,82,9,213
S01008884,590,285,206,67,12,305,32,6,3,3,0,26,77,19,15,2,2,58,73,26,22,4,0,47,37,15,7,7,1,22,371,219,159,51,9,152
S01008885,680,425,320,87,18,255,50,13,10,3,0,37,74,28,17,8,3,46,93,48,34,11,3,45,40,26,23,1,2,14,423,310,236,64,10,113
S01008886,712,441,362,56,23,271,62,15,10,4,1,47,87,40,31,7,2,47,106,59,49,3,7,47,52,36,27,5,4,16,405,291,245,37,9,114
S01008887,643,400,323,59,18,243,83,15,7,6,2,68,103,46,38,6,2,57,80,45,35,6,4,35,68,54,46,7,1,14,309,240,197,34,9,69
S01008888,542,408,337,48,23,134,24,9,5,2,2,15,64,44,35,6,3,20,72,49,42,4,3,23,34,22,18,3,1,12,348,284,237,33,14,64
S01008889,459,322,262,49,11,137,68,29,21,7,1,39,83,41,33,7,1,42,55,46,38,6,2,9,42,32,25,5,2,10,211,174,145,24,5,37
S01008890,599,356,291,53,12,243,105,23,15,7,1,82,97,55,42,11,2,42,97,64,51,7,6,33,48,35,26,7,2,13,252,179,157,21,1,73
S01008891,628,373,301,64,8,255,71,17,14,3,0,54,124,61,48,9,4,63,86,55,45,9,1,31,45,25,15,9,1,20,302,215,179,34,2,87
S01008892,837,490,400,66,24,347,115,22,17,2,3,93,136,74,54,12,8,62,92,58,49,4,5,34,64,34,25,8,1,30,430,302,255,40,7,128
S01008893,724,456,357,84,15,268,56,17,8,7,2,39,80,36,26,8,2,44,92,57,43,11,3,35,60,41,34,6,1,19,436,305,246,52,7,131
S01008894,688,416,314,90,12,272,43,13,10,3,0,30,89,48,34,12,2,41,99,56,46,9,1,43,50,30,23,7,0,20,407,269,201,59,9,138
S01008895,632,321,255,62,4,311,68,12,9,3,0,56,72,31,20,11,0,41,85,41,34,4,3,44,43,19,18,1,0,24,364,218,174,43,1,146
S01008896,410,264,230,30,4,146,33,9,7,1,1,24,51,25,17,8,0,26,58,35,32,2,1,23,32,25,23,2,0,7,236,170,151,17,2,66
S01008897,551,326,259,49,18,225,79,14,8,5,1,65,76,42,32,5,5,34,55,37,27,7,3,18,32,17,15,0,2,15,309,216,177,32,7,93
S01008898,689,411,308,84,19,278,76,25,15,9,1,51,109,51,33,15,3,58,111,68,49,11,8,43,52,37,28,6,3,15,341,230,183,43,4,111
S01008899,669,391,297,39,55,278,249,79,61,9,9,170,206,145,110,4,31,61,68,49,36,9,4,19,51,38,28,6,4,13,95,80,62,11,7,15
S01008900,789,516,440,37,39,273,250,95,75,12,8,155,240,169,147,7,15,71,98,76,60,8,8,22,43,36,31,2,3,7,158,140,127,8,5,18
S01008901,685,407,333,41,33,278,267,89,67,14,8,178,184,135,110,10,15,49,76,56,49,2,5,20,53,43,37,4,2,10,105,84,70,11,3,21
S01008902,831,515,425,46,44,316,258,88,70,4,14,170,251,171,135,17,19,80,89,75,66,4,5,14,65,46,35,7,4,19,168,135,119,14,2,33
S01008903,811,469,405,32,32,342,297,94,78,4,12,203,240,157,136,11,10,83,73,59,50,4,5,14,60,47,43,2,2,13,141,112,98,11,3,29
S01008904,810,523,421,38,64,287,204,86,71,1,14,118,222,135,113,6,16,87,68,50,45,1,4,18,85,60,39,8,13,25,231,192,153,22,17,39
S01008905,843,505,396,25,84,338,302,122,89,3,30,180,263,160,120,11,29,103,87,65,53,1,11,22,60,49,40,3,6,11,131,109,94,7,8,22
S01008906,616,407,305,28,74,209,165,77,50,6,21,88,185,121,86,8,27,64,72,50,40,2,8,22,63,51,38,3,10,12,131,108,91,9,8,23
S01008907,437,225,171,18,36,212,169,64,44,5,15,105,152,76,61,5,10,76,30,17,12,3,2,13,30,25,20,0,5,5,56,43,34,5,4,13
S01008908,717,440,350,45,45,277,229,95,67,9,19,134,203,122,92,12,18,81,67,51,44,6,1,16,55,39,32,4,3,16,163,133,115,14,4,30
S01008909,639,438,370,34,34,201,184,91,76,6,9,93,220,158,128,13,17,62,98,79,73,5,1,19,57,43,36,4,3,14,80,67,57,6,4,13
S01008910,374,266,226,25,15,108,96,42,35,4,3,54,119,93,78,8,7,26,38,29,24,3,2,9,39,30,27,1,2,9,82,72,62,9,1,10
S01008911,787,611,505,79,27,176,90,27,17,7,3,63,112,80,65,6,9,32,102,78,65,11,2,24,72,58,49,8,1,14,411,368,309,47,12,43
S01008912,640,448,362,65,21,192,119,40,30,8,2,79,141,98,77,16,5,43,101,79,61,11,7,22,48,43,36,5,2,5,231,188,158,25,5,43
S01008913,514,404,337,40,27,110,97,48,38,5,5,49,117,87,69,9,9,30,69,53,43,4,6,16,36,34,28,5,1,2,195,182,159,17,6,13
S01008914,739,458,386,55,17,281,225,63,51,10,2,162,188,124,99,14,11,64,89,70,63,6,1,19,51,37,33,3,1,14,186,164,140,22,2,22
S01008915,463,298,236,49,13,165,73,18,9,6,3,55,109,77,61,10,6,32,72,48,40,5,3,24,38,28,22,6,0,10,171,127,104,22,1,44
S01008916,906,464,363,42,59,442,395,109,84,10,15,286,199,121,90,7,24,78,106,79,65,8,6,27,63,48,41,4,3,15,143,107,83,13,11,36
S01008917,562,333,250,29,54,229,193,68,54,5,9,125,164,106,74,5,27,58,61,44,37,2,5,17,47,31,23,4,4,16,97,84,62,13,9,13
S01008918,423,262,181,22,59,161,149,66,44,3,19,83,116,76,57,3,16,40,31,26,15,2,9,5,45,27,20,2,5,18,82,67,45,12,10,15
S01008919,404,248,176,15,57,156,131,48,27,3,18,83,115,82,61,3,18,33,39,25,18,1,6,14,50,36,28,2,6,14,69,57,42,6,9,12
S01008920,948,792,658,88,46,156,81,34,23,6,5,47,172,136,98,23,15,36,128,110,95,9,6,18,89,77,63,10,4,12,478,435,379,40,16,43
S01008921,589,334,247,21,66,255,263,92,68,5,19,171,171,115,78,5,32,56,37,30,23,1,6,7,38,29,22,3,4,9,80,68,56,7,5,12
S01008922,648,385,304,28,53,263,222,78,63,8,7,144,218,143,110,8,25,75,58,41,32,2,7,17,52,39,30,2,7,13,98,84,69,8,7,14
S01008923,611,379,306,34,39,232,227,90,65,9,16,137,168,119,99,5,15,49,67,53,43,6,4,14,56,43,37,3,3,13,93,74,62,11,1,19
S01008924,704,445,351,19,75,259,262,124,98,6,20,138,243,168,129,7,32,75,65,46,34,2,10,19,44,37,33,1,3,7,90,70,57,3,10,20
S01008925,502,387,326,29,32,115,106,63,52,5,6,43,188,150,119,12,19,38,68,58,52,4,2,10,57,41,40,0,1,16,83,75,63,8,4,8
S01008926,475,356,303,34,19,119,133,65,50,10,5,68,164,139,117,11,11,25,47,43,40,2,1,4,26,21,19,1,1,5,105,88,77,10,1,17
S01008927,657,528,465,31,32,129,75,35,28,6,1,40,161,117,94,7,16,44,83,68,61,2,5,15,93,82,72,6,4,11,245,226,210,10,6,19
S01008928,628,378,298,33,47,250,211,56,41,9,6,155,130,82,59,7,16,48,87,63,46,4,13,24,52,46,37,1,8,6,148,131,115,12,4,17
S01008929,631,345,223,11,111,286,254,104,62,1,41,150,195,114,65,1,48,81,65,40,27,3,10,25,50,41,35,2,4,9,67,46,34,4,8,21
S01008930,683,398,289,19,90,285,308,119,86,8,25,189,213,152,101,4,47,61,51,42,29,3,10,9,38,30,27,1,2,8,73,55,46,3,6,18
S01008931,594,356,296,12,48,238,253,109,89,3,17,144,204,139,116,1,22,65,41,35,26,3,6,6,31,23,20,0,3,8,65,50,45,5,0,15
S01008932,694,525,439,49,37,169,143,71,51,14,6,72,199,147,122,12,13,52,82,71,59,3,9,11,50,41,38,3,0,9,220,195,169,17,9,25
S01008933,505,350,268,17,65,155,167,85,63,5,17,82,163,120,84,5,31,43,46,36,29,1,6,10,39,34,27,2,5,5,90,75,65,4,6,15
S01008934,594,400,319,41,40,194,185,82,63,8,11,103,168,119,93,10,16,49,82,63,51,6,6,19,36,31,25,4,2,5,123,105,87,13,5,18
S01008935,732,432,363,48,21,300,110,32,20,11,1,78,183,109,87,14,8,74,131,86,78,5,3,45,78,55,48,3,4,23,230,150,130,15,5,80
S01008936,300,191,155,35,1,109,36,11,7,4,0,25,50,27,19,8,0,23,39,27,22,5,0,12,21,14,12,2,0,7,154,112,95,16,1,42
S01008937,694,423,335,58,30,271,138,37,26,7,4,101,150,86,62,16,8,64,99,72,59,5,8,27,52,40,30,5,5,12,255,188,158,25,5,67
S01008938,583,344,276,56,12,239,74,21,15,6,0,53,132,67,54,7,6,65,84,54,39,10,5,30,53,31,24,6,1,22,240,171,144,27,0,69
S01008939,659,381,308,55,18,278,111,28,16,10,2,83,136,82,57,18,7,54,128,86,72,10,4,42,72,49,45,3,1,23,212,136,118,14,4,76
S01008940,508,274,196,68,10,234,43,13,7,6,0,30,57,25,17,5,3,32,61,32,26,5,1,29,24,14,9,5,0,10,323,190,137,47,6,133
S01008941,659,386,289,88,9,273,57,9,6,2,1,48,92,46,30,14,2,46,90,53,39,11,3,37,45,31,27,4,0,14,375,247,187,57,3,128
S01008942,581,379,311,55,13,202,47,19,13,6,0,28,109,60,48,8,4,49,92,65,53,11,1,27,52,32,24,8,0,20,281,203,173,22,8,78
S01008943,672,357,249,88,20,315,51,13,4,7,2,38,91,36,23,9,4,55,82,45,30,9,6,37,60,35,25,9,1,25,388,228,167,54,7,160
S01008944,809,428,312,101,15,381,73,16,9,7,0,57,114,53,38,14,1,61,119,65,47,11,7,54,45,21,16,5,0,24,458,273,202,64,7,185
S01008945,630,402,308,86,8,228,43,17,11,6,0,26,75,34,28,6,0,41,96,63,48,13,2,33,46,32,24,7,1,14,370,256,197,54,5,114
S01008946,769,403,298,82,23,366,89,23,16,5,2,66,123,49,31,12,6,74,99,59,44,8,7,40,56,33,25,6,2,23,402,239,182,51,6,163
S01008947,870,473,369,84,20,397,94,16,8,7,1,78,140,60,45,11,4,80,124,69,54,10,5,55,69,49,38,8,3,20,443,279,224,48,7,164
S01008948,573,388,302,69,17,185,63,17,10,6,1,46,97,66,50,9,7,31,108,68,57,10,1,40,52,46,34,10,2,6,253,191,151,34,6,62
S01008949,752,467,389,47,31,285,234,80,58,13,9,154,223,150,123,15,12,73,92,71,64,4,3,21,64,48,41,7,0,16,139,118,103,8,7,21
S01008950,775,470,388,46,36,305,229,56,37,10,9,173,198,140,111,15,14,58,123,95,86,3,6,28,64,55,47,5,3,9,161,124,107,13,4,37
S01008951,708,427,365,28,34,281,218,56,50,3,3,162,214,146,117,14,15,68,81,59,55,0,4,22,61,51,43,4,4,10,134,115,100,7,8,19
S01008952,663,434,347,37,50,229,199,75,58,9,8,124,209,151,112,14,25,58,86,64,53,3,8,22,52,42,32,6,4,10,117,102,92,5,5,15
S01008953,752,444,351,51,42,308,253,72,55,6,11,181,215,147,119,13,15,68,95,70,50,11,9,25,56,43,35,4,4,13,133,112,92,17,3,21
S01008954,747,397,315,41,41,350,274,62,45,9,8,212,174,103,74,10,19,71,104,76,62,6,8,28,57,50,43,5,2,7,138,106,91,11,4,32
S01008955,527,357,299,51,7,170,59,23,17,6,0,36,111,76,61,12,3,35,106,75,69,5,1,31,58,43,33,10,0,15,193,140,119,18,3,53
S01008956,727,551,473,40,38,176,94,43,34,1,8,51,185,139,111,11,17,46,132,108,91,13,4,24,62,52,47,3,2,10,254,209,190,12,7,45
S01008957,809,509,430,49,30,300,131,46,28,7,11,85,204,119,104,7,8,85,137,98,84,8,6,39,62,49,37,8,4,13,275,197,177,19,1,78
S01008958,605,355,303,32,20,250,150,27,22,2,3,123,148,90,73,9,8,58,92,65,54,7,4,27,46,33,28,5,0,13,169,140,126,9,5,29
S01008959,719,476,414,42,20,243,161,47,41,6,0,114,211,140,111,17,12,71,116,89,81,3,5,27,58,53,50,2,1,5,173,147,131,14,2,26
S01008960,672,545,464,69,12,127,50,27,18,8,1,23,115,84,71,10,3,31,89,64,54,8,2,25,61,51,43,6,2,10,357,319,278,37,4,38
S01008961,601,401,341,39,21,200,72,27,16,7,4,45,128,91,78,9,4,37,118,88,73,9,6,30,63,45,42,1,2,18,220,150,132,13,5,70
S01008962,530,349,302,34,13,181,88,25,20,5,0,63,96,59,45,9,5,37,99,75,67,7,1,24,48,39,34,2,3,9,199,151,136,11,4,48
S01008963,670,404,340,44,20,266,105,34,27,4,3,71,133,79,65,9,5,54,126,86,73,8,5,40,57,45,34,9,2,12,249,160,141,14,5,89
S01008964,437,257,212,35,10,180,59,10,7,3,0,49,85,45,33,8,4,40,74,52,43,6,3,22,42,31,26,4,1,11,177,119,103,14,2,58
S01008965,628,329,260,64,5,299,81,13,11,2,0,68,126,65,48,15,2,61,101,49,39,8,2,52,59,32,25,7,0,27,261,170,137,32,1,91
S01008966,483,303,258,33,12,180,71,19,17,1,1,52,100,64,50,10,4,36,79,54,46,5,3,25,42,28,21,7,0,14,191,138,124,10,4,53
S01008967,848,492,417,62,13,356,107,27,16,11,0,80,158,72,55,13,4,86,130,95,86,8,1,35,76,54,43,8,3,22,377,244,217,22,5,133
S01008968,824,516,438,63,15,308,91,29,20,7,2,62,151,86,63,16,7,65,151,101,88,10,3,50,71,54,47,6,1,17,360,246,220,24,2,114
S01008969,897,557,477,57,23,340,166,51,39,8,4,115,200,122,100,10,12,78,120,92,84,8,0,28,87,58,50,5,3,29,324,234,204,26,4,90
S01008970,838,561,476,73,12,277,74,20,15,3,2,54,117,66,51,12,3,51,125,88,75,11,2,37,64,43,36,6,1,21,458,344,299,41,4,114
S01008971,568,383,318,51,14,185,32,9,7,2,0,23,96,52,43,6,3,44,72,44,38,3,3,28,35,24,18,4,2,11,333,254,212,36,6,79
S01008972,633,381,299,69,13,252,55,6,4,2,0,49,56,27,21,4,2,29,83,46,34,8,4,37,44,28,22,5,1,16,395,274,218,50,6,121
S01008973,727,408,340,59,9,319,167,20,17,3,0,147,110,60,43,15,2,50,75,49,36,9,4,26,59,42,37,5,0,17,316,237,207,27,3,79
S01008974,652,374,317,43,14,278,107,17,11,4,2,90,117,56,46,7,3,61,100,70,60,8,2,30,50,33,26,5,2,17,278,198,174,19,5,80
S01008975,657,293,252,29,12,364,201,19,15,3,1,182,145,64,52,7,5,81,79,43,33,8,2,36,39,29,29,0,0,10,193,138,123,11,4,55
S01008976,426,262,207,40,15,164,45,12,6,5,1,33,80,43,28,9,6,37,68,48,41,4,3,20,34,25,19,4,2,9,199,134,113,18,3,65
S01008977,514,324,276,35,13,190,62,21,15,4,2,41,100,44,35,6,3,56,83,55,49,6,0,28,45,35,31,2,2,10,224,169,146,17,6,55
S01008978,473,330,277,35,18,143,100,39,30,8,1,61,142,100,88,8,4,42,80,69,59,5,5,11,36,27,24,2,1,9,115,95,76,12,7,20
S01008979,573,438,369,45,24,135,70,34,25,6,3,36,165,116,101,7,8,49,101,83,66,9,8,18,46,36,28,8,0,10,191,169,149,15,5,22
S01008980,620,454,388,46,20,166,108,49,40,5,4,59,189,127,103,14,10,62,110,89,81,5,3,21,62,48,45,1,2,14,151,141,119,21,1,10
S01008981,601,332,280,44,8,269,133,34,24,9,1,99,152,72,63,8,1,80,98,73,61,9,3,25,50,27,22,4,1,23,168,126,110,14,2,42
S01008982,629,447,386,37,24,182,128,48,40,6,2,80,209,151,125,11,15,58,103,87,78,6,3,16,44,37,33,2,2,7,145,124,110,12,2,21
S01008983,529,434,384,29,21,95,83,58,46,8,4,25,162,135,123,6,6,27,92,80,68,8,4,12,55,46,44,2,0,9,137,115,103,5,7,22
S01008984,390,279,238,18,23,111,83,27,19,3,5,56,125,93,80,8,5,32,53,40,32,2,6,13,34,33,29,0,4,1,95,86,78,5,3,9
S01008985,585,420,361,34,25,165,115,39,30,6,3,76,209,161,131,16,14,48,86,73,62,7,4,13,57,47,46,0,1,10,118,100,92,5,3,18
S01008986,661,416,348,48,20,245,155,53,39,10,4,102,190,129,108,15,6,61,120,79,71,4,4,41,52,42,35,6,1,10,144,113,95,13,5,31
S01008987,710,441,370,52,19,269,142,41,33,7,1,101,211,136,112,19,5,75,138,93,79,8,6,45,73,57,51,3,3,16,146,114,95,15,4,32
S01008988,928,507,429,49,29,421,247,49,40,6,3,198,210,114,94,9,11,96,120,87,69,15,3,33,73,57,51,2,4,16,278,200,175,17,8,78
S01008989,557,460,394,39,27,97,64,34,27,5,2,30,170,141,117,9,15,29,93,81,69,9,3,12,54,49,44,4,1,5,176,155,137,12,6,21
S01008990,643,535,468,45,22,108,80,52,42,7,3,28,160,127,110,10,7,33,124,115,102,7,6,9,79,70,61,6,3,9,200,171,153,15,3,29
S01008991,758,614,528,62,24,144,93,49,39,6,4,44,199,161,132,23,6,38,145,122,110,7,5,23,82,71,60,7,4,11,239,211,187,19,5,28
S01008992,487,305,257,31,17,182,116,38,31,4,3,78,138,91,75,9,7,47,63,46,42,3,1,17,36,30,23,4,3,6,134,100,86,11,3,34
S01008993,880,597,468,104,25,283,150,46,27,15,4,104,221,156,114,31,11,65,126,88,75,11,2,38,87,72,58,12,2,15,296,235,194,35,6,61
S01008994,628,412,330,50,32,216,217,104,83,12,9,113,184,138,108,15,15,46,64,49,41,5,3,15,40,32,25,6,1,8,123,89,73,12,4,34
S01008995,699,502,424,54,24,197,88,29,19,6,4,59,112,81,62,10,9,31,115,83,73,6,4,32,66,51,48,3,0,15,318,258,222,29,7,60
S01008996,483,303,258,24,21,180,171,75,60,4,11,96,120,84,69,10,5,36,72,56,51,3,2,16,30,19,18,1,0,11,90,69,60,6,3,21
S01008997,780,575,471,75,29,205,167,83,63,12,8,84,185,130,107,12,11,55,112,93,71,14,8,19,70,60,51,9,0,10,246,209,179,28,2,37
S01008998,464,309,246,19,44,155,103,54,39,4,11,49,183,121,93,5,23,62,67,50,40,4,6,17,44,32,26,3,3,12,67,52,48,3,1,15
S01008999,708,395,334,30,31,313,228,70,57,7,6,158,171,107,82,9,16,64,91,61,52,4,5,30,52,42,35,4,3,10,166,115,108,6,1,51
S01009000,757,483,395,71,17,274,140,43,33,8,2,97,154,106,87,13,6,48,140,97,82,12,3,43,74,45,39,5,1,29,249,192,154,33,5,57
S01009001,653,423,356,56,11,230,112,35,27,6,2,77,125,72,63,8,1,53,129,94,77,13,4,35,62,40,37,3,0,22,225,182,152,26,4,43
S01009002,657,451,367,59,25,206,98,30,26,3,1,68,135,89,68,8,13,46,92,71,55,10,6,21,58,50,41,8,1,8,274,211,177,30,4,63
S01009003,751,538,429,88,21,213,96,32,24,6,2,64,112,69,50,13,6,43,97,70,52,13,5,27,49,38,33,4,1,11,397,329,270,52,7,68
S01009004,534,389,332,45,12,145,100,47,38,9,0,53,167,123,107,11,5,44,94,70,61,7,2,24,60,56,50,4,2,4,113,93,76,14,3,20
S01009005,590,404,350,35,19,186,104,41,35,5,1,63,145,101,80,9,12,44,102,77,69,5,3,25,68,56,50,3,3,12,171,129,116,13,0,42
S01009006,602,357,300,33,24,245,141,37,30,4,3,104,182,109,91,7,11,73,87,59,47,5,7,28,51,40,35,5,0,11,141,112,97,12,3,29
S01009007,552,348,293,31,24,204,146,47,39,3,5,99,183,123,99,13,11,60,86,65,58,0,7,21,47,38,34,3,1,9,90,75,63,12,0,15
S01009008,780,469,383,61,25,311,124,35,29,6,0,89,159,100,70,13,17,59,107,71,61,8,2,36,69,44,40,2,2,25,321,219,183,32,4,102
S01009009,381,221,184,18,19,160,120,40,34,3,3,80,115,77,62,3,12,38,35,23,17,4,2,12,41,26,23,1,2,15,70,55,48,7,0,15
S01009010,820,629,562,53,14,191,94,43,33,7,3,51,210,152,135,12,5,58,150,118,110,6,2,32,64,56,48,6,2,8,302,260,236,22,2,42
S01009011,692,571,496,51,24,121,63,27,19,5,3,36,152,123,101,14,8,29,143,122,107,8,7,21,98,87,77,7,3,11,236,212,192,17,3,24
S01009012,609,456,393,50,13,153,67,24,17,7,0,43,135,102,82,12,8,33,98,74,65,7,2,24,70,57,47,8,2,13,239,199,182,16,1,40
S01009013,739,547,456,57,34,192,115,57,51,3,3,58,160,122,102,11,9,38,128,95,75,11,9,33,78,66,54,8,4,12,258,207,174,24,9,51
S01009014,497,333,249,58,26,164,159,70,40,17,13,89,119,100,79,14,7,19,63,52,42,8,2,11,43,34,26,5,3,9,113,77,62,14,1,36
S01009015,511,302,231,49,22,209,165,62,40,16,6,103,100,70,52,7,11,30,70,53,41,10,2,17,41,27,22,4,1,14,135,90,76,12,2,45
S01009016,436,249,188,43,18,187,149,52,36,11,5,97,93,69,47,15,7,24,49,34,29,4,1,15,30,24,17,4,3,6,115,70,59,9,2,45
S01009017,499,308,234,46,28,191,180,81,59,10,12,99,113,79,60,15,4,34,78,58,45,8,5,20,31,26,23,2,1,5,97,64,47,11,6,33
S01009018,601,408,321,70,17,193,204,107,77,24,6,97,130,99,79,15,5,31,73,56,46,9,1,17,36,29,24,3,2,7,158,117,95,19,3,41
S01009019,421,296,244,35,17,125,142,69,47,13,9,73,82,67,58,5,4,15,64,55,50,5,0,9,27,22,19,2,1,5,106,83,70,10,3,23
S01009020,635,487,402,50,35,148,134,68,48,11,9,66,161,126,103,10,13,35,96,83,74,7,2,13,56,51,44,4,3,5,188,159,133,18,8,29
S01009021,634,394,296,82,16,240,179,75,45,26,4,104,136,103,75,22,6,33,80,58,48,9,1,22,48,36,31,4,1,12,191,122,97,21,4,69
S01009022,788,482,363,89,30,306,234,86,48,27,11,148,165,131,107,15,9,34,119,93,69,20,4,26,58,44,39,3,2,14,212,128,100,24,4,84
S01009023,810,456,292,132,32,354,248,74,47,19,8,174,170,118,71,34,13,52,103,79,51,22,6,24,47,32,22,7,3,15,242,153,101,50,2,89
S01009024,844,467,353,86,28,377,326,105,68,28,9,221,159,113,87,14,12,46,108,78,60,11,7,30,56,46,37,9,0,10,195,125,101,24,0,70
S01009025,761,488,348,93,47,273,208,80,51,19,10,128,165,130,82,25,23,35,101,81,64,11,6,20,72,57,45,10,2,15,215,140,106,28,6,75
S01009026,770,465,357,69,39,305,219,72,45,18,9,147,151,112,79,13,20,39,101,72,55,13,4,29,82,63,53,8,2,19,217,146,125,17,4,71
S01009027,670,360,251,88,21,310,209,56,37,12,7,153,110,66,47,18,1,44,92,65,49,14,2,27,45,34,21,10,3,11,214,139,97,34,8,75
S01009028,430,256,189,48,19,174,123,44,27,10,7,79,86,58,40,9,9,28,58,46,36,9,1,12,40,32,27,4,1,8,123,76,59,16,1,47
S01009029,529,315,229,58,28,214,161,53,34,10,9,108,97,61,40,14,7,36,70,55,36,13,6,15,41,33,24,6,3,8,160,113,95,15,3,47
S01009030,611,386,296,62,28,225,213,85,54,22,9,128,122,80,63,12,5,42,71,57,43,9,5,14,58,49,41,4,4,9,147,115,95,15,5,32
S01009031,656,388,316,52,20,268,235,69,52,10,7,166,121,86,73,9,4,35,83,61,47,12,2,22,66,56,47,7,2,10,151,116,97,14,5,35
S01009032,559,303,239,45,19,256,211,54,35,12,7,157,98,72,58,11,3,26,81,59,50,3,6,22,37,26,18,6,2,11,132,92,78,13,1,40
S01009033,657,371,292,59,20,286,225,69,47,15,7,156,144,102,78,16,8,42,74,58,44,11,3,16,60,48,44,4,0,12,154,94,79,13,2,60
S01009034,558,324,274,39,11,234,172,42,32,7,3,130,107,75,65,8,2,32,72,63,51,11,1,9,51,42,36,5,1,9,156,102,90,8,4,54
S01009035,760,490,398,63,29,270,208,60,46,11,3,148,139,112,86,10,16,27,114,92,76,12,4,22,85,71,59,9,3,14,214,155,131,21,3,59
S01009036,814,561,462,63,36,253,186,67,48,11,8,119,180,136,106,16,14,44,124,104,80,17,7,20,103,91,76,12,3,12,221,163,152,7,4,58
S01009037,705,498,407,59,32,207,156,53,45,5,3,103,167,134,104,14,16,33,113,93,71,17,5,20,95,82,68,10,4,13,174,136,119,13,4,38
S01009038,868,583,488,62,33,285,228,82,55,19,8,146,205,157,131,14,12,48,132,105,89,8,8,27,93,82,73,6,3,11,210,157,140,15,2,53
S01009039,535,375,294,37,44,160,172,82,61,8,13,90,115,94,67,10,17,21,84,65,52,6,7,19,55,46,40,4,2,9,109,88,74,9,5,21
S01009040,560,348,284,40,24,212,185,56,45,6,5,129,121,96,77,10,9,25,81,68,50,11,7,13,59,48,45,3,0,11,114,80,67,10,3,34
S01009041,765,469,374,65,30,296,203,64,47,10,7,139,131,93,67,18,8,38,107,86,70,10,6,21,77,56,48,3,5,21,247,170,142,24,4,77
S01009042,724,464,385,41,38,260,223,90,67,13,10,133,167,126,97,14,15,41,97,76,67,3,6,21,78,60,56,1,3,18,159,112,98,10,4,47
S01009043,547,357,296,32,29,190,197,81,60,12,9,116,110,91,77,5,9,19,63,51,43,2,6,12,51,42,38,3,1,9,126,92,78,10,4,34
S01009044,749,385,330,37,18,364,273,62,53,7,2,211,139,93,78,11,4,46,84,64,57,5,2,20,73,54,47,4,3,19,180,112,95,10,7,68
S01009045,556,340,279,44,17,216,147,48,33,14,1,99,119,80,68,5,7,39,88,69,57,6,6,19,64,49,40,7,2,15,138,94,81,12,1,44
S01009046,710,460,377,64,19,250,179,56,43,11,2,123,153,108,87,14,7,45,97,81,68,10,3,16,79,62,49,10,3,17,202,153,130,19,4,49
S01009047,648,433,369,45,19,215,138,38,32,4,2,100,148,113,90,13,10,35,92,75,63,9,3,17,82,67,59,6,2,15,188,140,125,13,2,48
S01009048,686,440,377,42,21,246,180,66,54,9,3,114,118,82,72,5,5,36,97,71,58,7,6,26,70,63,54,6,3,7,221,158,139,15,4,63
S01009049,502,307,260,36,11,195,136,42,35,5,2,94,94,67,53,11,3,27,64,51,45,6,0,13,55,42,34,4,4,13,153,105,93,10,2,48
S01009050,676,427,360,38,29,249,209,62,48,12,2,147,168,129,107,13,9,39,94,77,67,1,9,17,64,54,49,2,3,10,141,105,89,10,6,36
S01009051,564,400,328,42,30,164,158,65,49,6,10,93,177,137,107,17,13,40,95,80,72,4,4,15,56,51,41,8,2,5,78,67,59,7,1,11
S01009052,539,336,285,36,15,203,159,46,36,5,5,113,141,103,82,16,5,38,90,71,60,9,2,19,65,54,48,5,1,11,84,62,59,1,2,22
S01009053,424,251,181,11,59,173,157,50,29,2,19,107,149,109,79,5,25,40,51,38,28,1,9,13,35,30,28,1,1,5,32,24,17,2,5,8
S01009054,480,304,254,16,34,176,166,73,55,6,12,93,154,113,90,8,15,41,59,46,40,1,5,13,34,27,26,0,1,7,67,45,43,1,1,22
S01009055,693,484,378,79,27,209,167,69,40,22,7,98,185,144,111,21,12,41,116,93,80,11,2,23,75,58,43,12,3,17,150,120,104,13,3,30
S01009056,432,259,191,28,40,173,168,61,43,5,13,107,146,108,83,10,15,38,59,45,34,5,6,14,30,23,18,3,2,7,29,22,13,5,4,7
S01009057,461,284,214,23,47,177,161,48,33,3,12,113,133,97,63,13,21,36,64,58,51,2,5,6,47,38,32,1,5,9,56,43,35,4,4,13
S01009058,674,388,336,23,29,286,232,47,34,7,6,185,182,129,109,5,15,53,94,75,69,5,1,19,70,61,54,2,5,9,96,76,70,4,2,20
S01009059,700,508,417,60,31,192,140,39,21,12,6,101,177,134,103,18,13,43,121,102,91,10,1,19,93,81,69,6,6,12,169,152,133,14,5,17
S01009060,411,339,278,51,10,72,57,34,20,12,2,23,108,89,68,18,3,19,70,60,48,9,3,10,63,55,51,3,1,8,113,101,91,9,1,12
S01009061,650,473,409,27,37,177,196,93,78,4,11,103,194,159,135,10,14,35,115,98,87,6,5,17,52,46,41,3,2,6,93,77,68,4,5,16
S01009062,538,319,250,21,48,219,204,74,56,5,13,130,152,103,75,6,22,49,68,58,44,6,8,10,53,43,40,0,3,10,61,41,35,4,2,20
S01009063,614,405,358,33,14,209,136,57,48,4,5,79,174,123,108,11,4,51,108,81,75,3,3,27,62,44,40,3,1,18,134,100,87,12,1,34
S01009064,473,298,258,14,26,175,157,54,46,2,6,103,144,105,86,5,14,39,63,48,40,4,4,15,38,33,32,0,1,5,71,58,54,3,1,13
S01009065,544,324,243,25,56,220,190,57,36,4,17,133,174,124,97,9,18,50,71,54,42,4,8,17,51,43,37,0,6,8,58,46,31,8,7,12
S01009066,594,367,301,24,42,227,207,73,64,3,6,134,183,125,97,11,17,58,68,55,41,4,10,13,59,53,46,3,4,6,77,61,53,3,5,16
S01009067,649,529,445,57,27,120,97,55,41,8,6,42,153,126,105,15,6,27,128,108,93,13,2,20,100,89,71,11,7,11,171,151,135,10,6,20
S01009068,732,497,428,35,34,235,197,85,66,9,10,112,221,170,142,12,16,51,111,89,83,3,3,22,80,64,54,7,3,16,123,89,83,4,2,34
S01009069,525,392,337,44,11,133,83,43,33,9,1,40,121,93,78,11,4,28,88,66,57,7,2,22,77,71,66,4,1,6,156,119,103,13,3,37
S01009070,525,370,310,44,16,155,107,45,37,5,3,62,142,109,87,14,8,33,111,89,73,12,4,22,57,49,43,6,0,8,108,78,70,7,1,30
S01009071,413,277,218,41,18,136,142,57,34,16,7,85,100,77,61,11,5,23,45,38,31,6,1,7,45,36,32,2,2,9,81,69,60,6,3,12
S01009072,413,283,225,39,19,130,109,38,22,11,5,71,124,95,73,14,8,29,55,47,40,5,2,8,43,36,33,3,0,7,82,67,57,6,4,15
S01009073,539,290,232,26,32,249,253,83,60,9,14,170,143,106,85,10,11,37,61,41,36,2,3,20,32,30,24,2,4,2,50,30,27,3,0,20
S01009074,582,380,305,25,50,202,234,106,84,10,12,128,161,126,96,6,24,35,63,51,43,4,4,12,64,55,47,3,5,9,60,42,35,2,5,18
S01009075,453,270,212,31,27,183,179,62,46,6,10,117,112,85,69,7,9,27,59,44,31,10,3,15,38,31,23,5,3,7,65,48,43,3,2,17
S01009076,768,580,487,63,30,188,155,84,64,13,7,71,196,159,130,16,13,37,140,112,97,12,3,28,116,94,83,10,1,22,161,131,113,12,6,30
S01009077,521,346,285,32,29,175,112,41,31,7,3,71,163,117,85,14,18,46,89,70,61,6,3,19,49,41,38,0,3,8,108,77,70,5,2,31
S01009078,571,484,421,40,23,87,52,30,23,5,2,22,139,114,91,11,12,25,103,92,81,7,4,11,73,60,56,3,1,13,204,188,170,14,4,16
S01009079,757,437,344,35,58,320,292,85,60,6,19,207,227,165,129,11,25,62,80,68,56,8,4,12,56,42,38,1,3,14,102,77,61,9,7,25
S01009080,775,455,374,43,38,320,290,111,94,10,7,179,239,150,111,19,20,89,84,70,56,8,6,14,81,63,59,2,2,18,81,61,54,4,3,20
S01009081,565,349,292,40,17,216,181,55,43,10,2,126,131,97,74,15,8,34,92,71,58,6,7,21,56,44,41,3,0,12,105,82,76,6,0,23
S01009082,832,519,411,56,52,313,284,106,79,14,13,178,282,200,146,25,29,82,102,76,64,6,6,26,58,52,47,3,2,6,106,85,75,8,2,21
S01009083,625,406,344,28,34,219,193,74,59,9,6,119,195,145,121,5,19,50,79,64,56,5,3,15,70,56,51,0,5,14,88,67,57,9,1,21
S01009084,385,268,203,52,13,117,110,42,28,10,4,68,99,76,51,19,6,23,55,42,33,8,1,13,33,28,24,3,1,5,88,80,67,12,1,8
S01009085,575,514,459,39,16,61,51,34,27,5,2,17,158,141,121,13,7,17,115,105,97,6,2,10,97,88,77,9,2,9,154,146,137,6,3,8
S01009086,564,382,316,35,31,182,177,67,50,7,10,110,139,103,88,9,6,36,79,69,59,6,4,10,68,59,46,6,7,9,101,84,73,7,4,17
S01009087,474,300,254,20,26,174,159,60,50,3,7,99,163,120,98,11,11,43,57,46,40,3,3,11,48,38,35,1,2,10,47,36,31,2,3,11
S01009088,838,546,446,76,24,292,164,61,41,15,5,103,225,154,118,24,12,71,141,106,85,17,4,35,82,63,56,5,2,19,226,162,146,15,1,64
S01009089,692,544,469,61,14,148,58,22,15,6,1,36,157,120,97,20,3,37,120,97,82,11,4,23,84,66,61,5,0,18,273,239,214,19,6,34
S01009090,643,539,481,51,7,104,56,10,7,3,0,46,115,87,64,19,4,28,97,84,76,8,0,13,89,85,81,3,1,4,286,273,253,18,2,13
S01009091,476,402,352,36,14,74,25,13,10,2,1,12,94,70,58,8,4,24,79,68,61,3,4,11,68,63,51,7,5,5,210,188,172,16,0,22
S01009092,872,537,462,38,37,335,209,66,52,3,11,143,219,136,114,8,14,83,122,93,81,8,4,29,84,68,60,4,4,16,238,174,155,15,4,64
S01009093,600,417,339,36,42,183,135,46,33,8,5,89,205,157,122,16,19,48,89,75,60,7,8,14,61,51,47,2,2,10,110,88,77,3,8,22
S01009094,576,302,272,23,7,274,67,16,13,1,2,51,112,51,44,5,2,61,97,61,54,4,3,36,61,40,34,6,0,21,239,134,127,7,0,105
S01009095,664,414,332,63,19,250,162,48,40,4,4,114,134,88,65,18,5,46,103,75,60,11,4,28,73,58,50,5,3,15,192,145,117,25,3,47
S01009096,779,549,467,62,20,230,149,33,22,7,4,116,149,101,79,14,8,48,132,111,99,7,5,21,86,73,63,7,3,13,263,231,204,27,0,32
S01009097,699,515,466,32,17,184,92,32,23,7,2,60,161,111,94,9,8,50,135,102,94,5,3,33,86,73,70,2,1,13,225,197,185,9,3,28
S01009098,426,263,213,34,16,163,67,19,11,5,3,48,69,41,33,5,3,28,83,54,47,4,3,29,43,32,27,3,2,11,164,117,95,17,5,47
S01009099,662,384,339,25,20,278,202,50,41,7,2,152,163,114,100,4,10,49,96,73,62,8,3,23,64,50,43,4,3,14,137,97,93,2,2,40
S01009100,651,336,286,30,20,315,260,61,47,9,5,199,163,107,86,11,10,56,73,58,50,5,3,15,60,50,49,0,1,10,95,60,54,5,1,35
S01009101,763,507,416,36,55,256,272,123,96,9,18,149,268,203,166,15,22,65,82,69,58,2,9,13,61,46,40,3,3,15,80,66,56,7,3,14
S01009102,600,407,321,22,64,193,205,114,84,11,19,91,229,157,125,4,28,72,60,52,43,2,7,8,42,35,27,3,5,7,64,49,42,2,5,15
S01009103,487,291,258,16,17,196,95,30,24,2,4,65,134,79,70,4,5,55,97,66,63,1,2,31,50,35,31,4,0,15,111,81,70,5,6,30
S01009104,650,408,353,28,27,242,164,64,54,4,6,100,218,142,118,10,14,76,92,69,63,2,4,23,61,49,40,7,2,12,115,84,78,5,1,31
S01009105,639,439,380,39,20,200,128,41,25,12,4,87,182,122,102,10,10,60,88,74,69,3,2,14,83,70,64,3,3,13,158,132,120,11,1,26
S01009106,457,298,253,23,22,159,138,47,40,2,5,91,109,90,75,7,8,19,66,53,46,4,3,13,44,32,25,4,3,12,100,76,67,6,3,24
S01009107,672,494,438,25,31,178,115,55,45,3,7,60,181,144,127,5,12,37,112,88,79,2,7,24,87,65,59,5,1,22,177,142,128,10,4,35
S01009108,612,404,355,33,16,208,110,36,33,2,1,74,154,112,90,14,8,42,89,64,59,3,2,25,87,70,59,8,3,17,172,122,114,6,2,50
S01009109,569,393,348,30,15,176,100,32,22,9,1,68,147,101,92,4,5,46,90,72,64,3,5,18,64,53,48,4,1,11,168,135,122,10,3,33
S01009110,499,301,269,21,11,198,124,36,31,4,1,88,157,98,88,4,6,59,56,45,40,5,0,11,44,31,27,2,2,13,118,91,83,6,2,27
S01009111,698,537,467,44,26,161,96,37,27,7,3,59,230,178,151,18,9,52,115,92,78,5,9,23,95,91,84,6,1,4,162,139,127,8,4,23
S01009112,470,279,240,33,6,191,76,23,12,11,0,53,109,69,62,4,3,40,66,50,42,6,2,16,61,42,39,3,0,19,158,95,85,9,1,63
S01009113,790,481,421,44,16,309,203,40,32,7,1,163,197,138,122,12,4,59,129,97,88,6,3,32,88,75,68,6,1,13,173,131,111,13,7,42
S01009114,615,481,412,36,33,134,129,67,51,8,8,62,178,149,121,14,14,29,123,101,92,3,6,22,73,64,60,3,1,9,112,100,88,8,4,12
S01009115,474,356,310,30,16,118,74,35,30,4,1,39,133,96,77,10,9,37,81,66,62,2,2,15,68,57,52,4,1,11,118,102,89,10,3,16
S01009116,405,281,248,17,16,124,71,31,26,4,1,40,97,73,60,8,5,24,88,71,63,0,8,17,51,40,39,0,1,11,98,66,60,5,1,32
S01009117,671,490,417,37,36,181,176,80,62,9,9,96,217,164,132,13,19,53,100,89,77,6,6,11,69,60,54,6,0,9,109,97,92,3,2,12
S01009118,471,387,349,27,11,84,61,27,22,2,3,34,118,93,82,8,3,25,100,87,79,7,1,13,81,74,69,2,3,7,111,106,97,8,1,5
S01009119,600,374,306,30,38,226,244,99,76,8,15,145,185,137,106,12,19,48,61,46,42,3,1,15,55,49,46,2,1,6,55,43,36,5,2,12
S01009120,444,287,243,17,27,157,162,72,58,6,8,90,119,83,66,5,12,36,68,56,50,2,4,12,43,36,32,2,2,7,52,40,37,2,1,12
S01009121,690,450,387,34,29,240,231,94,81,8,5,137,228,161,139,12,10,67,107,91,75,6,10,16,63,57,51,4,2,6,61,47,41,4,2,14
S01009122,778,511,383,80,48,267,219,94,70,16,8,125,202,143,103,22,18,59,117,88,71,6,11,29,92,72,55,12,5,20,148,114,84,24,6,34
S01009123,446,329,265,39,25,117,72,33,21,7,5,39,125,88,65,10,13,37,61,51,42,3,6,10,46,36,33,2,1,10,142,121,104,17,0,21
S01009124,407,306,259,36,11,101,90,39,34,5,0,51,133,110,92,12,6,23,58,49,44,4,1,9,52,48,42,5,1,4,74,60,47,10,3,14
S01009125,608,328,279,20,29,280,285,102,83,6,13,183,131,87,70,8,9,44,54,45,39,3,3,9,38,27,24,0,3,11,100,67,63,3,1,33
S01009126,461,290,210,18,62,171,164,66,47,3,16,98,169,123,80,9,34,46,51,39,31,2,6,12,40,34,29,4,1,6,37,28,23,0,5,9
S01009127,463,305,232,17,56,158,143,82,49,5,28,61,158,100,80,5,15,58,59,46,39,0,7,13,48,38,31,2,5,10,55,39,33,5,1,16
S01009128,687,373,288,24,61,314,299,88,58,4,26,211,200,141,111,10,20,59,62,49,36,4,9,13,63,49,40,5,4,14,63,46,43,1,2,17
S01009129,386,246,204,7,35,140,146,65,53,0,12,81,111,78,68,3,7,33,46,36,27,2,7,10,30,25,22,1,2,5,53,42,34,1,7,11
S01009130,504,357,291,28,38,147,133,57,47,4,6,76,154,113,82,9,22,41,74,58,52,1,5,16,54,50,42,6,2,4,89,79,68,8,3,10
S01009131,413,264,221,16,27,149,145,56,41,2,13,89,127,94,82,5,7,33,48,41,33,3,5,7,36,31,28,3,0,5,57,42,37,3,2,15
S01009132,633,493,435,32,26,140,96,45,32,6,7,51,170,124,112,4,8,46,113,100,87,9,4,13,81,79,70,4,5,2,173,145,134,9,2,28
S01009133,480,306,255,22,29,174,155,63,55,3,5,92,157,111,90,7,14,46,64,48,36,6,6,16,43,36,34,0,2,7,61,48,40,6,2,13
S01009134,764,506,438,38,30,258,160,50,43,3,4,110,221,156,127,17,12,65,107,83,74,5,4,24,91,75,68,4,3,16,185,142,126,9,7,43
S01009135,447,373,319,28,26,74,58,32,19,6,7,26,107,87,75,4,8,20,73,65,54,6,5,8,72,67,59,5,3,5,137,122,112,7,3,15
S01009136,620,416,348,42,26,204,150,32,21,6,5,118,139,102,78,13,11,37,95,82,67,9,6,13,77,67,59,6,2,10,159,133,123,8,2,26
S01009137,437,395,340,46,9,42,31,20,16,4,0,11,87,77,61,11,5,10,81,70,64,4,2,11,73,69,62,5,2,4,165,159,137,22,0,6
S01009138,712,516,428,60,28,196,110,43,28,10,5,67,179,122,100,16,6,57,110,88,66,12,10,22,84,68,60,7,1,16,229,195,174,15,6,34
S01009139,350,254,197,17,40,96,93,42,25,0,17,51,99,75,50,9,16,24,38,34,30,2,2,4,55,51,45,1,5,4,65,52,47,5,0,13
S01009140,616,398,340,26,32,218,172,55,45,3,7,117,144,96,80,3,13,48,105,84,69,11,4,21,70,57,50,3,4,13,125,106,96,6,4,19
S01009141,719,434,351,33,50,285,234,62,44,5,13,172,184,129,102,8,19,55,96,72,58,3,11,24,79,65,54,9,2,14,126,106,93,8,5,20
S01009142,548,340,274,22,44,208,166,71,58,5,8,95,155,104,83,7,14,51,81,62,48,4,10,19,47,31,24,1,6,16,99,72,61,5,6,27
S01009143,501,275,224,20,31,226,200,47,36,5,6,153,147,104,80,8,16,43,59,49,42,2,5,10,48,41,35,3,3,7,47,34,31,2,1,13
S01009144,542,470,415,36,19,72,62,37,30,5,2,25,146,119,95,14,10,27,100,90,80,7,3,10,66,61,57,3,1,5,168,163,153,7,3,5
S01009145,883,494,427,32,35,389,332,87,75,5,7,245,247,156,127,16,13,91,123,99,83,6,10,24,89,72,66,2,4,17,92,80,76,3,1,12
S01009146,758,507,414,34,59,251,253,103,78,10,15,150,235,174,136,12,26,61,79,63,53,2,8,16,87,79,68,4,7,8,104,88,79,6,3,16
S01009147,648,379,310,22,47,269,250,88,68,6,14,162,197,135,107,9,19,62,67,55,48,2,5,12,57,47,39,3,5,10,77,54,48,2,4,23
S01009148,549,347,300,13,34,202,203,90,74,6,10,113,188,135,117,1,17,53,65,49,45,0,4,16,48,36,31,2,3,12,45,37,33,4,0,8
S01009149,682,439,365,49,25,243,133,35,25,5,5,98,172,124,98,21,5,48,105,81,68,7,6,24,89,65,55,5,5,24,183,134,119,11,4,49
S01009150,745,102,82,13,7,643,483,41,32,4,5,442,148,28,21,5,2,120,30,11,10,1,0,19,29,6,5,1,0,23,55,16,14,2,0,39
S01009151,766,372,302,42,28,394,261,36,27,8,1,225,166,93,68,7,18,73,82,54,47,3,4,28,60,41,37,3,1,19,197,148,123,21,4,49
S01009152,625,325,270,26,29,300,216,37,30,3,4,179,150,97,75,9,13,53,77,51,48,0,3,26,59,44,37,5,2,15,123,96,80,9,7,27
S01009153,420,298,232,46,20,122,66,21,13,4,4,45,81,67,58,5,4,14,65,44,34,5,5,21,58,53,45,6,2,5,150,113,82,26,5,37
S01009154,852,480,384,77,19,372,171,26,13,12,1,145,172,96,75,13,8,76,111,72,62,8,2,39,102,76,61,12,3,26,296,210,173,32,5,86
S01009155,450,278,234,26,18,172,49,8,5,1,2,41,82,52,41,5,6,30,59,36,31,1,4,23,62,46,40,4,2,16,198,136,117,15,4,62
S01009156,461,276,226,34,16,185,60,15,6,5,4,45,79,42,33,4,5,37,77,55,45,7,3,22,28,17,14,3,0,11,217,147,128,15,4,70
S01009157,684,431,366,36,29,253,195,62,54,6,2,133,202,132,106,12,14,70,101,86,72,7,7,15,57,48,41,3,4,9,129,103,93,8,2,26
S01009158,465,287,249,16,22,178,150,40,33,1,6,110,131,97,83,5,9,34,59,50,42,4,4,9,40,33,30,2,1,7,85,67,61,4,2,18
S01009159,399,230,179,16,35,169,165,67,47,8,12,98,124,82,61,5,16,42,46,32,28,0,4,14,37,29,26,0,3,8,27,20,17,3,0,7
S01009160,583,344,279,24,41,239,223,71,54,3,14,152,162,118,96,9,13,44,69,50,44,1,5,19,50,42,35,4,3,8,79,63,50,7,6,16
S01009161,543,306,235,13,58,237,237,78,56,1,21,159,158,107,81,5,21,51,46,39,30,1,8,7,48,35,31,1,3,13,54,47,37,5,5,7
S01009162,643,376,321,15,40,267,240,66,52,3,11,174,203,151,126,6,19,52,65,55,46,3,6,10,54,42,40,1,1,12,81,62,57,2,3,19
S01009163,440,258,208,18,32,182,123,26,19,2,5,97,95,65,48,2,15,30,59,45,39,4,2,14,64,55,42,5,8,9,99,67,60,5,2,32
S01009164,598,392,327,19,46,206,200,75,64,4,7,125,196,143,111,6,26,53,76,67,56,3,8,9,57,52,46,4,2,5,69,55,50,2,3,14
S01009165,591,364,285,15,64,227,206,79,52,5,22,127,181,133,101,5,27,48,71,52,46,2,4,19,58,44,39,1,4,14,75,56,47,2,7,19
S01009166,673,406,325,16,65,267,254,97,76,4,17,157,222,152,110,7,35,70,68,57,52,0,5,11,67,52,44,3,5,15,62,48,43,2,3,14
S01009167,410,273,217,22,34,137,140,67,50,9,8,73,151,112,83,9,20,39,43,35,32,1,2,8,38,29,25,1,3,9,38,30,27,2,1,8
S01009168,562,333,291,28,14,229,114,36,29,5,2,78,126,77,63,8,6,49,91,68,58,7,3,23,68,49,46,1,2,19,163,103,95,7,1,60
S01009169,689,278,234,22,22,411,288,38,29,3,6,250,178,93,75,10,8,85,77,54,49,3,2,23,52,33,29,1,3,19,94,60,52,5,3,34
S01009170,529,362,289,34,39,167,164,71,51,8,12,93,198,156,125,15,16,42,61,51,41,2,8,10,40,31,28,2,1,9,66,53,44,7,2,13
S01009171,529,387,306,29,52,142,147,81,60,5,16,66,177,132,109,5,18,45,64,59,49,4,6,5,52,43,29,6,8,9,89,72,59,9,4,17
S01009172,556,364,293,55,16,192,50,19,12,6,1,31,71,33,24,7,2,38,87,58,44,9,5,29,47,32,29,3,0,15,301,222,184,30,8,79
S01009173,626,438,386,44,8,188,71,29,24,4,1,42,155,98,83,11,4,57,116,89,78,10,1,27,66,53,49,4,0,13,218,169,152,15,2,49
S01009174,346,305,252,39,14,41,16,11,9,1,1,5,79,65,50,9,6,14,47,39,25,11,3,8,51,49,42,6,1,2,153,141,126,12,3,12
S01009175,637,531,469,46,16,106,38,21,18,2,1,17,112,87,70,12,5,25,111,88,78,8,2,23,90,74,67,4,3,16,286,261,236,20,5,25
S01009176,801,499,410,70,19,302,115,33,23,8,2,82,125,69,55,11,3,56,126,90,70,17,3,36,84,56,49,5,2,28,351,251,213,29,9,100
S01009177,648,449,343,44,62,199,178,80,55,8,17,98,215,167,121,17,29,48,93,70,57,6,7,23,72,55,48,5,2,17,90,77,62,8,7,13
S01009178,568,390,305,26,59,178,124,53,37,3,13,71,201,143,100,8,35,58,82,67,55,7,5,15,65,54,51,3,0,11,96,73,62,5,6,23
S01009179,539,374,306,20,48,165,154,80,64,4,12,74,173,125,94,8,23,48,84,69,59,2,8,15,55,46,40,4,2,9,73,54,49,2,3,19
S01009180,805,512,430,39,43,293,291,116,95,11,10,175,268,191,158,12,21,77,91,68,58,7,3,23,73,62,52,3,7,11,82,75,67,6,2,7
S01009181,691,452,360,49,43,239,249,104,76,12,16,145,239,181,142,21,18,58,74,65,58,5,2,9,48,42,32,6,4,6,81,60,52,5,3,21
S01009182,808,581,472,66,43,227,174,64,43,15,6,110,242,185,137,22,26,57,135,114,100,9,5,21,95,82,75,4,3,13,162,136,117,16,3,26
S01009183,598,480,424,35,21,118,56,26,17,3,6,30,169,128,107,17,4,41,109,100,93,4,3,9,94,82,75,3,4,12,170,144,132,8,4,26
S01009184,693,420,286,74,60,273,255,100,60,22,18,155,197,138,91,23,24,59,73,56,37,10,9,17,50,35,29,2,4,15,118,91,69,17,5,27
S01009185,696,447,336,64,47,249,228,98,68,17,13,130,211,146,110,15,21,65,95,70,56,9,5,25,59,49,39,6,4,10,103,84,63,17,4,19
S01009186,656,434,338,51,45,222,179,75,48,16,11,104,190,124,100,9,15,66,96,76,64,9,3,20,90,71,55,5,11,19,101,88,71,12,5,13
S01009187,418,264,191,62,11,154,79,26,11,13,2,53,88,52,37,11,4,36,58,46,32,13,1,12,40,33,27,5,1,7,153,107,84,20,3,46
S01009188,713,469,363,71,35,244,208,75,56,11,8,133,215,154,121,22,11,61,101,82,64,11,7,19,50,43,35,5,3,7,139,115,87,22,6,24
S01009189,610,381,304,27,50,229,241,103,88,4,11,138,224,170,130,12,28,54,60,43,30,7,6,17,33,23,20,1,2,10,52,42,36,3,3,10
S01009190,639,492,406,72,14,147,86,31,24,4,3,55,165,125,103,17,5,40,118,104,82,20,2,14,93,77,63,11,3,16,177,155,134,20,1,22
S01009191,499,428,372,43,13,71,23,14,11,3,0,9,118,95,76,12,7,23,98,78,70,7,1,20,62,55,52,3,0,7,198,186,163,18,5,12
S01009192,994,392,316,42,34,602,330,61,46,5,10,269,376,117,86,16,15,259,103,79,67,8,4,24,55,42,37,4,1,13,130,93,80,9,4,37
S01009193,240,208,189,11,8,32,20,12,10,2,0,8,54,41,36,3,2,13,55,49,43,4,2,6,41,40,37,0,3,1,70,66,63,2,1,4
S01009194,673,440,372,53,15,233,93,32,26,5,1,61,166,108,80,20,8,58,101,77,69,5,3,24,90,61,49,10,2,29,223,162,148,13,1,61
S01009195,679,514,450,48,16,165,84,23,15,7,1,61,132,96,79,10,7,36,122,96,90,5,1,26,74,69,56,9,4,5,267,230,210,17,3,37
S01009196,584,361,288,43,30,223,154,50,37,10,3,104,181,120,95,11,14,61,77,62,46,8,8,15,49,33,26,4,3,16,123,96,84,10,2,27
S01009197,794,575,489,58,28,219,95,33,24,6,3,62,164,103,76,18,9,61,126,92,82,6,4,34,104,86,77,5,4,18,305,261,230,23,8,44
S01009198,612,411,340,49,22,201,107,38,26,10,2,69,122,84,64,12,8,38,122,91,82,5,4,31,71,56,46,6,4,15,190,142,122,16,4,48
S01009199,486,345,292,37,16,141,86,29,21,4,4,57,121,81,63,15,3,40,77,64,59,2,3,13,66,53,42,7,4,13,136,118,107,9,2,18
S01009200,892,579,508,44,27,313,163,51,39,7,5,112,193,115,97,8,10,78,132,96,81,7,8,36,106,84,74,8,2,22,298,233,217,14,2,65
S01009201,513,366,292,32,42,147,120,56,39,6,11,64,161,129,98,12,19,32,93,76,66,4,6,17,58,42,38,2,2,16,81,63,51,8,4,18
S01009202,402,299,251,34,14,103,43,15,10,5,0,28,114,85,68,11,6,29,69,56,46,7,3,13,46,36,33,2,1,10,130,107,94,9,4,23
S01009203,485,256,197,28,31,229,214,61,39,9,13,153,142,101,79,10,12,41,42,29,24,3,2,13,39,29,23,3,3,10,48,36,32,3,1,12
S01009204,685,484,391,44,49,201,185,96,74,9,13,89,185,130,95,12,23,55,114,92,73,11,8,22,85,73,63,6,4,12,116,93,86,6,1,23
S01009205,610,474,411,42,21,136,76,34,29,4,1,42,153,120,102,13,5,33,137,110,95,10,5,27,87,74,61,7,6,13,157,136,124,8,4,21
S01009206,689,518,460,32,26,171,91,39,28,4,7,52,153,107,94,6,7,46,125,108,98,4,6,17,95,82,72,8,2,13,225,182,168,10,4,43
S01009207,686,410,363,27,20,276,101,32,23,8,1,69,166,103,93,4,6,63,101,72,66,1,5,29,101,70,62,5,3,31,217,133,119,9,5,84
S01009208,540,298,262,21,15,242,126,25,20,3,2,101,124,74,66,4,4,50,82,61,54,4,3,21,65,49,45,3,1,16,143,89,77,7,5,54
S01009209,593,305,260,30,15,288,157,31,27,2,2,126,122,68,54,8,6,54,77,50,40,7,3,27,52,39,37,1,1,13,185,117,102,12,3,68
S01009210,472,315,255,46,14,157,87,26,21,3,2,61,116,79,64,10,5,37,70,54,42,11,1,16,57,46,36,7,3,11,142,110,92,15,3,32
S01009211,502,338,282,30,26,164,117,54,39,9,6,63,137,95,80,5,10,42,83,65,54,7,4,18,63,49,41,3,5,14,102,75,68,6,1,27
S01009212,683,389,329,30,30,294,255,87,72,8,7,168,210,142,120,9,13,68,87,64,53,5,6,23,62,52,46,4,2,10,69,44,38,4,2,25
S01009213,746,451,375,36,40,295,264,85,63,14,8,179,226,156,131,7,18,70,100,83,70,7,6,17,57,46,43,2,1,11,99,81,68,6,7,18
S01009214,825,553,478,42,33,272,164,44,37,4,3,120,214,139,113,11,15,75,136,115,98,7,10,21,94,83,76,6,1,11,217,172,154,14,4,45
S01009215,761,477,393,39,45,284,213,72,51,6,15,141,252,174,142,14,18,78,118,96,81,8,7,22,71,54,48,3,3,17,107,81,71,8,2,26
S01009216,755,485,411,38,36,270,251,98,85,8,5,153,248,183,143,15,25,65,113,90,83,4,3,23,51,41,35,4,2,10,92,73,65,7,1,19
S01009217,488,301,228,25,48,187,201,87,63,7,17,114,158,111,77,10,24,47,42,38,34,2,2,4,37,27,21,3,3,10,50,38,33,3,2,12
S01009218,717,405,339,36,30,312,200,53,44,6,3,147,208,136,109,17,10,72,101,75,63,5,7,26,67,58,51,3,4,9,141,83,72,5,6,58
S01009219,548,329,267,21,41,219,199,59,44,3,12,140,187,137,106,11,20,50,57,46,38,4,4,11,48,39,34,1,4,9,57,48,45,2,1,9
S01009220,446,252,206,16,30,194,159,56,44,5,7,103,140,88,69,4,15,52,54,40,37,1,2,14,35,28,21,2,5,7,58,40,35,4,1,18
S01009221,460,288,243,16,29,172,179,72,62,5,5,107,132,93,72,2,19,39,58,47,40,4,3,11,47,37,33,3,1,10,44,39,36,2,1,5
S01009222,414,264,218,18,28,150,149,53,43,1,9,96,132,106,89,8,9,26,57,45,35,3,7,12,33,25,21,3,1,8,43,35,30,3,2,8
S01009223,463,278,244,17,17,185,178,62,54,6,2,116,128,91,77,9,5,37,59,46,40,1,5,13,46,38,35,0,3,8,52,41,38,1,2,11
S01009224,519,324,265,19,40,195,192,72,57,6,9,120,181,128,101,5,22,53,69,61,49,7,5,8,39,34,30,1,3,5,38,29,28,0,1,9
S01009225,458,278,244,15,19,180,174,61,52,5,4,113,136,98,88,5,5,38,57,43,36,3,4,14,46,37,35,1,1,9,45,39,33,1,5,6
S01009226,796,447,381,22,44,349,328,90,72,5,13,238,228,161,134,11,16,67,99,80,70,4,6,19,61,51,46,2,3,10,80,65,59,0,6,15
S01009227,529,280,242,18,20,249,195,40,32,4,4,155,151,102,90,6,6,49,76,56,45,5,6,20,44,37,33,1,3,7,63,45,42,2,1,18
S01009228,499,286,218,21,47,213,196,76,56,4,16,120,147,99,69,9,21,48,71,46,40,2,4,25,46,36,30,3,3,10,39,29,23,3,3,10
S01009229,486,299,246,30,23,187,152,49,33,8,8,103,120,85,67,9,9,35,80,65,54,7,4,15,64,45,41,2,2,19,70,55,51,4,0,15
S01009230,491,365,322,28,15,126,113,43,33,6,4,70,127,97,83,9,5,30,88,76,66,6,4,12,85,80,75,4,1,5,78,69,65,3,1,9
S01009231,810,535,439,55,41,275,206,69,50,10,9,137,221,158,121,18,19,63,134,113,93,13,7,21,102,85,72,8,5,17,147,110,103,6,1,37
S01009232,466,289,218,4,67,177,152,58,44,2,12,94,183,130,92,0,38,53,47,33,25,1,7,14,46,40,31,0,9,6,38,28,26,1,1,10
S01009233,488,267,215,17,35,221,202,72,51,5,16,130,135,84,70,3,11,51,57,45,38,3,4,12,39,26,23,0,3,13,55,40,33,6,1,15
S01009234,781,491,377,19,95,290,275,118,78,4,36,157,274,183,136,5,42,91,82,67,55,2,10,15,72,61,52,4,5,11,78,62,56,4,2,16
S01009235,759,509,399,25,85,250,231,105,75,1,29,126,272,203,157,9,37,69,74,60,53,2,5,14,83,66,58,2,6,17,99,75,56,11,8,24
S01009236,419,230,197,18,15,189,103,26,19,3,4,77,125,73,59,9,5,52,54,40,33,3,4,14,56,44,43,1,0,12,81,47,43,2,2,34
S01009237,750,463,395,46,22,287,128,26,20,4,2,102,190,116,96,12,8,74,135,103,81,14,8,32,108,83,79,3,1,25,189,135,119,13,3,54
S01009238,630,354,301,8,45,276,214,69,56,3,10,145,216,138,115,3,20,78,85,66,57,1,8,19,49,35,33,1,1,14,66,46,40,0,6,20
S01009239,702,475,423,19,33,227,197,80,74,2,4,117,228,170,150,6,14,58,116,87,68,8,11,29,71,59,57,1,1,12,90,79,74,2,3,11
S01009240,541,350,241,14,95,191,180,77,52,4,21,103,199,149,89,5,55,50,64,54,44,3,7,10,47,33,31,0,2,14,51,37,25,2,10,14
S01009241,721,434,332,24,78,287,259,104,74,9,21,155,242,164,119,6,39,78,92,69,54,3,12,23,51,39,33,3,3,12,77,58,52,3,3,19
S01009242,633,407,340,29,38,226,146,53,43,3,7,93,194,135,109,8,18,59,118,91,74,9,8,27,77,58,51,3,4,19,98,70,63,6,1,28
S01009243,770,541,461,42,38,229,228,105,81,10,14,123,249,194,169,14,11,55,132,111,99,5,7,21,59,50,42,6,2,9,102,81,70,7,4,21
S01009244,694,434,378,43,13,260,152,51,40,11,0,101,167,108,93,9,6,59,117,85,77,6,2,32,94,73,63,7,3,21,164,117,105,10,2,47
S01009245,711,467,398,37,32,244,164,50,43,5,2,114,195,136,111,10,15,59,117,89,78,9,2,28,89,77,64,4,9,12,146,115,102,9,4,31
S01009246,687,422,353,32,37,265,281,111,95,8,8,170,195,132,101,10,21,63,77,67,57,6,4,10,61,49,45,3,1,12,73,63,55,5,3,10
S01009247,822,570,495,24,51,252,284,125,105,4,16,159,266,210,176,10,24,56,100,89,83,4,2,11,70,60,57,1,2,10,102,86,74,5,7,16
S01009248,589,355,300,36,19,234,168,51,43,4,4,117,153,116,94,10,12,37,96,66,56,10,0,30,54,40,34,6,0,14,118,82,73,6,3,36
S01009249,655,415,333,46,36,240,249,107,82,11,14,142,199,146,111,17,18,53,66,52,46,5,1,14,52,40,38,2,0,12,89,70,56,11,3,19
S01009250,523,327,278,28,21,196,198,72,61,9,2,126,152,119,100,6,13,33,64,52,49,1,2,12,51,37,29,6,2,14,58,47,39,6,2,11
S01009251,462,294,238,26,30,168,144,60,52,3,5,84,142,98,71,11,16,44,54,44,35,4,5,10,45,33,29,3,1,12,77,59,51,5,3,18
S01009252,359,293,259,24,10,66,48,21,15,4,2,27,86,75,64,5,6,11,78,67,60,5,2,11,45,38,34,4,0,7,102,92,86,6,0,10
S01009253,399,188,154,17,17,211,199,45,38,5,2,154,105,71,57,4,10,34,36,25,22,1,2,11,28,26,21,3,2,2,31,21,16,4,1,10
S01009254,656,373,296,20,57,283,278,96,75,5,16,182,188,133,102,7,24,55,63,44,39,0,5,19,42,36,30,0,6,6,85,64,50,8,6,21
S01009255,549,406,334,26,46,143,166,76,61,1,14,90,125,105,83,7,15,20,65,56,46,6,4,9,57,49,40,6,3,8,136,120,104,6,10,16
S01009256,412,230,201,18,11,182,127,38,30,5,3,89,81,51,39,6,6,30,57,38,35,2,1,19,50,36,34,1,1,14,97,67,63,4,0,30
S01009257,598,371,296,47,28,227,166,58,43,12,3,108,146,104,72,13,19,42,81,55,48,6,1,26,71,58,48,9,1,13,134,96,85,7,4,38
S01009258,540,344,256,69,19,196,134,44,30,9,5,90,103,68,55,9,4,35,55,42,30,10,2,13,61,50,34,12,4,11,187,140,107,29,4,47
S01009259,763,524,443,61,20,239,183,60,45,11,4,123,153,112,86,19,7,41,118,97,86,7,4,21,82,66,58,6,2,16,227,189,168,18,3,38
S01009260,965,690,588,58,44,275,263,117,99,5,13,146,269,208,169,22,17,61,139,117,104,6,7,22,84,75,64,10,1,9,210,173,152,15,6,37
S01009261,626,349,288,29,32,277,243,73,62,2,9,170,160,104,82,9,13,56,70,51,40,3,8,19,39,31,27,3,1,8,114,90,77,12,1,24
S01009262,459,262,218,14,30,197,200,73,61,5,7,127,129,91,73,4,14,38,54,40,31,1,8,14,34,29,28,1,0,5,42,29,25,3,1,13
S01009263,649,534,460,53,21,115,72,29,22,6,1,43,138,108,87,11,10,30,97,90,79,6,5,7,88,79,71,7,1,9,254,228,201,23,4,26
S01009264,465,277,224,40,13,188,106,39,28,9,2,67,120,72,56,9,7,48,71,50,40,7,3,21,58,46,42,4,0,12,110,70,58,11,1,40
S01009265,671,427,353,25,49,244,208,72,53,3,16,136,168,126,102,6,18,42,108,83,70,3,10,25,66,58,51,4,3,8,121,88,77,9,2,33
S01009266,710,405,331,33,41,305,257,78,65,6,7,179,177,118,92,9,17,59,84,60,44,7,9,24,86,70,63,5,2,16,106,79,67,6,6,27
S01009267,715,426,353,37,36,289,210,68,48,8,12,142,165,119,98,11,10,46,98,74,62,5,7,24,70,50,42,5,3,20,172,115,103,8,4,57
S01009268,774,505,418,46,41,269,230,76,55,16,5,154,224,182,148,13,21,42,106,82,69,6,7,24,77,60,52,3,5,17,137,105,94,8,3,32
S01009269,671,433,337,18,78,238,273,119,86,2,31,154,212,163,123,9,31,49,70,56,47,2,7,14,59,50,42,3,5,9,57,45,39,2,4,12
S01009270,501,280,213,28,39,221,225,73,52,8,13,152,142,108,86,5,17,34,52,45,33,8,4,7,35,23,19,1,3,12,47,31,23,6,2,16
S01009271,744,532,443,50,39,212,147,63,50,9,4,84,185,137,108,15,14,48,129,110,90,10,10,19,95,76,68,4,4,19,188,146,127,12,7,42
S01009272,552,375,293,25,57,177,211,111,83,9,19,100,175,133,109,4,20,42,59,46,34,4,8,13,49,41,33,3,5,8,58,44,34,5,5,14
S01009273,416,252,202,31,19,164,62,17,16,0,1,45,80,44,27,11,6,36,67,50,40,5,5,17,48,35,29,3,3,13,159,106,90,12,4,53
S01009274,514,303,246,31,26,211,129,44,37,3,4,85,119,83,65,10,8,36,72,47,35,4,8,25,51,37,26,5,6,14,143,92,83,9,0,51
S01009275,563,326,239,68,19,237,163,46,33,12,1,117,107,75,53,14,8,32,80,60,43,15,2,20,56,37,27,7,3,19,157,108,83,20,5,49
S01009276,756,443,362,54,27,313,179,54,43,9,2,125,159,93,72,11,10,66,102,73,59,11,3,29,94,69,59,5,5,25,222,154,129,18,7,68
S01009277,445,300,215,76,9,145,61,32,17,15,0,29,94,63,42,19,2,31,76,55,37,15,3,21,54,39,30,7,2,15,160,111,89,20,2,49
S01009278,437,314,274,29,11,123,80,23,19,4,0,57,85,60,46,10,4,25,53,47,43,2,2,6,42,34,29,5,0,8,177,150,137,8,5,27
S01009279,500,313,241,55,17,187,136,52,35,12,5,84,109,71,53,12,6,38,72,46,36,9,1,26,61,49,36,10,3,12,122,95,81,12,2,27
S01009280,698,360,278,13,69,338,354,111,84,3,24,243,199,146,115,5,26,53,54,39,32,1,6,15,43,33,24,1,8,10,48,31,23,3,5,17
S01009281,668,338,272,16,50,330,315,89,65,3,21,226,152,98,82,4,12,54,66,51,39,5,7,15,46,35,28,2,5,11,89,65,58,2,5,24
S01009282,625,378,291,64,23,247,131,44,29,9,6,87,122,70,55,8,7,52,94,69,55,9,5,25,62,45,32,10,3,17,216,150,120,28,2,66
S01009283,356,281,227,35,19,75,75,38,27,9,2,37,68,55,40,6,9,13,47,40,38,0,2,7,58,51,43,5,3,7,108,97,79,15,3,11
S01009284,650,474,408,49,17,176,83,28,19,9,0,55,155,113,93,16,4,42,102,68,58,4,6,34,89,77,70,6,1,12,221,188,168,14,6,33
S01009285,705,512,434,46,32,193,100,33,31,2,0,67,190,138,117,11,10,52,156,125,102,11,12,31,116,96,80,11,5,20,143,120,104,11,5,23
S01009286,653,411,345,45,21,242,134,41,32,6,3,93,158,106,87,13,6,52,97,66,53,8,5,31,97,77,67,7,3,20,167,121,106,11,4,46
S01009287,627,340,256,70,14,287,86,13,11,2,0,73,82,44,34,7,3,38,83,55,39,12,4,28,73,42,31,10,1,31,303,186,141,39,6,117
S01009288,700,381,289,70,22,319,113,26,16,8,2,87,110,57,40,13,4,53,94,55,39,11,5,39,92,62,52,7,3,30,291,181,142,31,8,110
S01009289,762,450,364,65,21,312,144,37,26,8,3,107,161,100,78,12,10,61,121,70,54,12,4,51,74,58,45,10,3,16,262,185,161,23,1,77
S01009290,538,295,244,40,11,243,84,18,13,5,0,66,83,45,34,9,2,38,78,50,41,7,2,28,77,52,46,4,2,25,216,130,110,15,5,86
S01009291,810,548,463,61,24,262,142,47,33,11,3,95,200,138,118,13,7,62,156,120,103,10,7,36,97,77,68,8,1,20,215,166,141,19,6,49
S01009292,425,271,223,15,33,154,152,53,44,1,8,99,140,117,91,8,18,23,50,38,31,3,4,12,31,24,21,2,1,7,52,39,36,1,2,13
S01009293,574,403,345,46,12,171,141,44,32,10,2,97,112,87,68,11,8,25,94,79,71,8,0,15,82,71,67,3,1,11,145,122,107,14,1,23
S01009294,401,273,220,38,15,128,62,24,15,6,3,38,68,43,34,5,4,25,59,43,33,7,3,16,62,52,42,7,3,10,150,111,96,13,2,39
S01009295,530,374,322,37,15,156,89,34,29,5,0,55,139,95,81,9,5,44,105,80,70,7,3,25,60,50,40,5,5,10,137,115,102,11,2,22
S01009296,426,319,266,39,14,107,88,41,29,10,2,47,100,78,67,4,7,22,74,61,56,2,3,13,52,42,33,8,1,10,112,97,81,15,1,15
S01009297,675,508,436,53,19,167,78,36,31,4,1,42,121,90,76,8,6,31,119,89,81,4,4,30,94,74,61,9,4,20,263,219,187,28,4,44
S01009298,845,496,402,41,53,349,325,86,69,5,12,239,185,136,103,8,25,49,108,84,74,6,4,24,85,68,53,7,8,17,142,122,103,15,4,20
S01009299,811,549,445,67,37,262,157,37,25,7,5,120,155,112,74,26,12,43,104,74,63,5,6,30,116,95,77,12,6,21,279,231,206,17,8,48
S01009300,444,310,255,26,29,134,104,32,23,3,6,72,94,61,47,7,7,33,70,57,45,6,6,13,60,59,50,4,5,1,116,101,90,6,5,15
S01009301,834,525,383,45,97,309,226,59,34,3,22,167,202,149,95,12,42,53,112,79,62,11,6,33,103,76,57,5,14,27,191,162,135,14,13,29
S01009302,690,451,354,16,81,239,202,69,51,4,14,133,221,157,117,6,34,64,78,69,55,1,13,9,79,62,45,3,14,17,110,94,86,2,6,16
S01009303,666,391,332,31,28,275,138,22,15,2,5,116,123,74,59,6,9,49,109,86,78,4,4,23,70,59,51,6,2,11,226,150,129,13,8,76
S01009304,770,507,424,48,35,263,195,67,48,9,10,128,204,146,121,13,12,58,108,89,73,12,4,19,95,77,69,4,4,18,168,128,113,10,5,40
S01009305,652,415,348,20,47,237,167,54,39,3,12,113,148,98,79,2,17,50,103,83,68,6,9,20,71,53,45,7,1,18,163,127,117,2,8,36
S01009306,897,639,520,51,68,258,179,65,47,5,13,114,189,144,105,15,24,45,148,119,102,7,10,29,127,107,82,11,14,20,254,204,184,13,7,50
S01009307,900,613,487,62,64,287,168,50,32,6,12,118,179,122,89,11,22,57,130,101,81,9,11,29,114,89,74,9,6,25,309,251,211,27,13,58
S01009308,436,309,244,39,26,127,64,17,9,2,6,47,93,71,56,11,4,22,82,68,53,7,8,14,52,42,32,7,3,10,145,111,94,12,5,34
S01009309,625,469,385,54,30,156,89,29,18,5,6,60,94,70,52,9,9,24,112,96,84,6,6,16,84,68,60,5,3,16,246,206,171,29,6,40
S01009310,804,493,405,61,27,311,140,29,23,3,3,111,174,104,81,13,10,70,112,81,65,11,5,31,87,67,54,10,3,20,291,212,182,24,6,79
S01009311,570,339,273,21,45,231,208,80,70,2,8,128,181,125,95,6,24,56,62,50,38,3,9,12,55,38,30,6,2,17,64,46,40,4,2,18
S01009312,578,430,369,28,33,148,98,33,24,1,8,65,120,88,68,10,10,32,89,77,67,3,7,12,76,66,57,7,2,10,195,166,153,7,6,29
S01009313,460,267,221,27,19,193,149,48,37,5,6,101,120,73,55,8,10,47,57,44,37,6,1,13,55,40,36,3,1,15,79,62,56,5,1,17
S01009314,541,354,302,31,21,187,101,35,30,4,1,66,121,83,68,4,11,38,69,44,39,2,3,25,77,60,50,9,1,17,173,132,115,12,5,41
S01009315,542,317,260,29,28,225,174,62,50,6,6,112,154,101,81,7,13,53,78,53,46,1,6,25,54,40,29,9,2,14,82,61,54,6,1,21
S01009316,621,428,354,51,23,193,75,25,21,1,3,50,105,57,43,4,10,48,93,68,62,3,3,25,66,57,49,5,3,9,282,221,179,38,4,61
S01009317,710,465,396,46,23,245,96,26,19,5,2,70,140,93,78,10,5,47,120,86,73,9,4,34,92,74,63,6,5,18,262,186,163,16,7,76
S01009318,500,356,309,33,14,144,52,16,14,2,0,36,71,48,38,8,2,23,95,78,68,5,5,17,55,40,34,3,3,15,227,174,155,15,4,53
S01009319,776,407,354,37,16,369,149,22,17,3,2,127,141,75,62,8,5,66,127,88,80,4,4,39,93,59,51,7,1,34,266,163,144,15,4,103
S01009320,599,329,289,29,11,270,210,41,34,5,2,169,122,79,70,7,2,43,79,63,57,4,2,16,49,39,31,6,2,10,139,107,97,7,3,32
S01009321,566,327,296,21,10,239,103,22,19,3,0,81,121,66,55,7,4,55,83,59,52,4,3,24,73,51,49,2,0,22,186,129,121,5,3,57
S01009322,673,403,348,37,18,270,183,55,48,6,1,128,144,98,81,5,12,46,100,79,70,8,1,21,90,68,60,5,3,22,156,103,89,13,1,53
S01009323,557,319,261,36,22,238,195,58,47,7,4,137,135,99,77,9,13,36,72,53,47,5,1,19,52,40,31,7,2,12,103,69,59,8,2,34
S01009324,448,296,246,26,24,152,140,51,43,5,3,89,118,85,65,9,11,33,72,63,56,3,4,9,42,34,29,2,3,8,76,63,53,7,3,13
S01009325,618,438,378,42,18,180,100,29,21,5,3,71,134,95,82,6,7,39,94,73,60,9,4,21,64,55,46,8,1,9,226,186,169,14,3,40
S01009326,448,333,292,18,23,115,82,18,14,2,2,64,109,84,68,1,15,25,57,54,50,1,3,3,66,56,49,6,1,10,134,121,111,8,2,13
S01009327,486,259,219,21,19,227,139,38,30,6,2,101,89,50,38,3,9,39,53,35,30,1,4,18,51,36,32,2,2,15,154,100,89,9,2,54
S01009328,478,434,395,27,12,44,26,21,18,1,2,5,88,76,68,6,2,12,71,67,62,3,2,4,76,69,63,4,2,7,217,201,184,13,4,16
S01009329,337,296,268,16,12,41,20,12,9,2,1,8,66,56,49,4,3,10,65,61,54,4,3,4,49,44,40,1,3,5,137,123,116,5,2,14
S01009330,353,270,231,21,18,83,39,17,15,0,2,22,100,73,61,3,9,27,55,43,35,5,3,12,54,44,37,5,2,10,105,93,83,8,2,12
S01009331,399,335,290,34,11,64,30,14,12,1,1,16,84,65,53,11,1,19,70,60,50,7,3,10,66,58,50,7,1,8,149,138,125,8,5,11
S01009332,750,475,411,42,22,275,131,31,21,8,2,100,133,79,71,5,3,54,107,86,75,6,5,21,97,76,65,5,6,21,282,203,179,18,6,79
S01009333,589,398,332,31,35,191,179,70,60,4,6,109,188,139,109,13,17,49,84,71,59,5,7,13,63,55,46,6,3,8,75,63,58,3,2,12
S01009334,511,301,222,17,62,210,179,61,42,2,17,118,147,101,72,6,23,46,60,47,30,5,12,13,57,39,34,0,5,18,68,53,44,4,5,15
S01009335,634,394,326,23,45,240,241,93,73,2,18,148,183,139,110,12,17,44,75,55,49,4,2,20,56,48,42,3,3,8,79,59,52,2,5,20
S01009336,518,313,216,19,78,205,169,64,40,3,21,105,167,115,73,4,38,52,60,47,34,5,8,13,60,48,40,3,5,12,62,39,29,4,6,23
S01009337,564,339,274,18,47,225,194,80,59,6,15,114,180,116,90,6,20,64,66,48,42,0,6,18,50,41,34,3,4,9,74,54,49,3,2,20
S01009338,626,348,257,15,76,278,266,83,52,6,25,183,187,130,88,4,38,57,70,60,53,3,4,10,42,31,27,2,2,11,61,44,37,0,7,17
S01009339,638,403,293,26,84,235,221,100,71,5,24,121,220,163,111,9,43,57,79,51,39,3,9,28,48,30,23,2,5,18,70,59,49,7,3,11
S01009340,483,296,250,16,30,187,192,74,61,3,10,118,140,104,86,4,14,36,51,39,36,2,1,12,49,37,32,1,4,12,51,42,35,6,1,9
S01009341,495,307,234,25,48,188,176,69,51,7,11,107,142,97,68,10,19,45,63,49,38,2,9,14,47,38,31,1,6,9,67,54,46,5,3,13
S01009342,609,396,327,24,45,213,187,70,55,3,12,117,191,139,114,8,17,52,78,59,44,6,9,19,71,61,53,3,5,10,82,67,61,4,2,15
S01009343,453,322,283,15,24,131,109,51,49,1,1,58,151,112,88,7,17,39,68,54,51,1,2,14,56,48,41,4,3,8,69,57,54,2,1,12
S01009344,530,317,261,15,41,213,206,59,42,2,15,147,161,127,108,5,14,34,61,47,35,4,8,14,56,46,43,1,2,10,46,38,33,3,2,8
S01009345,742,521,449,28,44,221,189,75,58,7,10,114,213,164,137,8,19,49,131,108,96,6,6,23,106,89,76,4,9,17,103,85,82,3,0,18
S01009346,479,421,349,53,19,58,25,14,12,2,0,11,80,66,46,10,10,14,69,62,45,14,3,7,75,66,63,3,0,9,230,213,183,24,6,17
S01009347,462,383,324,46,13,79,31,17,9,7,1,14,70,55,49,4,2,15,78,60,51,7,2,18,53,43,33,7,3,10,230,208,182,21,5,22
S01009348,351,305,272,22,11,46,27,18,13,3,2,9,83,71,62,5,4,12,61,57,51,4,2,4,54,47,42,4,1,7,126,112,104,6,2,14
S01009349,564,481,412,49,20,83,41,24,17,4,3,17,124,96,76,11,9,28,82,73,66,5,2,9,70,64,55,7,2,6,247,224,198,22,4,23
S01009350,446,374,320,29,25,72,39,21,18,3,0,18,128,103,83,5,15,25,83,74,64,5,5,9,60,54,49,4,1,6,136,122,106,12,4,14
S01009351,391,345,308,25,12,46,38,21,19,0,2,17,79,70,60,6,4,9,67,58,50,5,3,9,56,52,47,4,1,4,151,144,132,10,2,7
S01009352,563,491,444,31,16,72,22,12,10,2,0,10,109,82,63,12,7,27,81,71,61,7,3,10,78,73,66,5,2,5,273,253,244,5,4,20
S01009353,295,247,211,25,11,48,28,14,10,4,0,14,68,52,43,7,2,16,48,41,33,5,3,7,40,36,30,3,3,4,111,104,95,6,3,7
S01009354,635,536,457,58,21,99,43,24,17,6,1,19,144,111,89,15,7,33,90,69,61,4,4,21,100,89,75,12,2,11,258,243,215,21,7,15
S01009355,734,479,426,38,15,255,125,49,45,3,1,76,173,120,105,9,6,53,135,97,86,8,3,38,95,71,65,5,1,24,206,142,125,13,4,64
S01009356,828,531,465,43,23,297,161,51,38,10,3,110,175,119,100,10,9,56,146,98,86,6,6,48,109,87,80,7,0,22,237,176,161,10,5,61
S01009357,363,295,252,33,10,68,33,11,10,1,0,22,74,57,50,4,3,17,72,63,52,8,3,9,42,35,30,3,2,7,142,129,110,17,2,13
S01009358,556,394,325,53,16,162,50,16,12,4,0,34,100,61,51,7,3,39,76,47,35,7,5,29,75,49,40,4,5,26,255,221,187,31,3,34
S01009359,577,462,391,46,25,115,67,31,27,3,1,36,112,91,65,15,11,21,90,71,63,4,4,19,103,92,81,9,2,11,205,177,155,15,7,28
S01009360,704,460,395,46,19,244,132,50,41,5,4,82,151,95,83,8,4,56,118,90,78,5,7,28,84,66,59,5,2,18,219,159,134,23,2,60
S01009361,651,420,364,32,24,231,149,42,36,2,4,107,164,120,96,11,13,44,108,82,74,3,5,26,87,66,60,6,0,21,143,110,98,10,2,33
S01009362,868,573,506,37,30,295,139,45,37,7,1,94,224,149,130,6,13,75,147,111,100,5,6,36,134,107,97,5,5,27,224,161,142,14,5,63
S01009363,686,445,378,21,46,241,214,77,64,6,7,137,210,148,111,7,30,62,106,94,86,1,7,12,74,61,53,6,2,13,82,65,64,1,0,17
S01009364,694,528,451,37,40,166,149,75,61,3,11,74,232,182,149,16,17,50,111,99,84,9,6,12,93,79,71,5,3,14,109,93,86,4,3,16
S01009365,479,311,268,19,24,168,147,62,51,3,8,85,139,96,82,7,7,43,71,55,51,1,3,16,52,43,38,3,2,9,70,55,46,5,4,15
S01009366,628,369,302,33,34,259,230,68,54,9,5,162,170,123,95,11,17,47,81,64,58,3,3,17,66,51,41,4,6,15,81,63,54,6,3,18
S01009367,513,330,284,22,24,183,161,56,44,2,10,105,136,102,87,7,8,34,91,74,64,5,5,17,49,37,35,1,1,12,76,61,54,7,0,15
S01009368,445,319,259,21,39,126,136,76,60,3,13,60,150,112,93,4,15,38,68,52,43,5,4,16,44,40,35,2,3,4,47,39,28,7,4,8
S01009369,485,324,276,24,24,161,135,54,46,5,3,81,154,115,98,8,9,39,68,53,42,5,6,15,63,54,48,3,3,9,65,48,42,3,3,17
S01009370,737,452,390,25,37,285,222,70,55,7,8,152,200,144,122,5,17,56,101,76,65,5,6,25,84,65,60,2,3,19,130,97,88,6,3,33
S01009371,438,277,253,10,14,161,135,46,43,2,1,89,134,97,87,2,8,37,59,46,43,2,1,13,47,40,36,2,2,7,63,48,44,2,2,15
S01009372,428,294,239,28,27,134,121,55,43,4,8,66,133,105,83,9,13,28,65,50,42,4,4,15,51,37,29,7,1,14,58,47,42,4,1,11
S01009373,645,413,340,20,53,232,203,69,52,2,15,134,196,137,112,6,19,59,89,76,62,5,9,13,57,46,42,1,3,11,100,85,72,6,7,15
S01009374,745,440,364,30,46,305,284,98,79,6,13,186,210,146,120,9,17,64,93,70,57,5,8,23,78,63,52,6,5,15,80,63,56,4,3,17
S01009375,631,404,335,21,48,227,189,72,57,6,9,117,212,155,120,6,29,57,75,60,53,3,4,15,65,52,45,2,5,13,90,65,60,4,1,25
S01009376,479,287,249,15,23,192,185,80,67,4,9,105,114,83,71,5,7,31,74,49,48,0,1,25,56,39,31,4,4,17,50,36,32,2,2,14
S01009377,1016,868,781,43,44,148,107,58,54,4,0,49,366,320,295,7,18,46,168,150,139,6,5,18,109,98,85,5,8,11,266,242,208,21,13,24
S01009378,741,555,459,45,51,186,149,81,68,8,5,68,267,199,147,19,33,68,105,85,77,3,5,20,92,77,70,5,2,15,128,113,97,10,6,15
S01009379,688,546,466,43,37,142,92,54,41,5,8,38,201,155,127,13,15,46,107,93,82,6,5,14,109,93,81,8,4,16,179,151,135,11,5,28
S01009380,471,340,297,18,25,131,91,41,37,2,2,50,151,116,99,6,11,35,71,59,48,3,8,12,55,47,43,2,2,8,103,77,70,5,2,26
S01009381,539,409,339,43,27,130,84,34,26,6,2,50,146,121,99,10,12,25,88,67,56,7,4,21,61,54,46,5,3,7,160,133,112,15,6,27
S01009382,678,407,335,32,40,271,236,77,60,9,8,159,187,139,113,12,14,48,90,65,51,4,10,25,59,44,39,3,2,15,106,82,72,4,6,24
S01009383,686,467,373,41,53,219,195,65,45,9,11,130,204,167,129,11,27,37,90,78,66,3,9,12,68,58,51,5,2,10,129,99,82,13,4,30
S01009384,466,305,223,66,16,161,68,21,17,4,0,47,72,44,29,12,3,28,64,46,33,9,4,18,41,34,29,4,1,7,221,160,115,37,8,61
S01009385,413,275,218,40,17,138,82,29,24,5,0,53,82,63,41,13,9,19,59,46,40,3,3,13,55,39,34,4,1,16,135,98,79,15,4,37
S01009386,535,328,276,22,30,207,172,60,46,7,7,112,139,104,87,6,11,35,75,51,42,2,7,24,54,36,31,3,2,18,95,77,70,4,3,18
S01009387,481,293,230,24,39,188,138,52,48,2,2,86,143,88,67,9,12,55,71,48,37,1,10,23,52,43,30,2,11,9,77,62,48,10,4,15
S01009388,683,436,319,30,87,247,214,98,63,6,29,116,222,152,99,9,44,70,85,60,52,2,6,25,58,40,30,3,7,18,104,86,75,10,1,18
S01009389,807,489,395,56,38,318,194,57,40,8,9,137,173,111,88,15,8,62,125,86,75,3,8,39,88,63,50,5,8,25,227,172,142,25,5,55
S01009390,558,451,394,35,22,107,32,16,9,6,1,16,102,70,62,2,6,32,94,73,68,3,2,21,86,74,60,7,7,12,244,218,195,17,6,26
S01009391,513,425,369,41,15,88,36,19,15,4,0,17,140,113,93,15,5,27,87,74,66,5,3,13,70,65,54,8,3,5,180,154,141,9,4,26
S01009392,379,308,265,38,5,71,28,12,10,2,0,16,70,50,44,5,1,20,74,63,51,10,2,11,50,45,39,6,0,5,157,138,121,15,2,19
S01009393,562,398,321,56,21,164,101,37,26,7,4,64,144,102,82,12,8,42,98,81,63,13,5,17,68,55,43,10,2,13,151,123,107,14,2,28
S01009394,792,497,426,47,24,295,110,30,27,2,1,80,139,77,62,13,2,62,121,90,79,5,6,31,119,86,76,4,6,33,303,214,182,23,9,89
S01009395,581,301,251,40,10,280,97,17,15,2,0,80,78,39,30,8,1,39,89,46,37,5,4,43,75,56,46,6,4,19,242,143,123,19,1,99
S01009396,613,346,265,65,16,267,61,12,9,3,0,49,95,40,25,10,5,55,92,62,43,14,5,30,79,54,42,9,3,25,286,178,146,29,3,108
S01009397,597,384,315,39,30,213,94,23,15,4,4,71,127,74,56,8,10,53,89,72,60,4,8,17,55,47,37,6,4,8,232,168,147,17,4,64
S01009398,561,399,335,37,27,162,95,33,28,2,3,62,138,98,77,12,9,40,107,84,65,10,9,23,70,62,53,3,6,8,151,122,112,10,0,29
S01009399,596,392,329,48,15,204,106,35,30,0,5,71,138,100,82,13,5,38,88,59,55,2,2,29,76,52,45,5,2,24,188,146,117,28,1,42
S01009400,427,277,231,22,24,150,109,35,31,2,2,74,117,88,72,8,8,29,70,58,45,5,8,12,42,32,28,0,4,10,89,64,55,7,2,25
S01009401,577,308,255,30,23,269,85,19,14,4,1,66,122,74,57,6,11,48,89,59,53,2,4,30,71,40,33,2,5,31,210,116,98,16,2,94
S01009402,781,455,354,67,34,326,120,32,25,5,2,88,178,114,83,13,18,64,120,71,56,9,6,49,87,57,51,4,2,30,276,181,139,36,6,95
S01009403,419,304,269,22,13,115,68,25,23,1,1,43,94,67,57,7,3,27,82,63,54,6,3,19,60,53,49,1,3,7,115,96,86,7,3,19
S01009404,445,271,205,29,37,174,168,59,37,9,13,109,112,80,57,9,14,32,54,43,37,3,3,11,48,40,31,4,5,8,63,49,43,4,2,14
S01009405,331,227,167,41,19,104,84,32,24,6,2,52,94,68,46,12,10,26,46,35,30,4,1,11,37,32,21,8,3,5,70,60,46,11,3,10
S01009406,822,488,408,41,39,334,298,94,68,13,13,204,202,147,121,11,15,55,87,66,55,5,6,21,91,68,60,5,3,23,144,113,104,7,2,31
S01009407,427,266,211,31,24,161,127,41,28,4,9,86,105,67,50,9,8,38,67,56,47,6,3,11,49,41,36,4,1,8,79,61,50,8,3,18
S01009408,599,441,378,46,17,158,107,47,31,12,4,60,139,104,87,9,8,35,99,78,70,7,1,21,101,83,76,5,2,18,153,129,114,13,2,24
S01009409,557,325,267,23,35,232,226,74,62,3,9,152,159,122,99,8,15,37,56,44,36,3,5,12,57,44,37,5,2,13,59,41,33,4,4,18
S01009410,698,464,372,37,55,234,261,130,105,10,15,131,218,150,114,9,27,68,85,66,50,10,6,19,65,60,53,5,2,5,69,58,50,3,5,11
S01009411,693,433,349,32,52,260,277,108,92,6,10,169,185,134,93,14,27,51,99,81,70,5,6,18,67,54,46,3,5,13,65,56,48,4,4,9
S01009412,712,441,375,21,45,271,304,123,104,6,13,181,203,147,125,4,18,56,85,71,58,4,9,14,71,58,50,3,5,13,49,42,38,4,0,7
S01009413,848,548,444,46,58,300,298,115,92,12,11,183,222,173,131,15,27,49,114,86,64,7,15,28,93,78,70,6,2,15,121,96,87,6,3,25
S01009414,559,325,273,26,26,234,214,80,65,6,9,134,132,95,83,5,7,37,77,52,41,6,5,25,64,47,42,2,3,17,72,51,42,7,2,21
S01009415,686,398,294,42,62,288,230,71,43,6,22,159,183,127,89,17,21,56,100,76,61,5,10,24,67,52,42,4,6,15,106,72,59,10,3,34
S01009416,440,308,267,31,10,132,98,40,36,3,1,58,134,108,93,8,7,26,68,52,47,5,0,16,66,52,42,9,1,14,74,56,49,6,1,18
S01009417,229,188,147,33,8,41,31,13,10,2,1,18,55,44,33,9,2,11,41,38,32,4,2,3,41,36,24,11,1,5,61,57,48,7,2,4
S01009418,935,557,467,42,48,378,405,143,120,9,14,262,223,165,135,13,17,58,104,80,66,8,6,24,90,74,63,6,5,16,113,95,83,6,6,18
S01009419,458,277,226,15,36,181,161,52,43,3,6,109,116,84,65,3,16,32,77,59,52,1,6,18,57,45,33,7,5,12,47,37,33,1,3,10
S01009420,477,273,216,14,43,204,206,93,71,5,17,113,153,94,71,6,17,59,67,50,40,2,8,17,27,20,19,0,1,7,24,16,15,1,0,8
S01009421,553,333,259,18,56,220,193,78,56,5,17,115,166,113,81,7,25,53,64,46,38,1,7,18,57,47,38,3,6,10,73,49,46,2,1,24
S01009422,675,407,345,23,39,268,243,77,64,6,7,166,194,149,119,6,24,45,79,61,53,3,5,18,72,59,54,3,2,13,87,61,55,5,1,26
S01009423,703,576,493,52,31,127,74,43,32,7,4,31,196,157,126,20,11,39,139,113,98,9,6,26,98,86,77,6,3,12,196,177,160,10,7,19
S01009424,511,295,252,28,15,216,153,41,35,1,5,112,127,78,61,9,8,49,68,55,45,9,1,13,54,43,38,5,0,11,109,78,73,4,1,31
S01009425,649,373,303,29,41,276,224,72,48,8,16,152,154,103,83,6,14,51,85,65,60,1,4,20,81,61,52,7,2,20,105,72,60,7,5,33
S01009426,655,358,291,22,45,297,268,77,55,5,17,191,178,127,102,7,18,51,84,64,57,4,3,20,59,45,37,1,7,14,66,45,40,5,0,21
S01009427,504,272,211,19,42,232,221,61,42,4,15,160,112,77,56,5,16,35,76,62,48,5,9,14,52,44,40,2,2,8,43,28,25,3,0,15
S01009428,522,270,209,24,37,252,251,73,55,7,11,178,123,84,56,9,19,39,44,38,31,3,4,6,51,36,32,2,2,15,53,39,35,3,1,14
S01009429,590,310,267,8,35,280,305,100,82,1,17,205,134,95,82,3,10,39,51,41,37,0,4,10,49,39,33,3,3,10,51,35,33,1,1,16
S01009430,604,347,274,25,48,257,268,95,74,11,10,173,168,127,95,8,24,41,60,47,41,1,5,13,42,33,28,3,2,9,66,45,36,2,7,21
S01009431,553,311,250,28,33,242,221,60,42,10,8,161,139,101,79,8,14,38,62,47,41,3,3,15,52,43,36,2,5,9,79,60,52,5,3,19
S01009432,626,368,291,16,61,258,308,133,103,7,23,175,191,138,104,5,29,53,51,40,33,0,7,11,44,34,33,1,0,10,32,23,18,3,2,9
S01009433,632,361,275,18,68,271,265,99,72,4,23,166,195,138,96,9,33,57,75,51,42,2,7,24,56,43,38,1,4,13,41,30,27,2,1,11
S01009434,444,243,190,18,35,201,202,57,47,2,8,145,146,109,84,7,18,37,31,25,19,2,4,6,36,30,23,4,3,6,29,22,17,3,2,7
S01009435,585,341,235,26,80,244,266,107,69,9,29,159,153,113,69,10,34,40,59,45,33,3,9,14,46,32,24,3,5,14,61,44,40,1,3,17
S01009436,542,343,282,21,40,199,186,73,59,5,9,113,169,121,95,9,17,48,66,52,45,4,3,14,52,42,35,1,6,10,69,55,48,2,5,14
S01009437,568,341,272,35,34,227,224,57,48,3,6,167,165,130,94,17,19,35,59,48,36,8,4,11,64,58,50,3,5,6,56,48,44,4,0,8
S01009438,721,386,303,36,47,335,315,91,67,13,11,224,174,123,92,9,22,51,84,63,53,3,7,21,83,62,51,5,6,21,65,47,40,6,1,18
S01009439,734,418,336,21,61,316,311,104,77,5,22,207,208,152,126,4,22,56,86,67,54,4,9,19,64,52,45,2,5,12,65,43,34,6,3,22
S01009440,566,299,233,22,44,267,265,73,57,2,14,192,148,107,85,6,16,41,58,47,35,4,8,11,44,35,32,2,1,9,51,37,24,8,5,14
S01009441,634,399,320,23,56,235,236,89,72,6,11,147,230,178,139,7,32,52,78,59,51,3,5,19,54,42,31,3,8,12,36,31,27,4,0,5
S01009442,433,309,233,59,17,124,101,56,32,23,1,45,118,89,66,16,7,29,60,49,36,7,6,11,53,42,36,5,1,11,101,73,63,8,2,28
S01009443,568,354,285,49,20,214,186,64,46,13,5,122,130,99,80,11,8,31,77,55,45,9,1,22,62,48,37,7,4,14,113,88,77,9,2,25
S01009444,672,477,415,40,22,195,151,59,47,10,2,92,197,145,126,9,10,52,106,87,75,6,6,19,89,75,67,5,3,14,129,111,100,10,1,18
S01009445,642,396,326,28,42,246,251,97,81,5,11,154,190,137,104,15,18,53,74,60,50,3,7,14,71,60,54,3,3,11,56,42,37,2,3,14
S01009446,751,394,305,22,67,357,346,105,72,7,26,241,195,137,108,7,22,58,74,55,45,2,8,19,56,48,41,2,5,8,80,49,39,4,6,31
S01009447,421,261,206,21,34,160,163,63,49,3,11,100,110,78,65,5,8,32,56,43,31,4,8,13,39,36,30,2,4,3,53,41,31,7,3,12
S01009448,668,454,392,34,28,214,185,75,59,11,5,110,202,147,120,12,15,55,87,73,67,5,1,14,93,77,69,3,5,16,101,82,77,3,2,19
S01009449,426,231,198,21,12,195,183,50,41,6,3,133,101,70,54,10,6,31,49,38,36,1,1,11,42,35,33,2,0,7,51,38,34,2,2,13
S01009450,479,283,221,16,46,196,197,75,58,5,12,122,151,109,79,4,26,42,48,39,30,4,5,9,47,35,32,1,2,12,36,25,22,2,1,11
S01009451,775,467,350,36,81,308,311,118,86,9,23,193,244,172,120,16,36,72,92,72,57,7,8,20,72,57,49,2,6,15,56,48,38,2,8,8
S01009452,429,238,192,12,34,191,185,55,41,3,11,130,122,89,71,5,13,33,45,33,29,2,2,12,41,31,25,1,5,10,36,30,26,1,3,6
S01009453,877,496,413,25,58,381,338,94,78,4,12,244,251,175,138,8,29,76,111,91,77,4,10,20,88,72,65,3,4,16,89,64,55,6,3,25
S01009454,716,448,355,67,26,268,103,26,17,7,2,77,114,58,44,8,6,56,93,62,47,7,8,31,79,64,51,10,3,15,327,238,196,35,7,89
S01009455,717,420,311,93,16,297,73,20,15,5,0,53,99,51,37,12,2,48,96,57,39,15,3,39,69,49,36,10,3,20,380,243,184,51,8,137
S01009456,581,342,259,48,35,239,222,75,58,8,9,147,147,111,83,11,17,36,72,47,34,8,5,25,57,46,40,6,0,11,83,63,44,15,4,20
S01009457,522,315,226,81,8,207,140,31,15,15,1,109,112,80,53,24,3,32,62,47,38,7,2,15,64,51,40,9,2,13,144,106,80,26,0,38
S01009458,568,322,258,36,28,246,158,33,26,3,4,125,112,69,46,9,14,43,75,47,41,6,0,28,66,54,43,4,7,12,157,119,102,14,3,38
S01009459,718,430,314,59,57,288,222,66,43,12,11,156,145,103,63,16,24,42,99,69,52,8,9,30,77,61,47,8,6,16,175,131,109,15,7,44
S01009460,650,416,305,19,92,234,222,101,64,5,32,121,214,149,102,6,41,65,59,42,38,1,3,17,68,56,42,2,12,12,87,68,59,5,4,19
S01009461,413,317,273,32,12,96,38,17,14,3,0,21,68,54,45,6,3,14,63,50,41,5,4,13,57,40,36,3,1,17,187,156,137,15,4,31
S01009462,555,328,268,38,22,227,167,45,36,9,0,122,145,94,75,10,9,51,75,59,46,5,8,16,64,53,46,4,3,11,104,77,65,10,2,27
S01009463,560,317,250,38,29,243,134,34,28,4,2,100,141,95,62,16,17,46,72,42,35,3,4,30,69,55,47,6,2,14,144,91,78,9,4,53
S01009464,691,457,380,50,27,234,121,34,26,6,2,87,193,130,108,12,10,63,114,85,70,10,5,29,75,62,54,5,3,13,188,146,122,17,7,42
S01009465,489,297,244,26,27,192,153,43,33,3,7,110,143,95,77,8,10,48,61,48,37,7,4,13,50,42,36,4,2,8,82,69,61,4,4,13
S01009466,493,292,228,46,18,201,84,20,12,5,3,64,98,55,41,6,8,43,73,47,38,6,3,26,50,42,34,7,1,8,188,128,103,22,3,60
S01009467,656,375,309,46,20,281,107,24,17,3,4,83,108,56,43,9,4,52,83,52,41,6,5,31,73,52,42,7,3,21,285,191,166,21,4,94
S01009468,638,363,302,30,31,275,200,59,43,8,8,141,156,98,80,7,11,58,73,53,46,2,5,20,69,52,49,2,1,17,140,101,84,11,6,39
S01009469,692,420,332,37,51,272,131,38,27,4,7,93,144,84,57,5,22,60,103,74,60,5,9,29,75,61,48,6,7,14,239,163,140,17,6,76
S01009470,399,229,186,29,14,170,103,26,21,3,2,77,101,65,51,7,7,36,60,44,37,5,2,16,50,39,34,5,0,11,85,55,43,9,3,30
S01009471,595,267,200,23,44,328,270,61,44,3,14,209,100,58,34,8,16,42,64,42,37,2,3,22,52,36,29,4,3,16,109,70,56,6,8,39
S01009472,730,452,317,45,90,278,198,67,33,12,22,131,172,116,71,8,37,56,102,68,46,11,11,34,75,66,52,4,10,9,183,135,115,10,10,48
S01009473,739,462,352,32,78,277,258,86,53,8,25,172,197,143,106,5,32,54,76,63,49,6,8,13,73,52,47,1,4,21,135,118,97,12,9,17
S01009474,685,478,340,42,96,207,164,79,48,4,27,85,205,151,99,13,39,54,79,63,43,12,8,16,95,77,56,5,16,18,142,108,94,8,6,34
S01009475,447,315,259,47,9,132,72,24,13,9,2,48,87,54,45,8,1,33,58,42,31,8,3,16,53,45,41,3,1,8,177,150,129,19,2,27
S01009476,355,282,223,46,13,73,35,15,11,3,1,20,74,55,41,10,4,19,43,35,30,2,3,8,63,55,44,9,2,8,140,122,97,22,3,18
S01009477,629,359,285,56,18,270,139,23,18,4,1,116,101,55,35,14,6,46,78,50,42,8,0,28,76,65,58,3,4,11,235,166,132,27,7,69
S01009478,736,527,417,47,63,209,163,73,49,7,17,90,160,113,83,8,22,47,109,89,75,6,8,20,98,78,64,6,8,20,206,174,146,20,8,32
S01009479,750,430,331,48,51,320,182,37,26,7,4,145,153,98,73,7,18,55,89,60,41,9,10,29,80,67,53,4,10,13,246,168,138,21,9,78
S01009480,720,418,342,57,19,302,162,38,25,11,2,124,119,61,47,9,5,58,91,64,56,6,2,27,77,63,50,8,5,14,271,192,164,23,5,79
S01009481,801,547,472,39,36,254,192,65,57,3,5,127,168,116,92,12,12,52,123,94,80,9,5,29,114,102,91,4,7,12,204,170,152,11,7,34
S01009482,566,364,308,27,29,202,131,40,29,3,8,91,121,90,72,5,13,31,72,54,49,1,4,18,89,72,66,3,3,17,153,108,92,15,1,45
S01009483,614,466,380,48,38,148,85,38,19,10,9,47,125,98,80,11,7,27,94,79,59,10,10,15,96,77,64,7,6,19,214,174,158,10,6,40
S01009484,683,352,288,24,40,331,177,44,28,4,12,133,140,80,61,7,12,60,112,68,53,5,10,44,84,56,51,2,3,28,170,104,95,6,3,66
S01009485,654,358,279,37,42,296,214,76,61,4,11,138,144,92,69,8,15,52,102,76,60,7,9,26,77,43,32,8,3,34,117,71,57,10,4,46
S01009486,569,303,252,33,18,266,161,46,35,7,4,115,104,55,46,4,5,49,77,50,41,6,3,27,59,47,43,2,2,12,168,105,87,14,4,63
S01009487,668,382,329,20,33,286,243,68,60,4,4,175,178,136,111,6,19,42,72,48,44,1,3,24,66,53,43,6,4,13,109,77,71,3,3,32
S01009488,536,357,288,31,38,179,156,64,51,8,5,92,165,121,93,10,18,44,68,56,47,5,4,12,57,49,41,1,7,8,90,67,56,7,4,23
S01009489,673,356,288,30,38,317,292,86,67,5,14,206,159,107,80,7,20,52,75,54,46,6,2,21,56,45,36,7,2,11,91,64,59,5,0,27
S01009490,655,396,304,19,73,259,250,91,54,5,32,159,207,149,117,6,26,58,79,66,60,2,4,13,57,42,34,4,4,15,62,48,39,2,7,14
S01009491,594,279,215,27,37,315,276,70,54,3,13,206,138,87,70,6,11,51,75,47,35,6,6,28,40,32,26,3,3,8,65,43,30,9,4,22
S01009492,613,380,309,31,40,233,238,84,71,8,5,154,198,150,117,12,21,48,62,48,38,3,7,14,50,39,30,6,3,11,65,59,53,2,4,6
S01009493,737,368,287,69,12,369,130,29,17,11,1,101,83,40,33,4,3,43,98,58,47,9,2,40,75,50,43,6,1,25,351,191,147,39,5,160
S01009494,743,568,459,69,40,175,118,53,38,11,4,65,146,112,82,14,16,34,133,113,94,12,7,20,94,81,65,12,4,13,252,209,180,20,9,43
S01009495,727,523,445,57,21,204,105,48,35,11,2,57,162,107,87,12,8,55,122,94,80,9,5,28,107,85,76,7,2,22,231,189,167,18,4,42
S01009496,660,395,342,31,22,265,263,83,73,7,3,180,184,135,114,12,9,49,96,77,63,5,9,19,63,55,53,2,0,8,54,45,39,5,1,9
S01009497,808,514,439,33,42,294,271,87,70,10,7,184,205,150,116,10,24,55,118,95,84,6,5,23,86,72,70,1,1,14,128,110,99,6,5,18
S01009498,554,324,277,33,14,230,103,30,19,9,2,73,102,68,55,9,4,34,101,62,55,4,3,39,81,58,54,1,3,23,167,106,94,10,2,61
S01009499,665,385,313,34,38,280,187,56,44,4,8,131,164,115,83,12,20,49,83,62,53,6,3,21,88,64,54,6,4,24,143,88,79,6,3,55
S01009500,634,362,289,25,48,272,236,77,54,10,13,159,199,133,107,7,19,66,70,56,43,4,9,14,60,47,41,3,3,13,69,49,44,1,4,20
S01009501,570,316,241,20,55,254,240,84,61,4,19,156,145,96,68,7,21,49,72,50,44,1,5,22,61,53,41,5,7,8,52,33,27,3,3,19
S01009502,668,434,349,33,52,234,252,111,85,13,13,141,202,151,121,8,22,51,65,53,42,9,2,12,85,68,56,2,10,17,64,51,45,1,5,13
S01009503,591,401,328,39,34,190,210,96,75,11,10,114,164,133,105,15,13,31,67,54,47,2,5,13,62,52,46,5,1,10,88,66,55,6,5,22
S01009504,527,323,252,23,48,204,197,83,64,5,14,114,160,112,85,9,18,48,52,37,31,3,3,15,61,48,37,3,8,13,57,43,35,3,5,14
S01009505,595,364,265,11,88,231,197,69,49,2,18,128,226,158,112,3,43,68,56,44,34,1,9,12,61,50,37,2,11,11,55,43,33,3,7,12
S01009506,570,342,274,20,48,228,217,76,52,10,14,141,161,115,92,4,19,46,71,57,48,2,7,14,61,52,44,1,7,9,60,42,38,3,1,18
S01009507,664,453,384,32,37,211,155,62,50,6,6,93,213,155,126,13,16,58,99,78,63,6,9,21,94,72,67,2,3,22,103,86,78,5,3,17
S01009508,676,415,306,23,86,261,249,96,70,3,23,153,228,159,115,7,37,69,63,51,39,4,8,12,76,60,41,5,14,16,60,49,41,4,4,11
S01009509,797,505,388,38,79,292,261,101,72,6,23,160,230,159,115,9,35,71,93,73,61,5,7,20,99,80,65,6,9,19,114,92,75,12,5,22
S01009510,602,356,305,29,22,246,118,30,24,5,1,88,139,97,74,13,10,42,84,57,51,1,5,27,82,62,57,2,3,20,179,110,99,8,3,69
S01009511,526,300,258,32,10,226,121,35,26,6,3,86,107,65,54,9,2,42,79,55,48,6,1,24,66,56,53,3,0,10,153,89,77,8,4,64
S01009512,632,411,368,30,13,221,133,42,35,5,2,91,161,118,103,10,5,43,90,70,61,7,2,20,108,82,77,3,2,26,140,99,92,5,2,41
S01009513,487,291,260,23,8,196,81,28,26,2,0,53,108,62,53,4,5,46,78,58,54,4,0,20,76,54,45,7,2,22,144,89,82,6,1,55
S01009514,584,418,374,30,14,166,116,45,39,4,2,71,131,101,88,9,4,30,97,80,67,8,5,17,86,68,65,1,2,18,154,124,115,8,1,30
S01009515,615,333,272,28,33,282,273,81,69,6,6,192,154,116,82,16,18,38,62,44,38,3,3,18,60,44,39,0,5,16,66,48,44,3,1,18
S01009516,758,388,322,35,31,370,319,78,67,6,5,241,174,117,89,12,16,57,87,65,53,9,3,22,76,56,47,5,4,20,102,72,66,3,3,30
S01009517,703,590,512,53,25,113,58,35,22,5,8,23,175,139,111,20,8,36,117,101,90,7,4,16,118,102,93,6,3,16,235,213,196,15,2,22
S01009518,661,588,510,58,20,73,61,33,19,11,3,28,137,114,95,12,7,23,109,105,89,11,5,4,125,116,103,10,3,9,229,220,204,14,2,9
S01009519,401,280,239,23,18,121,105,48,37,5,6,57,102,78,61,9,8,24,60,46,43,2,1,14,61,48,43,4,1,13,73,60,55,3,2,13
S01009520,659,454,388,43,23,205,137,50,40,8,2,87,168,126,99,15,12,42,91,72,58,9,5,19,112,84,77,7,0,28,151,122,114,4,4,29
S01009521,702,351,258,28,65,351,326,106,68,11,27,220,195,118,84,8,26,77,58,41,32,4,5,17,51,37,29,3,5,14,72,49,45,2,2,23
S01009522,758,484,375,42,67,274,258,104,73,10,21,154,210,145,110,11,24,65,95,70,54,6,10,25,80,66,55,6,5,14,115,99,83,9,7,16
S01009523,482,262,205,10,47,220,181,55,41,2,12,126,143,93,67,2,24,50,37,24,20,1,3,13,51,39,30,2,7,12,70,51,47,3,1,19
S01009524,531,305,245,21,39,226,163,45,32,4,9,118,133,81,56,10,15,52,55,39,35,0,4,16,70,52,44,4,4,18,110,88,78,3,7,22
S01009525,447,259,209,16,34,188,159,56,41,6,9,103,133,86,69,4,13,47,43,28,25,0,3,15,50,41,35,2,4,9,62,48,39,4,5,14
S01009526,576,431,359,43,29,145,85,33,26,5,2,52,107,80,57,11,12,27,81,61,52,7,2,20,96,80,63,9,8,16,207,177,161,11,5,30
S01009527,573,361,293,23,45,212,164,53,39,6,8,111,116,74,53,2,19,42,83,66,51,7,8,17,73,55,51,3,1,18,137,113,99,5,9,24
S01009528,491,194,168,17,9,297,209,31,21,8,2,178,102,44,40,3,1,58,44,33,30,2,1,11,45,29,25,2,2,16,91,57,52,2,3,34
S01009529,505,292,228,39,25,213,130,33,23,6,4,97,85,55,43,5,7,30,79,60,51,5,4,19,57,44,35,6,3,13,154,100,76,17,7,54
S01009530,497,306,262,37,7,191,83,24,22,2,0,59,114,72,59,10,3,42,74,54,47,4,3,20,48,37,33,3,1,11,178,119,101,18,0,59
S01009531,680,363,295,18,50,317,318,96,68,8,20,222,182,116,92,3,21,66,53,41,37,4,0,12,58,51,48,0,3,7,69,59,50,3,6,10
S01009532,706,307,257,17,33,399,366,77,54,7,16,289,151,102,86,6,10,49,59,39,34,2,3,20,60,40,37,2,1,20,70,49,46,0,3,21
S01009533,653,400,325,30,45,253,240,83,61,7,15,157,163,116,89,7,20,47,82,64,53,4,7,18,69,60,57,2,1,9,99,77,65,10,2,22
S01009534,651,369,254,33,82,282,249,96,49,9,38,153,180,107,68,11,28,73,67,50,41,3,6,17,66,51,39,4,8,15,89,65,57,6,2,24
S01009535,486,310,222,18,70,176,172,84,50,2,32,88,153,100,72,8,20,53,57,44,32,4,8,13,54,42,37,1,4,12,50,40,31,3,6,10
S01009536,417,254,204,21,29,163,152,59,44,3,12,93,117,83,66,7,10,34,37,28,19,5,4,9,51,36,33,2,1,15,60,48,42,4,2,12
S01009537,451,250,197,19,34,201,146,25,20,2,3,121,102,76,55,4,17,26,62,44,34,5,5,18,46,37,32,1,4,9,95,68,56,7,5,27
S01009538,671,396,299,38,59,275,208,68,55,3,10,140,153,105,61,14,30,48,80,60,50,5,5,20,82,73,62,4,7,9,148,90,71,12,7,58
S01009539,738,442,379,36,27,296,250,75,60,8,7,175,214,160,132,16,12,54,77,55,51,3,1,22,88,66,56,4,6,22,109,86,80,5,1,23
S01009540,716,435,350,24,61,281,269,95,75,4,16,174,176,121,95,8,18,55,84,65,48,5,12,19,89,76,61,6,9,13,98,78,71,1,6,20
S01009541,639,411,338,50,23,228,200,74,61,8,5,126,141,98,75,15,8,43,93,72,53,12,7,21,74,58,54,2,2,16,131,109,95,13,1,22
S01009542,586,386,269,29,88,200,206,94,59,6,29,112,204,145,95,11,39,59,55,46,35,3,8,9,52,47,38,1,8,5,69,54,42,8,4,15
S01009543,480,254,202,35,17,226,183,56,42,5,9,127,112,69,57,9,3,43,52,32,24,6,2,20,47,39,35,3,1,8,86,58,44,12,2,28
S01009544,724,443,366,48,29,281,252,73,65,5,3,179,166,130,102,13,15,36,87,70,58,9,3,17,80,65,52,8,5,15,139,105,89,13,3,34
S01009545,646,395,305,50,40,251,216,80,58,14,8,136,187,129,94,17,18,58,70,54,43,5,6,16,75,62,53,5,4,13,98,70,57,9,4,28
S01009546,792,564,469,43,52,228,243,98,74,14,10,145,202,160,118,14,28,42,121,107,93,10,4,14,97,86,78,1,7,11,129,113,106,4,3,16
S01009547,600,395,308,44,43,205,193,75,61,6,8,118,155,110,79,11,20,45,79,64,50,6,8,15,83,73,61,9,3,10,90,73,57,12,4,17
S01009548,572,350,290,27,33,222,180,59,41,10,8,121,153,107,93,2,12,46,72,52,43,4,5,20,74,63,52,6,5,11,93,69,61,5,3,24
S01009549,649,415,349,43,23,234,176,55,43,8,4,121,176,122,98,13,11,54,88,64,56,6,2,24,91,78,65,7,6,13,118,96,87,9,0,22
S01009550,415,270,236,18,16,145,86,35,30,3,2,51,92,58,45,5,8,34,73,53,50,1,2,20,75,66,60,4,2,9,89,58,51,5,2,31
S01009551,421,266,225,16,25,155,94,30,25,2,3,64,118,87,70,6,11,31,61,47,40,4,3,14,60,45,39,3,3,15,88,57,51,1,5,31
S01009552,776,463,380,54,29,313,241,80,65,6,9,161,199,142,104,24,14,57,104,81,69,9,3,23,88,71,62,6,3,17,144,89,80,9,0,55
S01009553,701,414,317,30,67,287,270,101,72,3,26,169,185,128,95,10,23,57,86,65,53,5,7,21,75,58,48,2,8,17,85,62,49,10,3,23
S01009554,554,349,249,49,51,205,164,64,46,8,10,100,157,114,73,15,26,43,52,36,31,3,2,16,91,69,47,12,10,22,90,66,52,11,3,24
S01009555,633,415,315,55,45,218,178,71,50,11,10,107,148,106,70,16,20,42,100,81,63,11,7,19,90,70,59,4,7,20,117,87,73,13,1,30
S01009556,605,406,342,20,44,199,168,63,47,6,10,105,208,169,139,6,24,39,65,50,41,4,5,15,82,64,62,2,0,18,82,60,53,2,5,22
S01009557,526,324,244,18,62,202,166,54,41,6,7,112,169,118,81,3,34,51,62,47,37,2,8,15,63,53,40,2,11,10,66,52,45,5,2,14
S01009558,513,307,237,15,55,206,190,71,54,3,14,119,159,120,84,4,32,39,59,45,38,3,4,14,61,39,33,2,4,22,44,32,28,3,1,12
S01009559,682,429,339,22,68,253,226,89,73,6,10,137,249,178,134,9,35,71,59,50,39,3,8,9,84,63,54,3,6,21,64,49,39,1,9,15
S01009560,594,346,274,21,51,248,195,69,50,7,12,126,178,115,89,6,20,63,70,51,41,2,8,19,68,55,46,3,6,13,83,56,48,3,5,27
S01009561,423,247,195,17,35,176,127,38,23,2,13,89,142,96,76,6,14,46,48,35,29,4,2,13,56,44,38,2,4,12,50,34,29,3,2,16
S01009562,612,367,315,18,34,245,192,62,53,5,4,130,154,106,86,3,17,48,77,58,52,4,2,19,89,65,55,2,8,24,100,76,69,4,3,24
S01009563,643,341,293,22,26,302,229,49,45,1,3,180,171,124,100,9,15,47,68,42,38,4,0,26,80,62,51,5,6,18,95,64,59,3,2,31
S01009564,566,294,259,19,16,272,152,26,22,3,1,126,132,84,73,6,5,48,73,46,37,8,1,27,90,63,57,0,6,27,119,75,70,2,3,44
S01009565,457,263,214,12,37,194,118,43,29,5,9,75,153,92,68,3,21,61,71,53,50,1,2,18,52,38,34,2,2,14,63,37,33,1,3,26
S01009566,816,566,492,38,36,250,178,71,63,3,5,107,256,190,160,9,21,66,119,96,86,6,4,23,118,97,82,11,4,21,145,112,101,9,2,33
S01009567,715,452,372,27,53,263,198,67,51,5,11,131,191,137,102,10,25,54,100,74,66,2,6,26,110,100,91,5,4,10,116,74,62,5,7,42
S01009568,584,334,276,29,29,250,188,42,30,7,5,146,147,98,78,6,14,49,81,62,56,4,2,19,89,72,64,5,3,17,79,60,48,7,5,19
S01009569,666,389,347,15,27,277,236,67,56,4,7,169,184,130,113,4,13,54,83,64,58,3,3,19,83,66,61,4,1,17,80,62,59,0,3,18
S01009570,449,259,216,21,22,190,161,54,42,5,7,107,122,86,69,8,9,36,53,33,28,2,3,20,58,42,37,2,3,16,55,44,40,4,0,11
S01009571,540,330,245,19,66,210,193,73,49,6,18,120,158,109,72,6,31,49,70,54,45,3,6,16,58,44,36,2,6,14,61,50,43,2,5,11
S01009572,842,494,379,34,81,348,296,101,71,11,19,195,256,162,122,8,32,94,92,68,54,5,9,24,102,87,66,6,15,15,96,76,66,4,6,20
S01009573,585,337,260,14,63,248,257,96,75,3,18,161,169,118,87,6,25,51,49,33,25,2,6,16,51,41,29,1,11,10,59,49,44,2,3,10
S01009574,860,493,406,36,51,367,351,98,75,7,16,253,212,160,136,9,15,52,92,70,59,4,7,22,91,78,64,8,6,13,114,87,72,8,7,27
S01009575,429,267,222,17,28,162,119,24,15,4,5,95,105,79,65,7,7,26,70,56,47,1,8,14,72,64,57,2,5,8,63,44,38,3,3,19
S01009576,459,297,257,31,9,162,118,39,35,3,1,79,86,61,45,9,7,25,58,42,38,4,0,16,63,54,49,5,0,9,134,101,90,10,1,33
S01009577,598,390,317,44,29,208,130,32,23,9,0,98,127,82,63,10,9,45,100,76,59,5,12,24,77,74,63,7,4,3,164,126,109,13,4,38
S01009578,613,417,346,28,43,196,165,69,58,3,8,96,167,120,92,8,20,47,100,77,61,8,8,23,80,69,61,3,5,11,101,82,74,6,2,19
S01009579,842,565,470,47,48,277,180,70,47,12,11,110,199,140,103,14,23,59,134,103,90,7,6,31,144,113,103,7,3,31,185,139,127,7,5,46
S01009580,748,570,495,56,19,178,101,50,43,7,0,51,191,148,123,21,4,43,129,107,91,12,4,22,135,117,104,6,7,18,192,148,134,10,4,44
S01009581,473,286,236,18,32,187,134,38,30,2,6,96,146,101,78,8,15,45,55,37,30,2,5,18,67,55,48,5,2,12,71,55,50,1,4,16
S01009582,414,281,231,23,27,133,105,38,26,8,4,67,127,90,76,5,9,37,59,52,42,3,7,7,53,44,35,5,4,9,70,57,52,2,3,13
S01009583,623,395,325,32,38,228,173,66,48,7,11,107,205,145,117,14,14,60,79,61,52,3,6,18,74,51,47,1,3,23,92,72,61,7,4,20
S01009584,432,253,200,40,13,179,87,30,18,8,4,57,91,64,48,13,3,27,70,48,40,6,2,22,57,41,37,2,2,16,127,70,57,11,2,57
S01009585,775,515,435,40,40,260,220,93,70,11,12,127,253,180,151,14,15,73,112,90,85,2,3,22,100,85,73,4,8,15,90,67,56,9,2,23
S01009586,589,284,240,22,22,305,228,53,44,3,6,175,139,79,69,4,6,60,76,51,43,5,3,25,70,56,48,3,5,14,76,45,36,7,2,31
S01009587,619,308,255,26,27,311,227,36,27,4,5,191,133,79,64,6,9,54,74,52,46,3,3,22,78,64,56,1,7,14,107,77,62,12,3,30
S01009588,897,492,424,29,39,405,344,87,77,4,6,257,225,152,126,10,16,73,106,87,77,1,9,19,112,93,83,7,3,19,110,73,61,7,5,37
S01009589,744,487,411,29,47,257,239,91,70,8,13,148,211,155,125,10,20,56,88,76,63,4,9,12,115,97,91,3,3,18,91,68,62,4,2,23
S01009590,582,380,327,38,15,202,96,32,25,4,3,64,142,91,71,13,7,51,83,65,59,3,3,18,87,70,60,9,1,17,174,122,112,9,1,52
S01009591,567,393,336,33,24,174,85,38,31,5,2,47,147,102,81,12,9,45,89,63,55,5,3,26,82,72,64,2,6,10,164,118,105,9,4,46
S01009592,493,270,229,36,5,223,102,27,21,5,1,75,102,61,49,11,1,41,65,41,38,3,0,24,48,34,29,4,1,14,176,107,92,13,2,69
S01009593,492,343,273,42,28,149,75,28,23,2,3,47,107,78,55,8,15,29,76,62,48,8,6,14,74,62,55,7,0,12,160,113,92,17,4,47
S01009594,543,392,341,33,18,151,80,28,22,3,3,52,135,93,80,8,5,42,69,59,54,3,2,10,98,83,72,5,6,15,161,129,113,14,2,32
S01009595,398,308,243,39,26,90,52,17,10,6,1,35,101,82,63,11,8,19,64,56,40,11,5,8,66,57,50,2,5,9,115,96,80,9,7,19
S01009596,640,431,353,31,47,209,156,55,45,4,6,101,216,164,131,10,23,52,82,62,50,4,8,20,86,77,67,4,6,9,100,73,60,9,4,27
S01009597,633,420,298,31,91,213,159,74,37,12,25,85,199,134,94,3,37,65,82,61,52,2,7,21,112,86,65,6,15,26,81,65,50,8,7,16
S01009598,518,314,230,28,56,204,143,52,33,5,14,91,170,110,79,7,24,60,62,45,35,4,6,17,75,61,48,5,8,14,68,46,35,7,4,22
S01009599,723,464,382,28,54,259,226,85,66,6,13,141,183,132,104,7,21,51,94,76,64,4,8,18,101,80,69,6,5,21,119,91,79,5,7,28
S01009600,511,284,223,18,43,227,155,47,39,2,6,108,151,91,70,1,20,60,52,34,25,3,6,18,72,55,46,3,6,17,81,57,43,9,5,24
S01009601,534,355,285,18,52,179,136,59,44,2,13,77,156,102,76,3,23,54,67,55,44,3,8,12,86,64,57,4,3,22,89,75,64,6,5,14
S01009602,614,472,411,38,23,142,85,35,25,7,3,50,124,94,76,12,6,30,94,75,67,4,4,19,106,95,85,5,5,11,205,173,158,10,5,32
S01009603,471,312,263,35,14,159,70,19,11,5,3,51,109,62,46,9,7,47,86,61,55,4,2,25,72,64,62,2,0,8,134,106,89,15,2,28
S01009604,704,454,396,35,23,250,165,55,49,4,2,110,179,120,101,9,10,59,95,74,62,5,7,21,102,83,74,7,2,19,163,122,110,10,2,41
S01009605,644,348,276,31,41,296,188,39,28,7,4,149,174,101,75,7,19,73,92,64,51,4,9,28,83,65,56,5,4,18,107,79,66,8,5,28
S01009606,468,331,298,22,11,137,91,28,24,2,2,63,80,54,47,4,3,26,61,48,39,8,1,13,73,64,61,2,1,9,163,137,127,6,4,26
S01009607,445,278,240,29,9,167,78,24,15,7,2,54,92,63,54,5,4,29,58,40,38,2,0,18,61,44,38,5,1,17,156,107,95,10,2,49
S01009608,489,316,263,23,30,173,127,39,25,4,10,88,143,107,89,6,12,36,67,42,35,3,4,25,53,45,40,3,2,8,99,83,74,7,2,16
S01009609,665,434,348,55,31,231,151,50,34,12,4,101,146,94,65,16,13,52,88,68,53,11,4,20,112,92,81,6,5,20,168,130,115,10,5,38
S01009610,835,500,425,40,35,335,239,75,61,7,7,164,207,141,116,14,11,66,109,74,58,9,7,35,115,92,81,3,8,23,165,118,109,7,2,47
S01009611,447,294,230,56,8,153,91,34,21,12,1,57,101,67,49,15,3,34,60,39,25,12,2,21,70,52,44,6,2,18,125,102,91,11,0,23
S01009612,506,329,276,35,18,177,156,50,42,5,3,106,128,91,70,12,9,37,84,66,58,4,4,18,75,66,54,10,2,9,63,56,52,4,0,7
S01009613,380,277,210,53,14,103,83,37,19,18,0,46,85,67,45,17,5,18,38,32,25,4,3,6,53,49,42,6,1,4,121,92,79,8,5,29
S01009614,434,284,221,46,17,150,112,37,24,9,4,75,118,83,64,11,8,35,55,46,36,7,3,9,53,48,40,7,1,5,96,70,57,12,1,26
S01009615,344,181,156,15,10,163,129,31,26,4,1,98,75,51,43,5,3,24,41,29,27,1,1,12,46,32,28,1,3,14,53,38,32,4,2,15
S01009616,611,406,330,40,36,205,166,63,47,7,9,103,174,133,103,15,15,41,102,75,62,11,2,27,73,60,48,5,7,13,96,75,70,2,3,21
S01009617,597,415,363,39,13,182,129,57,50,4,3,72,166,117,101,11,5,49,98,71,63,4,4,27,74,66,61,5,0,8,130,104,88,15,1,26
S01009618,569,354,293,27,34,215,213,72,51,7,14,141,153,117,94,11,12,36,85,71,63,2,6,14,59,49,47,1,1,10,59,45,38,6,1,14
S01009619,520,286,222,23,41,234,197,50,34,5,11,147,130,96,69,9,18,34,70,52,46,3,3,18,59,41,34,3,4,18,64,47,39,3,5,17
S01009620,662,348,281,22,45,314,265,67,54,2,11,198,202,134,103,11,20,68,64,44,35,1,8,20,63,49,43,3,3,14,68,54,46,5,3,14
S01009621,655,370,296,30,44,285,272,101,71,11,19,171,145,95,78,6,11,50,79,59,46,4,9,20,74,56,50,2,4,18,85,59,51,7,1,26
S01009622,587,333,251,17,65,254,218,75,50,4,21,143,199,126,89,2,35,73,62,49,42,3,4,13,56,45,39,2,4,11,52,38,31,6,1,14
S01009623,410,213,180,18,15,197,154,46,35,5,6,108,117,63,56,4,3,54,45,34,29,3,2,11,42,33,30,2,1,9,52,37,30,4,3,15
S01009624,733,414,344,24,46,319,320,108,84,7,17,212,202,147,113,13,21,55,83,66,61,1,4,17,64,51,46,1,4,13,64,42,40,2,0,22
S01009625,685,423,349,21,53,262,284,126,103,3,20,158,227,168,133,9,26,59,61,41,35,3,3,20,51,40,37,1,2,11,62,48,41,5,2,14
S01009626,452,236,172,18,46,216,196,58,38,3,17,138,140,95,64,7,24,45,40,28,25,0,3,12,34,25,22,2,1,9,42,30,23,6,1,12
S01009627,656,379,302,25,52,277,284,110,87,7,16,174,187,123,92,6,25,64,75,59,50,6,3,16,56,47,39,2,6,9,54,40,34,4,2,14
S01009628,473,173,146,10,17,300,283,53,40,7,6,230,100,65,54,3,8,35,26,16,15,0,1,10,37,24,23,0,1,13,27,15,14,0,1,12
S01009629,827,511,405,33,73,316,316,117,100,1,16,199,241,179,130,16,33,62,109,79,62,5,12,30,87,74,64,3,7,13,74,62,49,8,5,12
S01009630,632,368,273,19,76,264,262,98,73,6,19,164,201,143,97,8,38,58,62,42,33,0,9,20,57,45,34,4,7,12,50,40,36,1,3,10
S01009631,587,322,244,20,58,265,277,95,65,8,22,182,162,112,85,5,22,50,55,44,36,1,7,11,56,49,41,3,5,7,37,22,17,3,2,15
S01009632,452,228,161,14,53,224,215,64,42,6,16,151,147,101,71,1,29,46,33,23,16,3,4,10,26,18,15,1,2,8,31,22,17,3,2,9
S01009633,548,321,235,15,71,227,234,94,67,7,20,140,161,107,78,3,26,54,57,46,32,1,13,11,40,31,24,1,6,9,56,43,34,3,6,13
S01009634,469,194,157,3,34,275,251,62,48,2,12,189,124,73,52,1,20,51,33,16,16,0,0,17,31,23,22,0,1,8,30,20,19,0,1,10
S01009635,706,432,352,32,48,274,238,85,66,9,10,153,210,157,125,6,26,53,82,58,46,6,6,24,74,59,55,1,3,15,102,73,60,10,3,29
S01009636,752,427,296,33,98,325,307,112,67,13,32,195,248,169,108,10,51,79,73,54,44,1,9,19,63,47,36,5,6,16,61,45,41,4,0,16
S01009637,615,375,317,22,36,240,210,62,44,7,11,148,184,138,121,5,12,46,82,67,54,5,8,15,65,52,45,4,3,13,74,56,53,1,2,18
S01009638,555,295,210,21,64,260,225,64,46,3,15,161,157,109,70,6,33,48,70,49,38,1,10,21,48,36,29,3,4,12,55,37,27,8,2,18
S01009639,694,370,297,47,26,324,162,36,23,6,7,126,160,94,68,16,10,66,87,54,43,8,3,33,89,61,54,6,1,28,196,125,109,11,5,71
S01009640,512,241,201,14,26,271,214,54,44,2,8,160,124,70,49,7,14,54,59,37,35,0,2,22,43,35,32,2,1,8,72,45,41,3,1,27
S01009641,684,352,274,35,43,332,255,63,40,9,14,192,164,98,81,6,11,66,106,79,60,10,9,27,55,38,31,1,6,17,104,74,62,9,3,30
S01009642,782,504,415,50,39,278,194,63,39,14,10,131,199,141,115,12,14,58,123,92,81,5,6,31,106,91,82,6,3,15,160,117,98,13,6,43
S01009643,436,356,323,21,12,80,68,35,30,2,3,33,139,111,100,7,4,28,69,60,57,2,1,9,74,69,57,8,4,5,86,81,79,2,0,5
S01009644,661,389,315,30,44,272,245,75,55,6,14,170,197,146,115,9,22,51,69,51,41,6,4,18,64,54,49,3,2,10,86,63,55,6,2,23
S01009645,532,305,250,28,27,227,192,43,33,4,6,149,143,102,84,10,8,41,77,64,48,8,8,13,62,52,43,4,5,10,58,44,42,2,0,14
S01009646,471,279,220,26,33,192,172,52,38,3,11,120,142,101,79,9,13,41,56,40,35,1,4,16,49,41,34,4,3,8,52,45,34,9,2,7
S01009647,512,263,198,25,40,249,199,53,39,3,11,146,131,80,51,9,20,51,64,46,38,4,4,18,57,41,35,4,2,16,61,43,35,5,3,18
S01009648,717,421,347,30,44,296,258,82,65,5,12,176,211,148,113,13,22,63,93,72,59,4,9,21,66,57,51,5,1,9,89,62,59,3,0,27
S01009649,845,505,412,34,59,340,255,70,56,3,11,185,226,156,117,10,29,70,132,101,84,5,12,31,91,72,59,7,6,19,141,106,96,9,1,35
S01009650,692,353,298,49,6,339,159,38,28,8,2,121,138,78,66,11,1,60,102,73,65,6,2,29,99,72,64,8,0,27,194,92,75,16,1,102
S01009651,790,475,331,114,30,315,173,59,33,23,3,114,137,85,59,17,9,52,112,74,50,16,8,38,83,63,45,16,2,20,285,194,144,42,8,91
S01009652,699,326,249,65,12,373,127,19,13,6,0,108,107,48,35,13,0,59,96,58,47,8,3,38,72,44,31,9,4,28,297,157,123,29,5,140
S01009653,445,279,242,31,6,166,83,15,10,4,1,68,79,56,44,12,0,23,64,44,39,5,0,20,54,45,39,3,3,9,165,119,110,7,2,46
S01009654,475,263,198,52,13,212,99,25,16,6,3,74,105,62,50,10,2,43,56,39,29,7,3,17,51,39,30,9,0,12,164,98,73,20,5,66
S01009655,686,408,333,20,55,278,325,141,109,9,23,184,177,128,102,7,19,49,75,58,47,3,8,17,43,32,29,0,3,11,66,49,46,1,2,17
S01009656,613,278,207,21,50,335,314,78,54,6,18,236,166,99,70,5,24,67,53,45,36,4,5,8,33,21,17,3,1,12,47,35,30,3,2,12
S01009657,657,420,337,43,40,237,162,54,36,9,9,108,186,132,94,18,20,54,118,89,75,8,6,29,86,65,61,1,3,21,105,80,71,7,2,25
S01009658,567,378,322,22,34,189,207,98,76,9,13,109,187,139,119,7,13,48,55,41,34,4,3,14,62,51,48,0,3,11,56,49,45,2,2,7
S01009659,415,268,206,24,38,147,111,42,21,2,19,69,132,96,73,10,13,36,50,42,35,4,3,8,48,34,29,2,3,14,74,54,48,6,0,20
S01009660,845,519,427,41,51,326,280,101,81,4,16,179,223,147,115,12,20,76,136,112,91,12,9,24,104,84,75,5,4,20,102,75,65,8,2,27
S01009661,708,458,328,117,13,250,156,59,39,19,1,97,122,85,55,26,4,37,102,68,50,13,5,34,82,62,49,12,1,20,246,184,135,47,2,62
S01009662,588,403,302,70,31,185,138,60,40,13,7,78,136,100,76,15,9,36,82,65,44,16,5,17,80,64,45,14,5,16,152,114,97,12,5,38
S01009663,531,332,268,44,20,199,92,21,17,3,1,71,106,71,52,12,7,35,80,55,46,4,5,25,58,41,30,7,4,17,195,144,123,18,3,51
S01009664,734,503,376,93,34,231,163,70,46,16,8,93,133,96,68,17,11,37,93,77,57,17,3,16,75,59,46,9,4,16,270,201,159,34,8,69
S01009665,535,332,275,34,23,203,152,48,39,5,4,104,121,90,72,9,9,31,72,57,49,5,3,15,49,39,34,3,2,10,141,98,81,12,5,43
S01009666,640,383,303,63,17,257,162,34,22,9,3,128,150,103,79,17,7,47,94,73,58,13,2,21,67,57,50,6,1,10,167,116,94,18,4,51
S01009667,437,274,225,45,4,163,70,25,15,10,0,45,86,55,48,5,2,31,62,45,36,9,0,17,54,37,29,7,1,17,165,112,97,14,1,53
S01009668,463,326,270,39,17,137,62,20,16,3,1,42,111,87,65,15,7,24,62,45,36,6,3,17,49,38,35,2,1,11,179,136,118,13,5,43
S01009669,438,241,190,41,10,197,129,30,20,9,1,99,77,51,37,8,6,26,60,37,32,4,1,23,51,40,30,8,2,11,121,83,71,12,0,38
S01009670,651,423,336,62,25,228,130,39,27,7,5,91,146,96,77,9,10,50,83,56,37,12,7,27,68,59,51,7,1,9,224,173,144,27,2,51
S01009671,524,361,279,62,20,163,86,29,20,6,3,57,96,63,50,7,6,33,70,55,47,6,2,15,72,57,46,8,3,15,200,157,116,35,6,43
S01009672,650,416,347,35,34,234,178,72,61,4,7,106,170,122,101,10,11,48,76,59,47,7,5,17,75,60,47,6,7,15,151,103,91,8,4,48
S01009673,674,408,318,63,27,266,190,61,43,12,6,129,143,103,78,15,10,40,73,55,46,7,2,18,64,50,44,2,4,14,204,139,107,27,5,65
S01009674,728,459,344,88,27,269,166,53,40,12,1,113,139,90,69,14,7,49,81,60,44,11,5,21,69,55,40,13,2,14,273,201,151,38,12,72
S01009675,748,479,373,78,28,269,188,54,33,13,8,134,123,82,65,14,3,41,90,70,55,12,3,20,111,93,76,11,6,18,236,180,144,28,8,56
S01009676,659,434,341,75,18,225,181,55,41,10,4,126,135,110,86,17,7,25,104,82,67,13,2,22,53,44,31,10,3,9,186,143,116,25,2,43
S01009677,484,322,227,80,15,162,77,29,16,11,2,48,90,55,33,18,4,35,57,42,30,8,4,15,55,40,27,12,1,15,205,156,121,31,4,49
S01009678,509,306,250,45,11,203,166,59,47,9,3,107,116,80,66,10,4,36,78,63,53,9,1,15,50,33,28,3,2,17,99,71,56,14,1,28
S01009679,752,468,380,55,33,284,241,80,65,7,8,161,198,142,118,10,14,56,82,66,49,14,3,16,75,56,50,5,1,19,156,124,98,19,7,32
S01009680,667,437,343,61,33,230,188,73,53,13,7,115,174,127,101,12,14,47,80,59,51,7,1,21,71,59,45,6,8,12,154,119,93,23,3,35
S01009681,592,339,286,36,17,253,181,50,44,3,3,131,130,85,70,7,8,45,81,51,42,8,1,30,40,32,26,5,1,8,160,121,104,13,4,39
S01009682,505,320,284,22,14,185,68,23,22,1,0,45,90,62,50,8,4,28,65,51,47,3,1,14,85,57,49,4,4,28,197,127,116,6,5,70
S01009683,759,391,318,45,28,368,146,27,24,2,1,119,133,63,47,9,7,70,106,66,52,5,9,40,84,53,41,3,9,31,290,182,154,26,2,108
S01009684,840,589,458,105,26,251,122,51,35,12,4,71,148,110,75,23,12,38,108,77,63,11,3,31,92,78,61,14,3,14,370,273,224,45,4,97
S01009685,523,308,255,29,24,215,133,41,36,3,2,92,115,78,61,7,10,37,73,51,46,2,3,22,66,51,38,7,6,15,136,87,74,10,3,49
S01009686,923,573,484,44,45,350,223,80,66,8,6,143,198,129,102,7,20,69,128,90,81,5,4,38,120,83,69,4,10,37,254,191,166,20,5,63
S01009687,572,381,309,38,34,191,119,44,32,6,6,75,141,110,88,7,15,31,103,79,66,7,6,24,69,53,46,5,2,16,140,95,77,13,5,45
S01009688,706,418,336,23,59,288,200,67,47,1,19,133,211,146,106,11,29,65,101,74,65,4,5,27,78,58,53,1,4,20,116,73,65,6,2,43
S01009689,519,333,271,36,26,186,114,29,22,5,2,85,93,66,49,11,6,27,75,56,45,4,7,19,58,42,31,5,6,16,179,140,124,11,5,39
S01009690,593,392,320,38,34,201,110,31,21,4,6,79,135,97,70,12,15,38,68,53,46,4,3,15,77,58,48,4,6,19,203,153,135,14,4,50
S01009691,502,299,250,31,18,203,91,23,19,3,1,68,104,71,57,9,5,33,67,44,33,6,5,23,51,37,28,4,5,14,189,124,113,9,2,65
S01009692,918,486,395,58,33,432,222,49,37,8,4,173,186,113,89,14,10,73,121,80,56,16,8,41,94,71,65,3,3,23,295,173,148,17,8,122
S01009693,522,322,268,34,20,200,66,21,12,5,4,45,111,70,57,7,6,41,86,63,51,8,4,23,71,55,50,2,3,16,188,113,98,12,3,75
S01009694,874,446,393,41,12,428,199,47,41,6,0,152,155,82,74,5,3,73,95,63,53,7,3,32,95,65,57,7,1,30,330,189,168,16,5,141
S01009695,521,315,233,66,16,206,99,32,24,7,1,67,91,57,36,15,6,34,58,37,29,4,4,21,60,53,42,10,1,7,213,136,102,30,4,77
S01009696,793,490,373,94,23,303,154,46,29,15,2,108,122,79,56,16,7,43,95,61,49,8,4,34,79,63,51,10,2,16,343,241,188,45,8,102
S01009697,589,369,283,70,16,220,99,31,21,8,2,68,95,57,45,9,3,38,62,43,25,15,3,19,71,53,41,9,3,18,262,185,151,29,5,77
S01009698,486,321,222,87,12,165,74,34,12,18,4,40,78,52,35,14,3,26,69,46,30,14,2,23,51,41,29,10,2,10,214,148,116,31,1,66
S01009699,412,182,131,38,13,230,83,19,13,4,2,64,70,41,32,6,3,29,58,30,20,8,2,28,37,21,16,3,2,16,164,71,50,17,4,93
S01009700,551,330,236,72,22,221,149,55,36,15,4,94,105,63,50,9,4,42,78,58,49,6,3,20,55,41,28,10,3,14,164,113,73,32,8,51
S01009701,405,162,106,50,6,243,87,15,9,4,2,72,73,35,20,11,4,38,57,26,16,10,0,31,24,14,12,2,0,10,164,72,49,23,0,92
S01009702,518,340,227,98,15,178,90,35,18,13,4,55,93,67,44,19,4,26,77,51,34,12,5,26,74,55,34,19,2,19,184,132,97,35,0,52
S01009703,485,267,210,47,10,218,141,46,30,14,2,95,112,75,63,12,0,37,61,40,33,2,5,21,44,29,22,6,1,15,127,77,62,13,2,50
S01009704,784,469,332,119,18,315,184,68,42,23,3,116,157,106,73,27,6,51,98,68,53,12,3,30,66,46,36,9,1,20,279,181,128,48,5,98
S01009705,618,396,294,73,29,222,196,85,62,18,5,111,155,118,89,20,9,37,76,61,43,12,6,15,65,52,41,7,4,13,126,80,59,16,5,46
S01009706,509,308,212,74,22,201,122,40,21,10,9,82,117,74,52,18,4,43,64,47,30,14,3,17,48,37,29,6,2,11,158,110,80,26,4,48
S01009707,404,273,217,40,16,131,75,18,15,3,0,57,77,60,44,9,7,17,59,42,34,5,3,17,42,36,29,5,2,6,151,117,95,18,4,34
S01009708,519,283,207,61,15,236,139,39,27,10,2,100,110,67,49,13,5,43,61,46,34,9,3,15,43,28,20,8,0,15,166,103,77,21,5,63
S01009709,693,399,305,66,28,294,207,78,52,17,9,129,140,98,69,16,13,42,90,66,51,12,3,24,69,48,39,8,1,21,187,109,94,13,2,78
S01009710,442,303,227,56,20,139,88,36,23,11,2,52,103,80,54,16,10,23,77,56,44,9,3,21,45,33,24,7,2,12,129,98,82,13,3,31
S01009711,659,376,269,78,29,283,224,59,31,20,8,165,144,106,74,19,13,38,81,60,48,10,2,21,62,51,38,11,2,11,148,100,78,18,4,48
S01009712,502,289,211,58,20,213,114,42,27,11,4,72,105,66,45,14,7,39,67,43,28,13,2,24,46,36,28,5,3,10,170,102,83,15,4,68
S01009713,775,398,280,88,30,377,182,48,30,15,3,134,148,90,66,15,9,58,109,63,42,12,9,46,61,43,26,14,3,18,275,154,116,32,6,121
S01009714,802,415,301,86,28,387,146,35,19,11,5,111,147,94,69,18,7,53,108,55,43,7,5,53,62,41,33,8,0,21,339,190,137,42,11,149
S01009715,564,334,236,84,14,230,86,36,19,14,3,50,95,68,52,15,1,27,67,39,23,15,1,28,51,33,22,8,3,18,265,158,120,32,6,107
S01009716,651,304,245,43,16,347,110,30,22,6,2,80,91,48,41,3,4,43,118,43,33,4,6,75,45,31,23,7,1,14,287,152,126,23,3,135
S01009717,905,362,285,21,56,543,123,35,28,2,5,88,170,98,76,6,16,72,283,85,64,1,20,198,66,35,25,5,5,31,263,109,92,7,10,154
S01009718,626,353,295,24,34,273,157,51,42,5,4,106,138,97,77,7,13,41,119,55,48,0,7,64,43,36,29,4,3,7,169,114,99,8,7,55
S01009719,647,376,315,32,29,271,207,82,65,13,4,125,141,103,84,6,13,38,117,61,49,4,8,56,56,45,40,4,1,11,126,85,77,5,3,41
S01009720,711,360,320,21,19,351,238,74,66,5,3,164,120,80,70,4,6,40,123,53,49,2,2,70,64,47,40,3,4,17,166,106,95,7,4,60
S01009721,564,178,136,20,22,386,7,3,3,0,0,4,75,16,11,1,4,59,289,75,54,7,14,214,29,16,12,3,1,13,164,68,56,9,3,96
S01009722,1078,307,244,29,34,771,49,10,8,0,2,39,215,44,28,7,9,171,444,112,88,4,20,332,45,18,11,6,1,27,325,123,109,12,2,202
S01009723,756,233,178,22,33,523,50,9,7,1,1,41,78,25,18,2,5,53,255,60,46,5,9,195,23,7,5,1,1,16,350,132,102,13,17,218
S01009724,891,408,328,36,44,483,207,55,41,8,6,152,160,87,69,9,9,73,199,70,53,4,13,129,53,29,21,3,5,24,272,167,144,12,11,105
S01009725,659,238,188,19,31,421,54,13,7,1,5,41,96,37,26,5,6,59,336,94,81,4,9,242,26,11,7,1,3,15,147,83,67,8,8,64
S01009726,1026,292,175,46,71,734,34,10,3,6,1,24,190,51,31,3,17,139,480,114,74,4,36,366,54,19,9,5,5,35,268,98,58,28,12,170
S01009727,675,401,302,77,22,274,74,29,15,8,6,45,126,84,72,11,1,42,121,47,35,7,5,74,62,47,35,10,2,15,292,194,145,41,8,98
S01009728,640,369,308,45,16,271,67,19,13,5,1,48,93,42,32,8,2,51,64,33,24,6,3,31,67,51,44,4,3,16,349,224,195,22,7,125
S01009729,554,276,232,36,8,278,69,14,8,6,0,55,61,25,22,2,1,36,61,36,31,3,2,25,43,25,19,6,0,18,320,176,152,19,5,144
S01009730,510,278,231,28,19,232,81,18,12,4,2,63,102,64,53,5,6,38,105,47,41,3,3,58,35,25,20,3,2,10,187,124,105,13,6,63
S01009731,530,201,150,37,14,329,63,8,4,4,0,55,68,26,16,4,6,42,92,26,19,3,4,66,30,13,7,6,0,17,277,128,104,20,4,149
S01009732,745,291,217,45,29,454,65,14,9,3,2,51,97,43,28,8,7,54,234,68,51,6,11,166,36,20,13,4,3,16,313,146,116,24,6,167
S01009733,421,264,206,47,11,157,97,36,27,7,2,61,74,49,40,5,4,25,49,35,27,5,3,14,29,22,17,5,0,7,172,122,95,25,2,50
S01009734,734,465,368,79,18,269,87,27,18,9,0,60,123,80,58,16,6,43,99,65,46,15,4,34,70,52,44,8,0,18,355,241,202,31,8,114
S01009735,1133,359,233,75,51,774,53,7,2,5,0,46,157,36,21,9,6,121,192,63,32,13,18,129,48,21,10,10,1,27,683,232,168,38,26,451
S01009736,2635,491,263,41,187,2144,99,8,5,3,0,91,501,75,26,6,43,426,1325,231,118,5,108,1094,119,18,8,4,6,101,591,159,106,23,30,432
S01009737,636,451,391,30,30,185,145,50,36,8,6,95,166,131,118,3,10,35,105,87,77,6,4,18,80,71,62,4,5,9,140,112,98,9,5,28
S01009738,371,260,214,34,12,111,87,32,24,5,3,55,91,71,55,15,1,20,61,51,45,4,2,10,39,31,26,5,0,8,93,75,64,5,6,18
S01009739,572,454,400,31,23,118,35,11,6,3,2,24,136,108,92,4,12,28,118,96,90,4,2,22,68,57,52,5,0,11,215,182,160,15,7,33
S01009740,447,266,226,24,16,181,124,30,22,5,3,94,128,86,75,3,8,42,61,46,38,5,3,15,54,46,43,1,2,8,80,58,48,10,0,22
S01009741,704,600,570,10,20,104,57,26,23,0,3,31,218,190,182,2,6,28,185,171,166,1,4,14,90,77,72,4,1,13,154,136,127,3,6,18
S01009742,418,266,203,48,15,152,49,23,16,6,1,26,74,47,32,10,5,27,44,28,20,5,3,16,46,30,26,2,2,16,205,138,109,25,4,67
S01009743,795,469,372,77,20,326,143,46,30,14,2,97,147,96,69,19,8,51,108,69,53,14,2,39,79,54,49,3,2,25,318,204,171,27,6,114
S01009744,594,362,292,58,12,232,86,26,16,10,0,60,136,83,64,16,3,53,85,64,53,7,4,21,65,46,38,5,3,19,222,143,121,20,2,79
S01009745,871,566,489,60,17,305,129,39,27,9,3,90,190,123,110,12,1,67,133,106,94,9,3,27,98,78,69,7,2,20,321,220,189,23,8,101
S01009746,457,305,209,85,11,152,61,28,16,12,0,33,81,48,30,15,3,33,56,33,19,12,2,23,53,41,29,9,3,12,206,155,115,37,3,51
S01009747,558,360,305,33,22,198,101,28,22,3,3,73,143,94,79,5,10,49,80,64,52,7,5,16,60,44,37,4,3,16,174,130,115,14,1,44
S01009748,588,365,316,31,18,223,114,39,31,6,2,75,118,73,62,6,5,45,77,55,45,5,5,22,62,47,45,1,1,15,217,151,133,13,5,66
S01009749,815,512,429,54,29,303,159,47,40,4,3,112,154,102,83,10,9,52,118,78,62,11,5,40,77,61,54,4,3,16,307,224,190,25,9,83
S01009750,560,354,299,31,24,206,142,42,36,5,1,100,140,94,76,7,11,46,69,53,47,3,3,16,62,52,43,7,2,10,147,113,97,9,7,34
S01009751,680,455,389,33,33,225,172,68,56,3,9,104,183,122,100,10,12,61,87,70,62,3,5,17,74,62,56,3,3,12,164,133,115,14,4,31
S01009752,495,316,254,43,19,179,46,5,3,2,0,41,52,19,13,3,3,33,64,43,33,6,4,21,27,17,14,1,2,10,306,232,191,31,10,74
S01009753,602,313,242,55,16,289,126,15,11,4,0,111,79,41,34,5,2,38,70,35,27,4,4,35,58,34,29,4,1,24,269,188,141,38,9,81
S01009754,720,403,324,50,29,317,132,22,14,4,4,110,121,66,49,7,10,55,88,58,46,8,4,30,63,43,30,10,3,20,316,214,185,21,8,102
S01009755,547,354,277,57,20,193,65,19,14,4,1,46,93,56,48,4,4,37,77,53,37,10,6,24,53,38,36,1,1,15,259,188,142,38,8,71
S01009756,622,382,311,48,23,240,81,24,18,5,1,57,113,66,52,6,8,47,69,36,27,5,4,33,54,46,34,8,4,8,305,210,180,24,6,95
S01009757,539,329,256,59,14,210,52,6,5,1,0,46,81,41,23,10,8,40,55,30,23,5,2,25,47,33,27,5,1,14,304,219,178,38,3,85
S01009758,514,354,301,32,21,160,141,58,45,9,4,83,122,75,57,7,11,47,97,90,80,7,3,7,51,45,41,4,0,6,103,86,78,5,3,17
S01009759,683,406,302,21,83,277,237,97,71,2,24,140,222,135,97,7,31,87,72,48,33,1,14,24,58,47,37,2,8,11,94,79,64,9,6,15
S01009760,682,382,293,28,61,300,297,98,78,4,16,199,185,137,93,13,31,48,60,42,38,1,3,18,50,40,33,4,3,10,90,65,51,6,8,25
S01009761,741,506,427,39,40,235,243,111,92,10,9,132,191,142,110,11,21,49,131,110,99,7,4,21,61,48,41,4,3,13,115,95,85,7,3,20
S01009762,734,434,334,16,84,300,304,121,89,4,28,183,180,123,92,3,28,57,85,63,46,1,16,22,74,53,49,1,3,21,91,74,58,7,9,17
S01009763,587,436,332,88,16,151,83,46,29,15,2,37,125,86,63,21,2,39,101,75,62,11,2,26,62,52,40,8,4,10,216,177,138,33,6,39
S01009764,499,336,256,20,60,163,188,80,61,5,14,108,134,109,69,6,34,25,58,46,38,2,6,12,50,43,36,3,4,7,69,58,52,4,2,11
S01009765,767,488,394,48,46,279,286,111,84,13,14,175,195,142,116,15,11,53,93,78,68,4,6,15,81,69,56,7,6,12,112,88,70,9,9,24
S01009766,458,353,318,20,15,105,119,70,63,3,4,49,119,95,85,7,3,24,76,65,58,2,5,11,58,52,51,0,1,6,86,71,61,8,2,15
S01009767,470,242,187,12,43,228,223,73,53,1,19,150,122,82,67,3,12,40,43,35,28,3,4,8,34,26,19,3,4,8,48,26,20,2,4,22
S01009768,465,337,257,37,43,128,149,78,55,11,12,71,133,102,80,6,16,31,53,40,30,5,5,13,53,45,33,8,4,8,77,72,59,7,6,5
S01009769,567,399,335,39,25,168,132,46,36,8,2,86,138,105,87,10,8,33,81,66,57,6,3,15,79,67,55,7,5,12,137,115,100,8,7,22
S01009770,562,375,313,40,22,187,145,64,43,16,5,81,150,115,96,10,9,35,79,49,42,3,4,30,68,55,50,4,1,13,120,92,82,7,3,28
S01009771,671,476,376,66,34,195,151,76,53,17,6,75,176,125,99,13,13,51,102,73,60,10,3,29,85,69,55,6,8,16,157,133,109,20,4,24
S01009772,503,384,323,32,29,119,130,66,56,5,5,64,142,119,98,9,12,23,79,65,52,7,6,14,58,50,44,2,4,8,94,84,73,9,2,10
S01009773,421,300,229,52,19,121,70,43,27,11,5,27,94,61,41,16,4,33,73,51,40,6,5,22,53,40,30,6,4,13,131,105,91,13,1,26
S01009774,355,276,224,40,12,79,56,28,17,8,3,28,76,58,44,8,6,18,46,34,25,7,2,12,43,36,31,5,0,7,134,120,107,12,1,14
S01009775,682,329,265,12,52,353,371,123,93,7,23,248,152,104,82,4,18,48,76,43,39,0,4,33,38,27,23,0,4,11,45,32,28,1,3,13
S01009776,529,275,198,9,68,254,259,84,63,1,20,175,159,108,71,4,33,51,55,36,27,0,9,19,32,31,25,3,3,1,24,16,12,1,3,8
S01009777,387,246,207,12,27,141,147,60,45,4,11,87,123,92,79,3,10,31,45,42,40,0,2,3,36,23,17,2,4,13,36,29,26,3,0,7
S01009778,711,286,231,17,38,425,418,94,65,8,21,324,155,99,84,5,10,56,44,27,24,0,3,17,45,41,35,3,3,4,49,25,23,1,1,24
S01009779,449,213,159,11,43,236,246,79,53,3,23,167,94,59,47,2,10,35,45,33,25,2,6,12,34,28,21,4,3,6,30,14,13,0,1,16
S01009780,445,273,193,10,70,172,220,109,76,6,27,111,98,64,41,0,23,34,52,44,33,0,11,8,38,33,25,2,6,5,37,23,18,2,3,14
S01009781,426,228,192,7,29,198,226,78,65,2,11,148,113,80,64,0,16,33,28,20,17,2,1,8,31,25,24,1,0,6,28,25,22,2,1,3
S01009782,396,294,231,31,32,102,106,48,34,7,7,58,114,91,68,6,17,23,53,46,41,4,1,7,51,44,34,7,3,7,72,65,54,7,4,7
S01009783,566,352,292,15,45,214,260,119,95,4,20,141,147,106,85,3,18,41,61,51,45,3,3,10,48,38,31,4,3,10,50,38,36,1,1,12
S01009784,591,309,240,11,58,282,273,99,73,4,22,174,166,107,77,1,29,59,58,37,32,2,3,21,48,34,30,2,2,14,46,32,28,2,2,14
S01009785,652,342,264,23,55,310,320,107,79,9,19,213,183,122,97,2,23,61,62,46,33,4,9,16,42,30,25,2,3,12,45,37,30,6,1,8
S01009786,746,398,299,18,81,348,366,121,91,4,26,245,194,136,92,10,34,58,68,51,38,3,10,17,60,49,40,1,8,11,58,41,38,0,3,17
S01009787,700,385,290,18,77,315,358,135,97,5,33,223,169,118,87,2,29,51,71,56,39,5,12,15,52,35,32,2,1,17,50,41,35,4,2,9
S01009788,717,369,306,29,34,348,362,126,102,12,12,236,158,106,91,7,8,52,79,46,40,2,4,33,47,36,28,2,6,11,71,55,45,6,4,16
S01009789,748,386,326,22,38,362,348,103,86,7,10,245,181,120,97,3,20,61,83,61,51,5,5,22,55,42,36,3,3,13,81,60,56,4,0,21
S01009790,519,315,272,13,30,204,234,91,77,3,11,143,139,107,87,8,12,32,61,45,43,0,2,16,39,34,31,0,3,5,46,38,34,2,2,8
S01009791,531,284,201,27,56,247,243,78,51,6,21,165,154,104,69,7,28,50,53,40,35,1,4,13,33,24,19,4,1,9,48,38,27,9,2,10
S01009792,718,556,469,58,29,162,119,68,50,12,6,51,147,106,90,9,7,41,125,90,75,8,7,35,84,74,67,4,3,10,243,218,187,25,6,25
S01009793,761,471,400,44,27,290,198,70,56,9,5,128,198,127,102,14,11,71,113,90,79,5,6,23,83,67,57,7,3,16,169,117,106,9,2,52
S01009794,399,346,314,24,8,53,60,35,26,7,2,25,103,89,81,6,2,14,69,65,62,2,1,4,52,48,40,7,1,4,115,109,105,2,2,6
S01009795,645,523,444,54,25,122,93,55,44,8,3,38,161,123,98,14,11,38,103,82,68,8,6,21,94,87,74,10,3,7,194,176,160,14,2,18
S01009796,623,413,353,46,14,210,179,62,46,15,1,117,112,87,73,11,3,25,106,78,70,4,4,28,71,58,47,8,3,13,155,128,117,8,3,27
S01009797,630,460,387,43,30,170,136,65,53,5,7,71,152,115,88,18,9,37,104,86,73,5,8,18,83,73,64,6,3,10,155,121,109,9,3,34
S01009798,555,440,371,50,19,115,98,62,47,9,6,36,127,104,85,13,6,23,106,84,75,6,3,22,85,70,61,8,1,15,139,120,103,14,3,19
S01009799,676,361,283,12,66,315,339,115,83,2,30,224,171,115,91,3,21,56,58,46,38,3,5,12,57,45,40,1,4,12,51,40,31,3,6,11
S01009800,846,532,434,32,66,314,305,122,95,8,19,183,261,184,154,3,27,77,112,85,66,8,11,27,77,63,52,6,5,14,91,78,67,7,4,13
S01009801,698,393,306,15,72,305,305,116,84,4,28,189,228,152,116,5,31,76,62,42,38,1,3,20,43,35,28,0,7,8,60,48,40,5,3,12
S01009802,772,499,422,28,49,273,259,107,83,6,18,152,244,167,138,12,17,77,76,62,51,4,7,14,79,63,58,3,2,16,114,100,92,3,5,14
S01009803,636,334,261,23,50,302,279,87,63,5,19,192,174,121,93,6,22,53,76,48,38,4,6,28,39,28,25,2,1,11,68,50,42,6,2,18
S01009804,456,281,246,23,12,175,130,32,23,4,5,98,92,56,50,5,1,36,41,24,19,5,0,17,49,40,32,3,5,9,144,129,122,6,1,15
S01009805,743,422,347,18,57,321,312,126,96,4,26,186,219,150,124,5,21,69,71,42,33,3,6,29,56,41,38,2,1,15,85,63,56,4,3,22
S01009806,786,396,332,28,36,390,300,80,61,8,11,220,178,110,96,5,9,68,107,66,59,1,6,41,81,58,47,3,8,23,120,82,69,11,2,38
S01009807,795,494,408,26,60,301,272,104,80,9,15,168,212,147,115,5,27,65,96,74,67,1,6,22,95,73,64,5,4,22,120,96,82,6,8,24
S01009808,693,403,287,27,89,290,240,91,65,4,22,149,205,129,85,7,37,76,80,59,42,3,14,21,81,65,54,4,7,16,87,59,41,9,9,28
S01009809,562,369,320,20,29,193,177,65,52,7,6,112,144,111,97,3,11,33,74,59,49,3,7,15,80,63,61,2,0,17,87,71,61,5,5,16
S01009810,671,365,270,23,72,306,292,91,57,5,29,201,162,105,80,2,23,57,74,51,39,5,7,23,50,45,35,3,7,5,93,73,59,8,6,20
S01009811,908,458,376,28,54,450,410,102,76,8,18,308,215,133,106,7,20,82,113,95,81,6,8,18,81,62,55,3,4,19,89,66,58,4,4,23
S01009812,627,336,267,26,43,291,256,73,55,5,13,183,146,95,72,8,15,51,76,60,46,6,8,16,58,49,41,5,3,9,91,59,53,2,4,32
S01009813,562,284,203,19,62,278,250,80,53,8,19,170,138,82,56,5,21,56,52,33,28,0,5,19,57,43,30,3,10,14,65,46,36,3,7,19
S01009814,696,400,319,41,40,296,219,78,60,9,9,141,130,81,67,8,6,49,95,67,47,6,14,28,81,57,48,4,5,24,171,117,97,14,6,54
S01009815,590,392,339,23,30,198,174,64,57,2,5,110,131,97,83,4,10,34,92,71,59,5,7,21,80,65,60,3,2,15,113,95,80,9,6,18
S01009816,587,416,365,29,22,171,158,67,62,4,1,91,144,109,97,7,5,35,94,75,64,5,6,19,69,57,50,4,3,12,122,108,92,9,7,14
S01009817,585,318,271,18,29,267,238,77,63,6,8,161,137,91,74,5,12,46,64,44,39,1,4,20,61,43,37,2,4,18,85,63,58,4,1,22
S01009818,852,444,361,49,34,408,231,54,45,8,1,177,166,91,68,11,12,75,144,91,81,6,4,53,77,56,41,8,7,21,234,152,126,16,10,82
S01009819,566,267,213,37,17,299,202,33,22,4,7,169,100,57,42,11,4,43,82,40,30,7,3,42,44,31,29,1,1,13,138,106,90,14,2,32
S01009820,790,457,398,31,28,333,236,68,55,7,6,168,218,138,118,10,10,80,109,74,61,5,8,35,70,60,53,3,4,10,157,117,111,6,0,40
S01009821,533,354,289,34,31,179,126,54,32,11,11,72,111,69,54,8,7,42,81,58,47,4,7,23,51,45,39,3,3,6,164,128,117,8,3,36
S01009822,360,239,198,10,31,121,112,38,28,3,7,74,100,79,64,1,14,21,50,43,34,3,6,7,35,27,25,1,1,8,63,52,47,2,3,11
S01009823,600,305,247,11,47,295,286,91,76,4,11,195,157,114,89,2,23,43,71,54,42,2,10,17,37,22,18,1,3,15,49,24,22,2,0,25
S01009824,659,412,348,18,46,247,281,98,86,4,8,183,147,115,90,5,20,32,88,69,62,1,6,19,53,47,37,4,6,6,90,83,73,4,6,7
S01009825,806,488,389,27,72,318,336,129,94,9,26,207,225,166,124,10,32,59,78,62,51,2,9,16,78,61,54,4,3,17,89,70,66,2,2,19
S01009826,456,259,204,11,44,197,203,71,52,0,19,132,138,96,73,6,17,42,49,41,36,1,4,8,30,20,18,1,1,10,36,31,25,3,3,5
S01009827,695,381,315,17,49,314,312,110,91,4,15,202,187,124,93,7,24,63,74,57,47,3,7,17,48,34,29,3,2,14,74,56,55,0,1,18
S01009828,658,303,223,18,62,355,331,80,60,6,14,251,136,89,63,4,22,47,65,46,34,1,11,19,52,33,25,2,6,19,74,55,41,5,9,19
S01009829,793,512,414,31,67,281,243,78,57,7,14,165,221,161,120,9,32,60,97,80,69,2,9,17,92,79,71,1,7,13,140,114,97,12,5,26
S01009830,619,416,348,19,49,203,218,107,80,8,19,111,193,143,113,7,23,50,69,57,51,2,4,12,65,52,51,1,0,13,74,57,53,1,3,17
S01009831,594,444,392,17,35,150,163,92,77,5,10,71,146,113,100,1,12,33,109,93,84,6,3,16,64,53,47,1,5,11,112,93,84,4,5,19
S01009832,825,514,432,36,46,311,244,77,66,6,5,167,196,136,105,8,23,60,103,81,66,8,7,22,103,89,80,3,6,14,179,131,115,11,5,48
S01009833,462,322,277,23,22,140,145,67,54,8,5,78,104,75,65,2,8,29,62,54,46,4,4,8,47,34,29,3,2,13,104,92,83,6,3,12
S01009834,630,444,370,25,49,186,209,108,80,5,23,101,174,132,110,9,13,42,72,57,47,5,5,15,72,60,55,0,5,12,103,87,78,6,3,16
S01009835,417,243,203,10,30,174,213,85,72,3,10,128,91,70,55,3,12,21,44,35,31,1,3,9,30,22,18,1,3,8,39,31,27,2,2,8
S01009836,815,497,420,31,46,318,341,126,103,13,10,215,187,148,124,9,15,39,92,72,59,3,10,20,79,67,56,3,8,12,116,84,78,3,3,32
S01009837,610,303,264,13,26,307,336,95,83,4,8,241,117,85,74,2,9,32,52,45,38,3,4,7,49,36,34,1,1,13,56,42,35,3,4,14
S01009838,635,387,304,19,64,248,258,85,65,4,16,173,135,99,69,3,27,36,63,50,40,3,7,13,55,51,38,2,11,4,124,102,92,7,3,22
S01009839,818,510,397,23,90,308,268,110,78,5,27,158,234,156,121,4,31,78,111,80,57,2,21,31,92,67,53,7,7,25,113,97,88,5,4,16
S01009840,848,442,362,24,56,406,427,136,111,6,19,291,186,127,102,8,17,59,82,64,46,4,14,18,59,47,43,2,2,12,94,68,60,4,4,26
S01009841,695,411,320,20,71,284,225,70,53,1,16,155,172,118,83,4,31,54,74,46,35,2,9,28,86,74,60,4,10,12,138,103,89,9,5,35
S01009842,524,327,237,20,70,197,169,65,36,2,27,104,160,113,81,5,27,47,41,21,16,0,5,20,53,44,39,1,4,9,101,84,65,12,7,17
S01009843,496,244,179,8,57,252,229,65,42,1,22,164,140,85,63,1,21,55,50,37,25,0,12,13,29,20,16,3,1,9,48,37,33,3,1,11
S01009844,477,258,164,23,71,219,206,68,38,7,23,138,139,92,57,5,30,47,39,27,20,0,7,12,27,22,16,0,6,5,66,49,33,11,5,17
S01009845,612,412,287,24,101,200,198,89,55,3,31,109,162,119,81,9,29,43,62,54,42,0,12,8,54,42,28,2,12,12,136,108,81,10,17,28
S01009846,714,439,339,23,77,275,284,121,92,6,23,163,177,113,77,5,31,64,70,54,42,3,9,16,66,63,53,4,6,3,117,88,75,5,8,29
S01009847,469,312,261,11,40,157,166,70,57,3,10,96,124,95,73,3,19,29,62,50,44,0,6,12,50,38,36,1,1,12,67,59,51,4,4,8
S01009848,738,409,332,15,62,329,354,126,98,6,22,228,179,128,102,2,24,51,65,44,38,1,5,21,57,43,34,2,7,14,83,68,60,4,4,15
S01009849,662,326,283,17,26,336,301,65,55,3,7,236,127,86,69,5,12,41,74,47,46,0,1,27,56,42,35,3,4,14,104,86,78,6,2,18
S01009850,765,431,364,29,38,334,327,102,86,8,8,225,165,120,99,6,15,45,78,56,46,5,5,22,75,61,49,6,6,14,120,92,84,4,4,28
S01009851,739,376,307,32,37,363,356,90,67,9,14,266,153,100,81,9,10,53,75,57,50,1,6,18,64,49,41,4,4,15,91,80,68,9,3,11
S01009852,495,259,224,16,19,236,193,45,37,1,7,148,114,70,58,5,7,44,48,38,33,2,3,10,57,43,38,4,1,14,83,63,58,4,1,20
S01009853,708,381,315,24,42,327,270,77,59,4,14,193,172,105,85,7,13,67,74,51,41,5,5,23,68,55,46,2,7,13,124,93,84,6,3,31
S01009854,690,440,355,31,54,250,265,107,83,6,18,158,171,130,107,12,11,41,70,53,43,2,8,17,62,49,39,7,3,13,122,101,83,4,14,21
S01009855,490,310,266,21,23,180,136,41,33,4,4,95,105,69,56,6,7,36,74,54,46,4,4,20,65,53,47,1,5,12,110,93,84,6,3,17
S01009856,548,269,217,27,25,279,202,65,50,9,6,137,113,50,43,3,4,63,78,48,35,5,8,30,53,35,30,2,3,18,102,71,59,8,4,31
S01009857,732,412,355,28,29,320,239,67,57,6,4,172,163,105,82,9,14,58,103,68,60,4,4,35,73,51,48,2,1,22,154,121,108,7,6,33
S01009858,633,373,318,24,31,260,224,69,51,11,7,155,158,101,85,5,11,57,83,66,57,4,5,17,71,58,54,1,3,13,97,79,71,3,5,18
S01009859,884,434,317,18,99,450,452,131,95,4,32,321,194,125,88,2,35,69,72,50,36,0,14,22,60,46,25,5,16,14,106,82,73,7,2,24
S01009860,793,376,276,8,92,417,406,105,81,2,22,301,166,104,73,3,28,62,79,52,39,0,13,27,46,37,23,1,13,9,96,78,60,2,16,18
S01009861,896,468,348,32,88,428,358,104,71,4,29,254,189,114,78,6,30,75,97,72,53,7,12,25,90,59,47,5,7,31,162,119,99,10,10,43
S01009862,961,552,419,34,99,409,379,137,88,9,40,242,181,118,84,4,30,63,85,58,47,2,9,27,98,77,66,4,7,21,218,162,134,15,13,56
S01009863,686,437,337,33,67,249,219,79,57,12,10,140,137,93,65,4,24,44,70,47,38,4,5,23,63,52,39,3,10,11,197,166,138,10,18,31
S01009864,513,342,248,30,64,171,131,47,27,5,15,84,94,60,44,2,14,34,64,51,38,5,8,13,65,55,43,4,8,10,159,129,96,14,19,30
S01009865,395,255,202,24,29,140,108,28,18,4,6,80,85,63,52,4,7,22,56,44,34,6,4,12,48,38,33,3,2,10,98,82,65,7,10,16
S01009866,782,514,425,35,54,268,250,85,66,9,10,165,178,130,101,9,20,48,102,88,73,3,12,14,68,56,49,3,4,12,184,155,136,11,8,29
S01009867,948,692,580,72,40,256,191,42,34,5,3,149,124,91,74,10,7,33,121,106,93,7,6,15,104,87,69,14,4,17,408,366,310,36,20,42
S01009868,622,418,355,27,36,204,138,36,29,2,5,102,103,75,66,2,7,28,79,47,31,8,8,32,71,53,45,3,5,18,231,207,184,12,11,24
S01009869,464,339,264,30,45,125,76,41,23,9,9,35,75,50,38,7,5,25,59,39,32,2,5,20,73,49,36,1,12,24,181,160,135,11,14,21
S01009870,498,326,230,38,58,172,145,56,34,9,13,89,122,78,48,8,22,44,47,32,25,0,7,15,49,43,35,3,5,6,135,117,88,18,11,18
S01009871,853,406,305,60,41,447,293,65,40,11,14,228,150,73,59,9,5,77,83,50,30,10,10,33,90,50,39,5,6,40,237,168,137,25,6,69
S01009872,605,410,313,47,50,195,135,46,34,6,6,89,103,66,46,8,12,37,85,60,50,5,5,25,83,65,46,10,9,18,199,173,137,18,18,26
S01009873,788,435,315,78,42,353,232,55,31,9,15,177,112,62,44,11,7,50,73,42,28,11,3,31,83,57,38,15,4,26,288,219,174,32,13,69
S01009874,868,499,371,72,56,369,227,70,51,9,10,157,158,96,68,9,19,62,115,70,53,9,8,45,87,63,51,5,7,24,281,200,148,40,12,81
S01009875,517,296,199,35,62,221,146,44,27,8,9,102,94,57,36,5,16,37,77,46,27,5,14,31,55,31,20,3,8,24,145,118,89,14,15,27
S01009876,526,286,197,19,70,240,149,52,42,1,9,97,139,82,41,7,34,57,67,40,26,4,10,27,56,39,29,2,8,17,115,73,59,5,9,42
S01009877,761,443,306,111,26,318,120,27,13,9,5,93,96,47,31,13,3,49,96,51,36,13,2,45,62,43,30,12,1,19,387,275,196,64,15,112
S01009878,542,312,208,51,53,230,174,63,31,17,15,111,94,53,33,5,15,41,50,28,19,3,6,22,45,24,17,6,1,21,179,144,108,20,16,35
S01009879,733,467,319,119,29,266,89,33,20,9,4,56,76,42,26,10,6,34,111,62,40,13,9,49,41,32,20,9,3,9,416,298,213,78,7,118
S01009880,612,339,250,60,29,273,127,30,18,11,1,97,114,59,34,15,10,55,73,42,31,5,6,31,62,42,35,4,3,20,236,166,132,25,9,70
S01009881,402,257,185,38,34,145,130,58,32,14,12,72,70,40,26,6,8,30,38,24,16,1,7,14,33,27,19,5,3,6,131,108,92,12,4,23
S01009882,936,754,602,89,63,182,102,43,25,10,8,59,121,91,62,12,17,30,119,100,73,20,7,19,109,98,80,10,8,11,485,422,362,37,23,63
S01009883,602,375,266,51,58,227,154,46,19,15,12,108,87,49,31,5,13,38,62,37,25,4,8,25,57,36,28,3,5,21,242,207,163,24,20,35
S01009884,634,427,307,73,47,207,149,65,42,11,12,84,98,47,35,4,8,51,53,33,18,6,9,20,72,55,40,9,6,17,262,227,172,43,12,35
S01009885,663,389,250,78,61,274,166,49,24,20,5,117,113,62,32,8,22,51,69,45,32,3,10,24,84,45,27,10,8,39,231,188,135,37,16,43
S01009886,626,335,237,56,42,291,168,41,25,10,6,127,106,54,35,7,12,52,76,41,33,5,3,35,74,45,31,4,10,29,202,154,113,30,11,48
S01009887,774,463,333,51,79,311,221,83,50,13,20,138,141,87,69,4,14,54,99,63,42,7,14,36,102,57,37,6,14,45,211,173,135,21,17,38
S01009888,527,311,236,43,32,216,168,74,43,19,12,94,89,43,30,5,8,46,50,25,22,1,2,25,53,32,24,5,3,21,167,137,117,13,7,30
S01009889,652,371,282,51,38,281,189,65,40,20,5,124,124,52,40,4,8,72,63,39,35,0,4,24,69,52,44,5,3,17,207,163,123,22,18,44
S01009890,439,256,191,18,47,183,150,54,35,1,18,96,95,55,36,6,13,40,55,43,37,4,2,12,38,29,18,1,10,9,101,75,65,6,4,26
S01009891,635,382,291,36,55,253,214,64,38,7,19,150,87,60,47,4,9,27,70,47,39,2,6,23,68,56,46,4,6,12,196,155,121,19,15,41
S01009892,708,401,311,21,69,307,266,80,60,2,18,186,136,91,65,5,21,45,56,37,29,4,4,19,62,40,31,1,8,22,188,153,126,9,18,35
S01009893,672,458,353,43,62,214,148,59,31,14,14,89,128,87,65,4,18,41,81,66,49,3,14,15,66,44,32,6,6,22,249,202,176,16,10,47
S01009894,689,346,271,31,44,343,283,75,57,5,13,208,124,66,48,7,11,58,57,35,26,5,4,22,77,61,50,3,8,16,148,109,90,11,8,39
S01009895,620,344,265,22,57,276,224,72,51,5,16,152,124,73,51,3,19,51,57,45,35,2,8,12,76,58,46,4,8,18,139,96,82,8,6,43
S01009896,769,395,283,45,67,374,330,120,73,24,23,210,176,91,63,7,21,85,67,49,37,3,9,18,74,45,37,2,6,29,122,90,73,9,8,32
S01009897,810,462,357,51,54,348,276,70,42,9,19,206,150,98,79,11,8,52,106,74,56,7,11,32,72,50,41,4,5,22,206,170,139,20,11,36
S01009898,490,236,160,37,39,254,213,59,44,5,10,154,122,77,48,18,11,45,33,22,16,0,6,11,53,31,16,6,9,22,69,47,36,8,3,22
S01009899,684,490,419,38,33,194,114,30,21,1,8,84,96,69,51,7,11,27,90,66,60,4,2,24,80,66,53,9,4,14,304,259,234,17,8,45
S01009900,741,635,551,49,35,106,73,30,21,4,5,43,78,61,48,3,10,17,102,91,78,9,4,11,88,75,63,7,5,13,400,378,341,26,11,22
S01009901,741,617,529,53,35,124,66,23,12,4,7,43,83,60,46,4,10,23,96,72,61,5,6,24,90,84,75,8,1,6,406,378,335,32,11,28
S01009902,804,391,300,39,52,413,342,65,37,13,15,277,128,80,60,5,15,48,76,52,38,5,9,24,67,51,43,1,7,16,191,143,122,15,6,48
S01009903,652,458,344,75,39,194,115,47,28,10,9,68,90,48,39,6,3,42,79,51,31,9,11,28,67,52,38,7,7,15,301,260,208,43,9,41
S01009904,696,493,416,53,24,203,150,33,24,8,1,117,66,44,36,5,3,22,84,60,46,8,6,24,62,48,39,4,5,14,334,308,271,28,9,26
S01009905,622,432,316,51,65,190,102,44,28,6,10,58,77,49,31,5,13,28,111,57,47,2,8,54,63,47,34,2,11,16,269,235,176,36,23,34
S01009906,557,411,328,43,40,146,115,50,31,7,12,65,72,51,41,3,7,21,70,54,43,3,8,16,65,47,41,5,1,18,235,209,172,25,12,26
S01009907,730,500,372,45,83,230,147,55,33,7,15,92,115,78,52,2,24,37,70,51,37,5,9,19,116,84,61,8,15,32,282,232,189,23,20,50
S01009908,856,667,526,108,33,189,113,45,34,7,4,68,99,67,44,12,11,32,112,86,70,12,4,26,82,69,55,8,6,13,450,400,323,69,8,50
S01009909,767,589,453,86,50,178,107,40,26,7,7,67,116,83,58,9,16,33,90,72,59,4,9,18,92,81,64,9,8,11,362,313,246,57,10,49
S01009910,455,378,307,40,31,77,52,26,17,5,4,26,49,32,21,3,8,17,46,41,33,2,6,5,53,45,40,2,3,8,255,234,196,28,10,21
S01009911,840,533,432,65,36,307,174,32,17,10,5,142,89,53,40,4,9,36,90,62,47,7,8,28,80,54,43,7,4,26,407,332,285,37,10,75
S01009912,790,448,316,109,23,342,145,23,11,11,1,122,84,39,26,11,2,45,96,57,37,12,8,39,49,39,29,7,3,10,416,290,213,68,9,126
S01009913,591,376,258,99,19,215,112,36,18,17,1,76,105,63,39,17,7,42,87,57,38,18,1,30,53,35,26,6,3,18,234,185,137,41,7,49
S01009914,819,516,350,142,24,303,123,52,28,22,2,71,107,56,34,15,7,51,115,74,55,16,3,41,60,41,33,7,1,19,414,293,200,82,11,121
S01009915,752,502,383,92,27,250,103,41,25,13,3,62,87,55,36,17,2,32,107,64,52,8,4,43,56,44,29,10,5,12,399,298,241,44,13,101
S01009916,776,427,289,104,34,349,204,63,29,29,5,141,136,57,32,14,11,79,94,49,30,14,5,45,78,55,37,14,4,23,264,203,161,33,9,61
S01009917,592,405,333,55,17,187,84,24,16,6,2,60,67,32,27,4,1,35,75,51,40,9,2,24,45,32,25,5,2,13,321,266,225,31,10,55
S01009918,578,370,294,60,16,208,88,21,9,8,4,67,62,32,19,9,4,30,69,38,34,4,0,31,38,28,22,5,1,10,321,251,210,34,7,70
S01009919,948,597,457,73,67,351,256,67,50,10,7,189,140,92,62,13,17,48,117,82,63,7,12,35,93,72,51,6,15,21,342,284,231,37,16,58
S01009920,782,621,545,52,24,161,98,30,23,2,5,68,80,53,44,4,5,27,80,62,49,6,7,18,84,76,67,6,3,8,440,400,362,34,4,40
S01009921,593,493,417,41,35,100,67,22,14,2,6,45,54,43,33,4,6,11,78,65,56,4,5,13,65,57,50,5,2,8,329,306,264,26,16,23
S01009922,940,740,648,58,34,200,91,26,18,5,3,65,101,61,49,5,7,40,125,99,81,8,10,26,106,91,75,11,5,15,517,463,425,29,9,54
S01009923,788,551,453,60,38,237,148,50,35,9,6,98,104,62,44,6,12,42,97,82,73,5,4,15,109,86,70,10,6,23,330,271,231,30,10,59
S01009924,896,647,564,55,28,249,148,42,33,5,4,106,118,75,62,7,6,43,105,79,72,5,2,26,113,85,74,4,7,28,412,366,323,34,9,46
S01009925,602,500,438,31,31,102,55,16,11,1,4,39,63,41,33,3,5,22,66,58,49,6,3,8,71,67,58,4,5,4,347,318,287,17,14,29
S01009926,660,458,371,61,26,202,127,34,25,6,3,93,84,47,33,4,10,37,76,47,38,6,3,29,68,54,41,11,2,14,305,276,234,34,8,29
S01009927,443,296,226,39,31,147,107,32,19,3,10,75,67,46,34,7,5,21,38,24,15,5,4,14,44,35,25,7,3,9,187,159,133,17,9,28
S01009928,763,557,438,86,33,206,81,20,9,8,3,61,77,37,19,13,5,40,74,52,47,2,3,22,79,66,52,7,7,13,452,382,311,56,15,70
S01009929,423,287,222,43,22,136,57,11,8,2,1,46,48,26,13,5,8,22,56,42,30,7,5,14,55,34,25,7,2,21,207,174,146,22,6,33
S01009930,758,604,487,73,44,154,90,34,19,6,9,56,101,80,65,8,7,21,89,70,54,8,8,19,97,83,60,13,10,14,381,337,289,38,10,44
S01009931,692,587,506,55,26,105,45,12,8,4,0,33,63,45,33,7,5,18,80,65,53,7,5,15,77,63,54,6,3,14,427,402,358,31,13,25
S01009932,576,454,380,56,18,122,89,30,24,5,1,59,70,42,35,3,4,28,67,52,45,4,3,15,59,56,46,9,1,3,291,274,230,35,9,17
S01009933,762,480,369,28,83,282,207,66,37,5,24,141,160,98,70,6,22,62,71,51,40,5,6,20,99,83,63,4,16,16,225,182,159,8,15,43
S01009934,753,542,465,44,33,211,132,60,44,10,6,72,113,59,45,5,9,54,116,91,83,4,4,25,66,51,45,2,4,15,326,281,248,23,10,45
S01009935,502,203,165,10,28,299,259,47,33,4,10,212,94,50,40,1,9,44,40,27,22,1,4,13,31,24,22,1,1,7,78,55,48,3,4,23
S01009936,568,332,273,27,32,236,181,42,33,4,5,139,105,65,56,4,5,40,76,54,41,5,8,22,52,41,37,0,4,11,154,130,106,14,10,24
S01009937,401,184,131,9,44,217,168,42,30,2,10,126,92,50,33,0,17,42,45,31,24,3,4,14,40,27,21,1,5,13,56,34,23,3,8,22
S01009938,818,357,276,39,42,461,388,71,54,3,14,317,150,84,64,8,12,66,72,42,30,7,5,30,65,52,41,7,4,13,143,108,87,14,7,35
S01009939,687,341,196,11,134,346,328,127,72,3,52,201,176,103,61,1,41,73,42,20,13,2,5,22,64,40,15,3,22,24,77,51,35,2,14,26
S01009940,678,326,248,15,63,352,369,113,88,3,22,256,170,104,72,5,27,66,51,36,32,1,3,15,48,42,33,2,7,6,40,31,23,4,4,9
S01009941,754,523,399,63,61,231,193,102,72,19,11,91,193,140,109,12,19,53,130,93,76,8,9,37,81,62,41,6,15,19,157,126,101,18,7,31
S01009942,836,449,340,29,80,387,423,140,107,9,24,283,216,150,111,6,33,66,86,74,61,6,7,12,47,39,27,3,9,8,64,46,34,5,7,18
S01009943,671,319,245,18,56,352,348,98,70,7,21,250,153,95,65,6,24,58,65,50,46,1,3,15,50,38,32,1,5,12,55,38,32,3,3,17
S01009944,658,380,304,38,38,278,224,69,49,10,10,155,159,102,76,11,15,57,92,61,56,3,2,31,60,44,34,5,5,16,123,104,89,9,6,19
S01009945,790,433,353,30,50,357,294,81,65,7,9,213,182,112,85,5,22,70,96,66,55,4,7,30,85,62,53,2,7,23,133,112,95,12,5,21
S01009946,672,388,311,30,47,284,238,84,68,5,11,154,144,96,69,8,19,48,93,66,56,5,5,27,69,46,34,3,9,23,128,96,84,9,3,32
S01009947,470,262,208,27,27,208,168,50,36,6,8,118,115,76,57,7,12,39,53,32,30,0,2,21,43,32,27,1,4,11,91,72,58,13,1,19
S01009948,671,328,251,23,54,343,278,70,46,6,18,208,152,85,63,4,18,67,67,53,45,1,7,14,82,53,46,2,5,29,92,67,51,10,6,25
S01009949,667,390,309,27,54,277,215,60,41,4,15,155,154,106,83,4,19,48,95,66,54,6,6,29,62,46,34,3,9,16,141,112,97,10,5,29
S01009950,593,389,290,76,23,204,74,21,13,5,3,53,70,37,23,11,3,33,99,64,50,9,5,35,34,23,18,3,2,11,316,244,186,48,10,72
S01009951,615,397,260,114,23,218,74,27,15,8,4,47,63,24,12,8,4,39,72,39,30,5,4,33,42,35,24,8,3,7,364,272,179,85,8,92
S01009952,599,368,308,43,17,231,104,29,25,2,2,75,84,41,32,5,4,43,82,54,41,8,5,28,59,39,32,6,1,20,270,205,178,22,5,65
S01009953,734,469,383,61,25,265,131,43,32,7,4,88,112,69,54,10,5,43,103,65,56,5,4,38,59,47,38,4,5,12,329,245,203,35,7,84
S01009954,511,324,227,65,32,187,90,33,19,12,2,57,92,52,34,11,7,40,83,52,34,10,8,31,45,38,26,4,8,7,201,149,114,28,7,52
S01009955,854,485,393,51,41,369,259,55,40,8,7,204,134,84,64,11,9,50,111,81,65,7,9,30,72,54,43,3,8,18,278,211,181,22,8,67
S01009956,617,357,274,43,40,260,170,48,36,6,6,122,133,82,64,4,14,51,85,53,39,12,2,32,56,45,33,6,6,11,173,129,102,15,12,44
S01009957,611,400,303,86,11,211,74,16,10,4,2,58,64,38,24,11,3,26,81,52,36,14,2,29,47,29,22,6,1,18,345,265,211,51,3,80
S01009958,747,539,446,75,18,208,103,34,26,8,0,69,109,68,51,10,7,41,96,73,58,10,5,23,64,48,40,5,3,16,375,316,271,42,3,59
S01009959,556,307,224,67,16,249,91,23,15,6,2,68,87,48,34,9,5,39,81,49,38,5,6,32,42,27,23,4,0,15,255,160,114,43,3,95
S01009960,758,418,339,64,15,340,161,31,16,14,1,130,101,38,26,11,1,63,111,65,58,3,4,46,57,44,36,5,3,13,328,240,203,31,6,88
S01009961,580,339,265,47,27,241,155,46,33,8,5,109,122,79,63,6,10,43,97,68,52,11,5,29,59,41,31,6,4,18,147,105,86,16,3,42
S01009962,888,612,525,50,37,276,188,67,51,6,10,121,152,104,84,12,8,48,147,118,100,12,6,29,113,84,75,3,6,29,288,239,215,17,7,49
S01009963,665,442,373,58,11,223,120,36,25,9,2,84,131,86,73,11,2,45,138,106,89,15,2,32,60,48,41,6,1,12,216,166,145,17,4,50
S01009964,743,516,426,64,26,227,116,38,27,7,4,78,106,68,51,10,7,38,121,78,61,12,5,43,76,60,50,6,4,16,324,272,237,29,6,52
S01009965,613,401,335,39,27,212,168,63,44,12,7,105,132,94,79,7,8,38,101,82,70,5,7,19,57,40,33,4,3,17,155,122,109,11,2,33
S01009966,645,435,372,32,31,210,156,65,50,10,5,91,172,123,95,14,14,49,121,99,87,4,8,22,69,55,50,2,3,14,127,93,90,2,1,34
S01009967,700,453,373,63,17,247,106,26,18,8,0,80,98,60,37,15,8,38,95,68,58,7,3,27,68,53,41,11,1,15,333,246,219,22,5,87
S01009968,523,344,291,34,19,179,152,54,39,11,4,98,123,88,72,9,7,35,91,72,64,3,5,19,45,41,37,2,2,4,112,89,79,9,1,23
S01009969,700,408,318,66,24,292,144,34,18,11,5,110,124,71,54,11,6,53,108,74,59,11,4,34,81,56,42,12,2,25,243,173,145,21,7,70
S01009970,733,378,277,21,80,355,325,87,53,7,27,238,207,138,98,7,33,69,75,57,44,1,12,18,71,53,45,3,5,18,55,43,37,3,3,12
S01009971,860,525,398,42,85,335,376,155,105,18,32,221,238,173,129,11,33,65,77,57,44,6,7,20,75,60,49,2,9,15,94,80,71,5,4,14
S01009972,680,397,328,42,27,283,243,68,51,12,5,175,154,109,82,15,12,45,85,64,57,5,2,21,69,51,42,6,3,18,129,105,96,4,5,24
S01009973,565,391,333,26,32,174,195,94,76,3,15,101,180,135,115,11,9,45,67,55,46,5,4,12,52,45,42,1,2,7,71,62,54,6,2,9
S01009974,468,244,183,10,51,224,233,73,51,4,18,160,130,93,71,3,19,37,49,37,29,0,8,12,41,31,25,2,4,10,15,10,7,1,2,5
S01009975,629,267,195,15,57,362,334,78,51,7,20,256,157,90,64,3,23,67,54,39,32,3,4,15,42,29,24,0,5,13,42,31,24,2,5,11
S01009976,385,213,173,10,30,172,184,72,51,6,15,112,114,83,72,3,8,31,27,26,21,1,4,1,33,21,20,0,1,12,27,11,9,0,2,16
S01009977,813,325,236,11,78,488,487,122,88,4,30,365,184,111,76,2,33,73,49,33,23,1,9,16,43,27,22,1,4,16,50,32,27,3,2,18
S01009978,773,441,340,22,79,332,339,139,102,6,31,200,217,144,111,4,29,73,85,57,42,4,11,28,66,50,41,5,4,16,66,51,44,3,4,15
S01009979,516,209,160,6,43,307,328,83,62,3,18,245,92,62,45,1,16,30,37,22,16,1,5,15,24,21,17,0,4,3,35,21,20,1,0,14
S01009980,541,231,168,5,58,310,261,81,59,1,21,180,170,94,65,3,26,76,53,28,21,0,7,25,28,16,15,0,1,12,29,12,8,1,3,17
S01009981,532,301,223,12,66,231,248,92,66,4,22,156,159,120,85,4,31,39,52,35,29,0,6,17,36,27,19,2,6,9,37,27,24,2,1,10
S01009982,767,497,390,39,68,270,277,115,75,14,26,162,242,179,138,12,29,63,94,79,66,5,8,15,62,49,45,2,2,13,92,75,66,6,3,17
S01009983,426,228,156,6,66,198,194,67,43,0,24,127,123,83,53,1,29,40,29,14,9,2,3,15,32,22,19,0,3,10,48,42,32,3,7,6
S01009984,580,388,299,34,55,192,214,96,65,9,22,118,157,117,92,11,14,40,74,58,49,5,4,16,57,52,40,6,6,5,78,65,53,3,9,13
S01009985,467,268,188,14,66,199,192,80,55,4,21,112,147,91,57,6,28,56,62,47,39,2,6,15,32,22,18,1,3,10,34,28,19,1,8,6
S01009986,446,208,146,6,56,238,222,67,44,4,19,155,116,69,45,0,24,47,37,25,22,0,3,12,36,22,15,2,5,14,35,25,20,0,5,10
S01009987,747,370,290,21,59,377,401,109,78,10,21,292,170,123,99,4,20,47,76,59,48,2,9,17,45,34,29,1,4,11,55,45,36,4,5,10
S01009988,447,195,144,5,46,252,247,68,49,2,17,179,85,52,33,1,18,33,45,27,23,0,4,18,36,21,18,0,3,15,34,27,21,2,4,7
S01009989,670,434,356,27,51,236,223,89,68,8,13,134,175,132,109,7,16,43,89,60,47,2,11,29,81,68,57,5,6,13,102,85,75,5,5,17
S01009990,553,401,343,22,36,152,147,65,52,5,8,82,161,124,106,7,11,37,94,84,72,2,10,10,73,61,49,5,7,12,78,67,64,3,0,11
S01009991,625,458,387,26,45,167,150,79,65,2,12,71,184,136,108,7,21,48,104,84,68,11,5,20,81,70,65,2,3,11,106,89,81,4,4,17
S01009992,573,283,207,14,62,290,303,92,59,6,27,211,139,86,57,3,26,53,57,46,35,3,8,11,32,26,24,1,1,6,42,33,32,1,0,9
S01009993,659,492,416,44,32,167,162,82,67,9,6,80,167,130,105,15,10,37,104,87,74,5,8,17,92,79,69,6,4,13,134,114,101,9,4,20
S01009994,532,385,333,27,25,147,119,53,42,7,4,66,144,108,94,7,7,36,92,74,61,6,7,18,58,48,46,1,1,10,119,102,90,6,6,17
S01009995,535,398,340,27,31,137,122,69,55,8,6,53,161,127,110,6,11,34,90,68,61,3,4,22,72,59,51,3,5,13,90,75,63,7,5,15
S01009996,572,394,330,25,39,178,149,72,55,7,10,77,158,115,91,6,18,43,84,66,56,4,6,18,70,55,51,3,1,15,111,86,77,5,4,25
S01009997,470,340,288,21,31,130,117,59,49,5,5,58,116,85,69,4,12,31,82,64,54,3,7,18,60,49,41,3,5,11,95,83,75,6,2,12
S01009998,524,298,224,47,27,226,130,38,23,11,4,92,95,62,44,10,8,33,104,66,48,12,6,38,46,36,28,4,4,10,149,96,81,10,5,53
S01009999,597,369,310,28,31,228,133,48,43,2,3,85,125,73,59,5,9,52,109,80,67,3,10,29,67,54,47,4,3,13,163,114,94,14,6,49
S01010000,491,362,300,25,37,129,120,62,48,9,5,58,125,95,76,4,15,30,74,60,50,3,7,14,67,58,49,4,5,9,105,87,77,5,5,18
S01010001,617,406,343,29,34,211,161,61,48,2,11,100,136,100,82,10,8,36,109,83,75,3,5,26,61,50,43,5,2,11,150,112,95,9,8,38
S01010002,644,438,369,30,39,206,175,79,60,9,10,96,178,123,102,7,14,55,106,81,73,2,6,25,72,59,48,5,6,13,113,96,86,7,3,17
S01010003,571,393,335,34,24,178,144,59,45,10,4,85,146,100,87,8,5,46,96,76,68,3,5,20,56,45,38,5,2,11,129,113,97,8,8,16
S01010004,617,393,313,40,40,224,109,37,24,5,8,72,121,72,47,11,14,49,120,77,63,7,7,43,55,43,37,3,3,12,212,164,142,14,8,48
S01010005,682,479,386,31,62,203,185,61,38,5,18,124,123,92,72,7,13,31,84,75,60,4,11,9,89,71,60,4,7,18,201,180,156,11,13,21
S01010006,810,560,493,24,43,250,196,41,29,1,11,155,126,90,74,2,14,36,114,91,78,5,8,23,94,81,75,3,3,13,280,257,237,13,7,23
S01010007,805,553,473,56,24,252,142,47,36,7,4,95,140,92,74,13,5,48,137,101,87,9,5,36,89,72,61,7,4,17,297,241,215,20,6,56
S01010008,567,413,352,33,28,154,99,34,22,5,7,65,96,67,51,7,9,29,77,58,51,5,2,19,66,53,46,5,2,13,229,201,182,11,8,28
S01010009,528,423,359,29,35,105,83,27,19,2,6,56,103,81,71,2,8,22,80,69,57,6,6,11,70,65,56,5,4,5,192,181,156,14,11,11
S01010010,858,575,472,71,32,283,127,43,29,9,5,84,139,85,66,12,7,54,133,100,86,10,4,33,82,61,52,6,3,21,377,286,239,34,13,91
S01010011,703,415,352,25,38,288,236,44,32,3,9,192,80,45,31,3,11,35,63,44,33,4,7,19,72,59,51,4,4,13,252,223,205,11,7,29
S01010012,685,428,359,43,26,257,183,73,54,11,8,110,150,90,73,8,9,60,108,81,68,8,5,27,73,57,53,3,1,16,171,127,111,13,3,44
S01010013,698,518,430,41,47,180,126,41,27,6,8,85,108,77,62,5,10,31,103,83,66,7,10,20,81,70,53,6,11,11,280,247,222,17,8,33
S01010014,874,616,488,82,46,258,198,53,42,7,4,145,101,67,48,5,14,34,116,91,70,13,8,25,101,85,67,8,10,16,358,320,261,49,10,38
S01010015,711,555,445,58,52,156,81,33,20,8,5,48,102,68,45,8,15,34,110,79,62,6,11,31,74,63,52,5,6,11,344,312,266,31,15,32
S01010016,611,328,277,21,30,283,258,71,51,7,13,187,165,108,87,9,12,57,82,73,65,4,4,9,39,25,25,0,0,14,67,51,49,1,1,16
S01010017,606,347,267,17,63,259,266,96,70,8,18,170,172,117,85,5,27,55,76,58,51,0,7,18,36,32,26,3,3,4,56,44,35,1,8,12
S01010018,798,418,365,24,29,380,368,95,83,3,9,273,175,125,109,7,9,50,88,64,51,9,4,24,72,60,53,3,4,12,95,74,69,2,3,21
S01010019,586,293,224,10,59,293,290,76,56,5,15,214,157,106,77,3,26,51,52,39,27,2,10,13,36,31,30,0,1,5,51,41,34,0,7,10
S01010020,627,350,302,21,27,277,293,94,75,7,12,199,145,104,88,7,9,41,76,56,53,1,2,20,52,43,38,2,3,9,61,53,48,4,1,8
S01010021,624,305,200,23,82,319,274,80,41,12,27,194,164,102,66,2,34,62,52,34,27,1,6,18,42,28,19,1,8,14,92,61,47,7,7,31
S01010022,773,415,315,32,68,358,319,81,63,6,12,238,175,117,76,11,30,58,68,48,37,2,9,20,85,54,43,2,9,31,126,115,96,11,8,11
S01010023,536,212,154,9,49,324,311,66,42,2,22,245,110,67,54,5,8,43,44,25,16,0,9,19,45,36,32,0,4,9,26,18,10,2,6,8
S01010024,625,363,298,14,51,262,244,82,63,3,16,162,105,60,50,2,8,45,66,47,34,1,12,19,64,50,45,1,4,14,146,124,106,7,11,22
S01010025,471,231,162,22,47,240,209,48,27,5,16,161,85,46,33,2,11,39,41,33,20,4,9,8,50,32,24,4,4,18,86,72,58,7,7,14
S01010026,758,477,382,30,65,281,248,76,49,4,23,172,144,103,76,5,22,41,101,62,55,2,5,39,82,64,53,5,6,18,183,172,149,14,9,11
S01010027,761,480,396,29,55,281,217,62,47,3,12,155,111,73,48,8,17,38,103,69,55,1,13,34,83,62,52,0,10,21,247,214,194,17,3,33
S01010028,547,283,221,21,41,264,239,50,36,3,11,189,95,61,39,5,17,34,37,23,22,0,1,14,37,31,26,2,3,6,139,118,98,11,9,21
S01010029,574,217,174,11,32,357,311,57,41,3,13,254,115,66,52,4,10,49,43,25,22,1,2,18,45,25,21,1,3,20,60,44,38,2,4,16
S01010030,704,501,428,27,46,203,130,33,28,1,4,97,119,88,72,5,11,31,78,53,43,1,9,25,88,69,58,1,10,19,289,258,227,19,12,31
S01010031,730,549,438,45,66,181,70,33,10,5,18,37,81,54,35,4,15,27,119,83,72,5,6,36,70,56,49,3,4,14,390,323,272,28,23,67
S01010032,804,479,371,24,84,325,99,21,11,2,8,78,113,49,33,3,13,64,124,83,65,2,16,41,201,115,78,9,28,86,267,211,184,8,19,56
S01010033,769,463,351,33,79,306,241,83,53,9,21,158,135,81,62,5,14,54,86,69,56,3,10,17,77,50,35,3,12,27,230,180,145,13,22,50
S01010034,882,431,354,15,62,451,342,69,47,2,20,273,146,95,75,4,16,51,111,72,60,3,9,39,121,81,71,0,10,40,162,114,101,6,7,48
S01010035,573,301,213,14,74,272,235,64,43,1,20,171,96,55,44,1,10,41,53,36,26,1,9,17,49,38,28,2,8,11,140,108,72,9,27,32
S01010036,767,572,446,46,80,195,39,24,15,6,3,15,63,43,33,1,9,20,160,102,78,5,19,58,129,101,85,9,7,28,376,302,235,25,42,74
S01010037,565,234,186,10,38,331,326,71,46,5,20,255,92,52,42,2,8,40,44,30,25,1,4,14,37,25,22,0,3,12,66,56,51,2,3,10
S01010038,867,448,366,32,50,419,380,101,76,12,13,279,149,98,84,2,12,51,103,70,61,6,3,33,89,65,52,5,8,24,146,114,93,7,14,32
S01010039,931,669,558,59,52,262,57,14,7,4,3,43,89,64,47,6,11,25,207,120,99,6,15,87,83,65,49,9,7,18,495,406,356,34,16,89
S01010040,666,484,388,46,50,182,137,56,42,4,10,81,115,80,55,7,18,35,104,81,71,6,4,23,84,71,56,7,8,13,226,196,164,22,10,30
S01010041,627,401,339,33,29,226,125,28,20,3,5,97,57,35,25,5,5,22,118,70,58,5,7,48,62,46,38,3,5,16,265,222,198,17,7,43
S01010042,974,717,583,44,90,257,174,67,40,6,21,107,184,140,103,13,24,44,127,100,88,6,6,27,137,119,95,3,21,18,352,291,257,16,18,61
S01010043,656,404,305,16,83,252,269,89,58,1,30,180,121,89,59,3,27,32,67,51,39,4,8,16,68,58,48,3,7,10,131,117,101,5,11,14
S01010044,993,584,485,37,62,409,388,96,67,7,22,292,204,142,124,6,12,62,89,68,58,4,6,21,92,82,66,8,8,10,220,196,170,12,14,24
S01010045,418,179,140,7,32,239,228,55,35,2,18,173,96,51,40,2,9,45,38,27,24,1,2,11,31,23,21,1,1,8,25,23,20,1,2,2
S01010046,647,349,268,33,48,298,292,86,58,15,13,206,177,118,92,6,20,59,48,36,25,4,7,12,44,36,31,1,4,8,86,73,62,7,4,13
S01010047,694,317,239,16,62,377,404,109,72,5,32,295,132,88,73,2,13,44,59,41,33,2,6,18,40,29,24,3,2,11,59,50,37,4,9,9
S01010048,810,388,306,18,64,422,422,111,82,5,24,311,180,124,93,2,29,56,84,55,45,3,7,29,52,40,35,1,4,12,72,58,51,7,0,14
S01010049,604,317,241,11,65,287,324,115,81,3,31,209,134,94,69,3,22,40,40,31,22,2,7,9,40,25,22,0,3,15,66,52,47,3,2,14
S01010050,807,373,287,15,71,434,424,107,75,2,30,317,164,115,85,6,24,49,67,42,31,3,8,25,54,40,36,0,4,14,98,69,60,4,5,29
S01010051,606,269,209,14,46,337,345,86,63,4,19,259,105,74,58,2,14,31,43,33,28,1,4,10,31,26,18,3,5,5,82,50,42,4,4,32
S01010052,555,305,235,12,58,250,266,93,64,5,24,173,114,70,54,0,16,44,47,31,24,1,6,16,40,36,30,0,6,4,88,75,63,6,6,13
S01010053,700,400,321,22,57,300,275,80,57,5,18,195,160,110,83,4,23,50,58,40,38,1,1,18,70,57,48,4,5,13,137,113,95,8,10,24
S01010054,411,200,142,6,52,211,247,89,58,3,28,158,99,60,39,2,19,39,17,14,13,0,1,3,21,17,14,0,3,4,27,20,18,1,1,7
S01010055,961,500,384,32,84,461,454,144,102,11,31,310,215,135,110,5,20,80,101,72,54,5,13,29,61,48,38,3,7,13,130,101,80,8,13,29
S01010056,360,202,157,13,32,158,178,76,56,5,15,102,115,75,58,5,12,40,23,17,13,2,2,6,25,19,18,0,1,6,19,15,12,1,2,4
S01010057,334,197,160,11,26,137,140,38,29,3,6,102,75,61,45,2,14,14,30,24,20,2,2,6,31,26,24,1,1,5,58,48,42,3,3,10
S01010058,613,366,297,18,51,247,274,121,93,4,24,153,154,100,78,6,16,54,61,49,43,1,5,12,46,39,35,3,1,7,78,57,48,4,5,21
S01010059,548,372,304,23,45,176,178,67,43,6,18,111,127,102,81,8,13,25,59,44,39,2,3,15,62,56,49,1,6,6,122,103,92,6,5,19
S01010060,768,444,357,28,59,324,345,134,101,13,20,211,164,108,82,7,19,56,91,72,63,1,8,19,60,45,36,2,7,15,108,85,75,5,5,23
S01010061,419,295,240,24,31,124,125,49,33,5,11,76,107,89,72,6,11,18,62,48,40,4,4,14,56,48,38,5,5,8,69,61,57,4,0,8
S01010062,594,319,244,28,47,275,253,75,56,6,13,178,155,99,76,7,16,56,62,54,42,4,8,8,59,44,37,3,4,15,65,47,33,8,6,18
S01010063,854,475,361,25,89,379,390,131,91,7,33,259,212,151,109,9,33,61,77,52,38,6,8,25,66,52,46,0,6,14,109,89,77,3,9,20
S01010064,442,260,214,17,29,182,174,57,42,5,10,117,109,79,64,6,9,30,63,43,37,3,3,20,44,38,36,1,1,6,52,43,35,2,6,9
S01010065,709,372,314,21,37,337,373,129,102,9,18,244,170,113,91,8,14,57,66,56,52,0,4,10,42,35,31,4,0,7,58,39,38,0,1,19
S01010066,608,301,227,20,54,307,297,91,66,8,17,206,161,108,79,3,26,53,55,40,32,3,5,15,45,32,27,1,4,13,50,30,23,5,2,20
S01010067,468,255,170,14,71,213,246,91,55,5,31,155,109,76,50,2,24,33,39,27,18,2,7,12,39,35,27,3,5,4,35,26,20,2,4,9
S01010068,524,316,259,25,32,208,189,50,31,12,7,139,114,82,69,6,7,32,67,58,52,1,5,9,48,45,38,2,5,3,106,81,69,4,8,25
S01010069,698,511,442,47,22,187,203,97,80,13,4,106,183,146,123,15,8,37,117,99,88,6,5,18,84,69,62,4,3,15,111,100,89,9,2,11
S01010070,556,431,368,48,15,125,140,82,62,19,1,58,174,150,129,13,8,24,109,94,84,6,4,15,55,47,42,4,1,8,78,58,51,6,1,20
S01010071,680,399,320,47,32,281,254,82,62,14,6,172,173,126,89,18,19,47,84,61,55,4,2,23,68,54,45,7,2,14,101,76,69,4,3,25
S01010072,693,421,358,29,34,272,296,119,100,9,10,177,152,110,91,7,12,42,105,81,68,3,10,24,52,43,40,1,2,9,88,68,59,9,0,20
S01010073,671,383,339,33,11,288,241,65,48,14,3,176,138,94,82,10,2,44,108,80,71,6,3,28,53,45,43,1,1,8,131,99,95,2,2,32
S01010074,694,385,326,37,22,309,228,69,55,12,2,159,153,94,78,9,7,59,96,74,65,5,4,22,69,53,47,2,4,16,148,95,81,9,5,53
S01010075,541,252,215,12,25,289,291,83,66,6,11,208,114,70,62,2,6,44,51,40,32,3,5,11,42,32,30,0,2,10,43,27,25,1,1,16
S01010076,553,333,272,29,32,220,226,81,62,9,10,145,163,118,93,7,18,45,66,50,43,4,3,16,41,36,33,3,0,5,57,48,41,6,1,9
S01010077,511,260,214,24,22,251,259,81,64,9,8,178,116,83,70,6,7,33,54,36,27,3,6,18,28,24,22,1,1,4,54,36,31,5,0,18
S01010078,510,364,311,33,20,146,133,61,49,9,3,72,138,111,95,8,8,27,98,77,66,5,6,21,45,38,33,4,1,7,96,77,68,7,2,19
S01010079,793,501,397,83,21,292,201,58,35,21,2,143,157,105,81,20,4,52,144,107,88,13,6,37,70,56,47,6,3,14,221,175,146,23,6,46
S01010080,577,328,273,37,18,249,175,55,38,14,3,120,131,82,64,11,7,49,75,55,49,3,3,20,71,50,46,3,1,21,125,86,76,6,4,39
S01010081,617,349,272,63,14,268,185,64,46,15,3,121,115,69,54,11,4,46,95,65,52,11,2,30,77,54,42,11,1,23,145,97,78,15,4,48
S01010082,742,467,369,62,36,275,202,58,43,8,7,144,188,136,106,18,12,52,103,78,59,8,11,25,82,63,45,15,3,19,167,132,116,13,3,35
S01010083,609,311,247,23,41,298,277,83,60,10,13,194,157,102,83,4,15,55,88,63,53,4,6,25,46,34,28,1,5,12,41,29,23,4,2,12
S01010084,750,390,334,16,40,360,337,92,75,4,13,245,197,130,114,5,11,67,87,70,61,5,4,17,69,57,51,0,6,12,60,41,33,2,6,19
S01010085,657,415,352,35,28,242,201,80,59,12,9,121,135,96,80,6,10,39,120,93,78,9,6,27,75,53,49,3,1,22,126,93,86,5,2,33
S01010086,778,391,314,25,52,387,393,129,104,7,18,264,217,140,108,9,23,77,81,59,50,5,4,22,51,38,33,2,3,13,36,25,19,2,4,11
S01010087,506,284,228,43,13,222,150,44,30,12,2,106,131,84,62,17,5,47,72,49,41,5,3,23,56,36,29,5,2,20,97,71,66,4,1,26
S01010088,612,525,428,77,20,87,95,58,39,16,3,37,150,121,92,20,9,29,76,65,55,8,2,11,77,74,63,9,2,3,214,207,179,24,4,7
S01010089,618,336,277,26,33,282,247,77,60,8,9,170,165,116,95,11,10,49,69,47,35,6,6,22,63,50,45,0,5,13,74,46,42,1,3,28
S01010090,875,617,532,52,33,258,240,91,72,9,10,149,211,176,148,15,13,35,158,124,106,14,4,34,95,85,80,3,2,10,171,141,126,11,4,30
S01010091,674,529,429,56,44,145,167,94,69,16,9,73,174,151,120,14,17,23,99,82,66,7,9,17,85,72,58,8,6,13,149,130,116,11,3,19
S01010092,822,355,292,21,42,467,420,97,72,10,15,323,181,104,82,4,18,77,75,47,39,5,3,28,55,41,36,0,5,14,91,66,63,2,1,25
S01010093,731,475,393,41,41,256,231,90,62,17,11,141,171,116,97,8,11,55,115,90,72,7,11,25,87,73,67,3,3,14,127,106,95,6,5,21
S01010094,564,357,312,28,17,207,175,59,51,6,2,116,141,104,88,8,8,37,73,57,53,1,3,16,62,53,47,4,2,9,113,84,73,9,2,29
S01010095,594,394,332,40,22,200,151,60,44,14,2,91,162,116,96,14,6,46,100,77,66,7,4,23,65,52,50,1,1,13,116,89,76,4,9,27
S01010096,617,419,356,35,28,198,138,52,44,7,1,86,187,136,109,16,11,51,116,86,73,9,4,30,56,45,36,1,8,11,120,100,94,2,4,20
S01010097,603,387,316,35,36,216,176,64,49,8,7,112,162,112,91,7,14,50,97,78,60,11,7,19,70,58,51,3,4,12,98,75,65,6,4,23
S01010098,600,392,329,41,22,208,164,63,47,11,5,101,159,115,99,11,5,44,109,87,71,7,9,22,59,45,39,5,1,14,109,82,73,7,2,27
S01010099,592,363,306,37,20,229,156,46,37,7,2,110,124,84,68,10,6,40,115,90,75,10,5,25,72,51,43,4,4,21,125,92,83,6,3,33
S01010100,766,442,373,49,20,324,277,91,69,16,6,186,197,138,114,16,8,59,109,75,67,5,3,34,74,51,48,2,1,23,109,87,75,10,2,22
S01010101,644,402,341,37,24,242,252,100,79,13,8,152,158,114,93,12,9,44,93,76,62,8,6,17,56,47,45,2,0,9,85,65,62,2,1,20
S01010102,749,592,516,44,32,157,146,90,73,9,8,56,193,160,136,17,7,33,157,121,107,7,7,36,72,64,58,2,4,8,181,157,142,9,6,24
S01010103,774,637,518,77,42,137,158,101,76,17,8,57,235,206,159,34,13,29,143,123,96,15,12,20,89,76,70,3,3,13,149,131,117,8,6,18
S01010104,554,458,387,47,24,96,102,67,51,13,3,35,159,130,102,15,13,29,99,82,71,7,4,17,80,74,64,8,2,6,114,105,99,4,2,9
S01010105,313,205,161,7,37,108,133,65,46,3,16,68,90,66,47,3,16,24,41,34,32,0,2,7,28,24,23,0,1,4,21,16,13,1,2,5
S01010106,357,183,144,10,29,174,190,76,54,6,16,114,97,61,49,1,11,36,34,20,17,1,2,14,14,9,9,0,0,5,22,17,15,2,0,5
S01010107,647,378,301,26,51,269,270,122,94,6,22,148,183,127,99,7,21,56,113,63,51,7,5,50,33,27,22,2,3,6,48,39,35,4,0,9
S01010108,623,367,297,34,36,256,340,143,117,13,13,197,126,89,71,7,11,37,55,49,39,4,6,6,61,52,42,6,4,9,41,34,28,4,2,7
S01010109,659,404,326,27,51,255,266,103,83,6,14,163,161,124,92,9,23,37,73,54,44,5,5,19,58,43,37,2,4,15,101,80,70,5,5,21
S01010110,684,322,254,14,54,362,412,136,105,6,25,276,144,92,68,2,22,52,46,32,28,2,2,14,48,36,31,2,3,12,34,26,22,2,2,8
S01010111,754,388,276,23,89,366,394,138,97,5,36,256,206,127,88,6,33,79,62,45,32,3,10,17,50,43,33,3,7,7,42,35,26,6,3,7
S01010112,728,399,290,21,88,329,344,135,97,6,32,209,208,137,98,7,32,71,73,50,37,2,11,23,57,46,33,1,12,11,46,31,25,5,1,15
S01010113,395,225,169,10,46,170,179,71,53,4,14,108,115,73,48,5,20,42,44,31,25,0,6,13,25,22,18,0,4,3,32,28,25,1,2,4
S01010114,614,289,216,10,63,325,334,114,90,3,21,220,164,98,64,2,32,66,52,31,25,2,4,21,31,24,18,1,5,7,33,22,19,2,1,11
S01010115,486,359,293,38,28,127,182,110,80,19,11,72,147,120,98,12,10,27,58,46,40,3,3,12,58,49,44,2,3,9,41,34,31,2,1,7
S01010116,794,618,527,45,46,176,204,124,97,18,9,80,224,182,158,6,18,42,121,101,88,5,8,20,108,97,86,6,5,11,137,114,98,10,6,23
S01010117,502,397,327,44,26,105,96,50,33,10,7,46,130,105,82,13,10,25,58,50,45,5,0,8,56,50,46,3,1,6,162,142,121,13,8,20
S01010118,478,228,162,9,57,250,281,98,69,3,26,183,108,73,46,4,23,35,35,21,17,0,4,14,29,16,13,0,3,13,25,20,17,2,1,5
S01010119,389,265,196,10,59,124,164,87,51,4,32,77,110,80,61,3,16,30,44,35,35,0,0,9,33,30,24,0,6,3,38,33,25,3,5,5
S01010120,772,423,303,15,105,349,411,165,114,7,44,246,187,130,85,7,38,57,71,49,41,0,8,22,58,46,35,1,10,12,45,33,28,0,5,12
S01010121,532,291,218,15,58,241,286,112,73,6,33,174,140,105,82,7,16,35,45,32,27,1,4,13,40,27,22,1,4,13,21,15,14,0,1,6
S01010122,380,162,113,6,43,218,234,63,44,1,18,171,74,48,29,2,17,26,33,25,18,2,5,8,20,15,12,1,2,5,19,11,10,0,1,8
S01010123,535,324,260,11,53,211,228,84,61,3,20,144,147,113,90,2,21,34,61,46,39,2,5,15,51,42,35,2,5,9,48,39,35,2,2,9
S01010124,506,368,307,23,38,138,138,82,65,5,12,56,164,124,99,8,17,40,77,55,49,0,6,22,56,49,44,4,1,7,71,58,50,6,2,13
S01010125,402,253,200,19,34,149,159,73,58,2,13,86,110,74,50,10,14,36,49,38,33,2,3,11,35,27,22,2,3,8,49,41,37,3,1,8
S01010126,593,394,318,41,35,199,244,104,83,10,11,140,177,141,112,16,13,36,79,65,56,6,3,14,53,47,37,5,5,6,40,37,30,4,3,3
S01010127,526,258,203,16,39,268,268,71,55,5,11,197,118,76,60,4,12,42,61,48,41,2,5,13,37,31,21,3,7,6,42,32,26,2,4,10
S01010128,343,181,132,5,44,162,157,57,34,3,20,100,104,65,44,1,20,39,30,18,16,0,2,12,31,22,20,1,1,9,21,19,18,0,1,2
S01010129,550,294,207,8,79,256,275,113,67,4,42,162,155,101,69,2,30,54,40,28,24,1,3,12,37,25,23,1,1,12,43,27,24,0,3,16
S01010130,341,158,121,13,24,183,180,48,35,3,10,132,88,60,43,5,12,28,30,22,21,0,1,8,23,17,16,1,0,6,20,11,6,4,1,9
S01010131,840,511,414,67,30,329,295,94,74,14,6,201,209,154,120,21,13,55,126,100,88,8,4,26,89,77,62,11,4,12,121,86,70,13,3,35
S01010132,809,359,281,16,62,450,425,103,76,8,19,322,197,118,84,3,31,79,70,46,40,0,6,24,48,39,38,0,1,9,69,53,43,5,5,16
S01010133,607,270,215,15,40,337,322,85,59,6,20,237,126,76,62,3,11,50,61,41,35,2,4,20,40,29,26,0,3,11,58,39,33,4,2,19
S01010134,840,425,346,30,49,415,438,129,99,7,23,309,194,125,95,11,19,69,82,62,54,5,3,20,50,42,39,0,3,8,76,67,59,7,1,9
S01010135,639,297,251,13,33,342,340,114,99,3,12,226,151,83,64,4,15,68,60,43,35,5,3,17,39,23,21,1,1,16,49,34,32,0,2,15
S01010136,679,405,335,32,38,274,260,89,67,7,15,171,197,139,115,10,14,58,78,54,48,1,5,24,57,51,42,8,1,6,87,72,63,6,3,15
S01010137,849,400,331,21,48,449,399,80,65,5,10,319,176,114,94,5,15,62,92,67,56,3,8,25,74,62,48,3,11,12,108,77,68,5,4,31
S01010138,841,352,233,21,98,489,417,95,54,7,34,322,195,128,84,8,36,67,69,36,28,2,6,33,59,32,25,1,6,27,101,61,42,3,16,40
S01010139,897,466,375,29,62,431,419,123,95,7,21,296,203,142,111,10,21,61,108,79,68,5,6,29,74,57,46,1,10,17,93,65,55,6,4,28
S01010140,596,452,381,26,45,144,159,83,64,4,15,76,208,170,142,10,18,38,70,58,50,4,4,12,53,43,38,4,1,10,106,98,87,4,7,8
S01010141,662,333,264,20,49,329,341,115,87,5,23,226,139,85,65,5,15,54,64,44,40,4,0,20,45,34,28,2,4,11,73,55,44,4,7,18
S01010142,491,308,234,24,50,183,198,85,57,8,20,113,122,89,66,6,17,33,68,54,45,4,5,14,53,45,38,1,6,8,50,35,28,5,2,15
S01010143,632,301,250,25,26,331,335,97,78,12,7,238,139,80,71,3,6,59,55,47,35,2,10,8,51,38,32,5,1,13,52,39,34,3,2,13
S01010144,575,390,309,24,57,185,179,79,51,8,20,100,158,112,95,6,11,46,71,57,48,1,8,14,62,51,35,4,12,11,105,91,80,5,6,14
S01010145,650,379,309,27,43,271,245,90,71,11,8,155,189,134,106,9,19,55,60,36,29,1,6,24,62,43,34,4,5,19,94,76,69,2,5,18
S01010146,627,394,282,22,90,233,271,112,78,7,27,159,176,129,88,4,37,47,59,49,36,4,9,10,58,52,43,3,6,6,63,52,37,4,11,11
S01010147,746,410,287,26,97,336,350,138,88,7,43,212,228,144,95,7,42,84,69,46,35,4,7,23,48,39,34,0,5,9,51,43,35,8,0,8
S01010148,601,317,235,15,67,284,322,123,86,9,28,199,132,86,59,1,26,46,43,30,26,1,3,13,46,34,27,2,5,12,58,44,37,2,5,14
S01010149,496,296,254,29,13,200,205,52,40,8,4,153,111,91,71,14,6,20,58,46,41,4,1,12,43,37,35,1,1,6,79,70,67,2,1,9
S01010150,540,234,181,21,32,306,324,83,60,10,13,241,103,66,50,6,10,37,58,38,32,3,3,20,26,21,15,2,4,5,29,26,24,0,2,3
S01010151,550,216,167,10,39,334,322,68,48,3,17,254,121,73,56,5,12,48,39,29,25,0,4,10,33,22,15,2,5,11,35,24,23,0,1,11
S01010152,736,393,323,17,53,343,353,100,80,8,12,253,153,117,97,1,19,36,93,72,58,1,13,21,59,43,38,2,3,16,78,61,50,5,6,17
S01010153,825,386,317,26,43,439,422,108,84,12,12,314,176,117,89,8,20,59,72,49,42,1,6,23,67,54,49,2,3,13,88,58,53,3,2,30
S01010154,783,310,273,11,26,473,431,93,83,4,6,338,164,94,80,4,10,70,68,35,33,0,2,33,49,38,32,2,4,11,71,50,45,1,4,21
S01010155,664,298,245,22,31,366,346,84,71,5,8,262,167,107,82,7,18,60,58,35,29,2,4,23,31,28,27,0,1,3,62,44,36,8,0,18
S01010156,477,218,163,24,31,259,259,72,47,10,15,187,93,56,41,6,9,37,48,36,30,2,4,12,25,16,13,2,1,9,52,38,32,4,2,14
S01010157,487,228,153,10,65,259,282,82,54,4,24,200,121,80,49,2,29,41,35,29,20,2,7,6,23,15,11,1,3,8,26,22,19,1,2,4
S01010158,790,387,321,24,42,403,390,95,75,7,13,295,184,125,109,6,10,59,69,54,42,6,6,15,62,50,41,1,8,12,85,63,54,4,5,22
S01010159,628,282,232,24,26,346,328,70,62,5,3,258,123,83,63,8,12,40,72,52,44,4,4,20,47,31,26,1,4,16,58,46,37,6,3,12
S01010160,473,272,178,26,68,201,187,76,40,7,29,111,90,64,30,7,27,26,39,24,17,5,2,15,67,36,32,2,2,31,90,72,59,5,8,18
S01010161,484,332,269,27,36,152,191,92,71,5,16,99,151,120,96,13,11,31,64,51,44,5,2,13,29,25,24,1,0,4,49,44,34,3,7,5
S01010162,639,310,205,13,92,329,325,97,50,6,41,228,173,109,74,2,33,64,44,32,23,1,8,12,50,32,25,2,5,18,47,40,33,2,5,7
S01010163,465,234,176,13,45,231,216,64,42,7,15,152,123,72,58,1,13,51,48,38,27,0,11,10,43,31,27,1,3,12,35,29,22,4,3,6
S01010164,628,314,242,24,48,314,324,99,70,9,20,225,153,105,78,8,19,48,66,46,40,2,4,20,39,32,26,4,2,7,46,32,28,1,3,14
S01010165,490,256,194,7,55,234,242,87,70,1,16,155,121,80,55,1,24,41,45,36,26,2,8,9,37,26,24,0,2,11,45,27,19,3,5,18
S01010166,606,314,255,18,41,292,329,108,83,7,18,221,135,99,75,8,16,36,65,49,45,1,3,16,40,26,23,0,3,14,37,32,29,2,1,5
S01010167,692,302,231,16,55,390,414,110,81,7,22,304,150,92,68,5,19,58,50,37,30,1,6,13,43,32,26,1,5,11,35,31,26,2,3,4
S01010168,397,261,200,20,41,136,163,66,41,6,19,97,114,91,73,8,10,23,52,45,35,3,7,7,31,25,19,2,4,6,37,34,32,1,1,3
S01010169,666,412,313,28,71,254,296,121,80,7,34,175,202,150,110,11,29,52,56,45,38,3,4,11,55,49,44,2,3,6,57,47,41,5,1,10
S01010170,435,253,201,17,35,182,210,84,68,6,10,126,120,87,60,8,19,33,41,35,31,1,3,6,34,28,28,0,0,6,30,19,14,2,3,11
S01010171,783,399,278,12,109,384,440,149,86,10,53,291,188,132,86,2,44,56,63,47,38,0,9,16,51,39,37,0,2,12,41,32,31,0,1,9
S01010172,624,271,217,20,34,353,341,69,50,6,13,272,94,58,42,4,12,36,58,42,37,1,4,16,39,30,25,1,4,9,92,72,63,8,1,20
S01010173,639,333,275,27,31,306,283,85,70,6,9,198,149,94,72,9,13,55,77,55,49,3,3,22,45,33,27,5,1,12,85,66,57,4,5,19
S01010174,1309,382,298,29,55,927,588,84,60,8,16,504,391,126,93,11,22,265,134,67,58,3,6,67,91,47,39,3,5,44,105,58,48,4,6,47
S01010175,384,214,174,14,26,170,169,59,47,2,10,110,103,72,56,6,10,31,37,21,18,2,1,16,31,28,24,2,2,3,44,34,29,2,3,10
S01010176,590,279,231,20,28,311,292,76,58,4,14,216,122,79,63,8,8,43,50,35,31,3,1,15,51,40,34,4,2,11,75,49,45,1,3,26
S01010177,571,308,213,16,79,263,283,113,72,6,35,170,173,106,71,6,29,67,47,29,21,2,6,18,32,30,24,1,5,2,36,30,25,1,4,6
S01010178,739,415,303,16,96,324,359,140,81,8,51,219,198,133,104,3,26,65,72,53,45,0,8,19,59,51,42,2,7,8,51,38,31,3,4,13
S01010179,690,345,275,11,59,345,412,154,124,1,29,258,139,93,78,2,13,46,48,38,32,1,5,10,31,27,21,2,4,4,60,33,20,5,8,27
S01010180,399,294,232,24,38,105,141,75,53,8,14,66,80,64,54,5,5,16,36,33,27,0,6,3,54,44,32,8,4,10,88,78,66,3,9,10
S01010181,489,254,175,19,60,235,263,95,53,11,31,168,122,80,54,6,20,42,43,36,31,0,5,7,26,18,17,0,1,8,35,25,20,2,3,10
S01010182,580,411,342,43,26,169,196,99,74,20,5,97,129,99,85,9,5,30,79,65,57,4,4,14,69,63,55,2,6,6,107,85,71,8,6,22
S01010183,391,182,145,10,27,209,215,58,43,4,11,157,91,63,46,5,12,28,33,23,22,0,1,10,23,19,18,0,1,4,29,19,16,1,2,10
S01010184,517,280,212,11,57,237,268,97,71,4,22,171,132,95,67,3,25,37,42,34,27,2,5,8,32,23,21,1,1,9,43,31,26,1,4,12
S01010185,487,265,203,16,46,222,254,85,63,5,17,169,138,101,72,6,23,37,42,34,28,2,4,8,29,23,20,2,1,6,24,22,20,1,1,2
S01010186,523,369,308,35,26,154,160,87,69,14,4,73,147,113,92,6,15,34,75,60,52,4,4,15,36,28,26,1,1,8,105,81,69,10,2,24
S01010187,548,416,357,31,28,132,158,81,68,7,6,77,154,130,114,9,7,24,95,82,69,5,8,13,59,54,42,5,7,5,82,69,64,5,0,13
S01010188,610,426,351,50,25,184,158,63,43,13,7,95,125,97,81,13,3,28,103,81,66,10,5,22,80,64,58,4,2,16,144,121,103,10,8,23
S01010189,739,612,518,64,30,127,124,81,67,10,4,43,196,171,139,19,13,25,117,93,79,7,7,24,104,88,76,9,3,16,198,179,157,19,3,19
S01010190,581,476,379,70,27,105,85,54,34,14,6,31,112,93,61,22,10,19,103,84,70,10,4,19,56,48,41,5,2,8,225,197,173,19,5,28
S01010191,531,415,343,53,19,116,119,64,50,13,1,55,142,116,96,13,7,26,80,66,55,9,2,14,70,59,48,9,2,11,120,110,94,9,7,10
S01010192,631,507,436,44,27,124,134,83,66,14,3,51,156,124,99,12,13,32,100,84,75,6,3,16,85,74,69,2,3,11,156,142,127,10,5,14
S01010193,685,432,358,55,19,253,179,68,55,8,5,111,158,118,97,16,5,40,90,68,54,12,2,22,79,66,58,6,2,13,179,112,94,13,5,67
S01010194,548,284,226,18,40,264,262,76,59,6,11,186,129,87,73,4,10,42,68,50,38,6,6,18,48,40,30,1,9,8,41,31,26,1,4,10
S01010195,431,238,191,18,29,193,200,72,58,5,9,128,99,68,56,5,7,31,63,48,38,3,7,15,28,20,16,1,3,8,41,30,23,4,3,11
S01010196,634,318,244,9,65,316,320,97,73,2,22,223,145,99,68,5,26,46,56,41,33,0,8,15,60,43,36,1,6,17,53,38,34,1,3,15
S01010197,548,311,254,10,47,237,282,117,92,4,21,165,113,78,59,2,17,35,72,50,42,0,8,22,42,36,32,3,1,6,39,30,29,1,0,9
S01010198,850,411,316,29,66,439,474,149,113,11,25,325,189,125,94,2,29,64,73,49,39,6,4,24,62,46,38,3,5,16,52,42,32,7,3,10
S01010199,412,236,175,7,54,176,213,83,60,2,21,130,105,76,56,2,18,29,41,34,26,1,7,7,28,21,17,0,4,7,25,22,16,2,4,3
S01010200,580,290,239,20,31,290,313,88,75,5,8,225,153,107,86,10,11,46,51,43,34,2,7,8,31,25,21,2,2,6,32,27,23,1,3,5
S01010201,511,320,270,21,29,191,222,92,75,7,10,130,160,124,100,10,14,36,51,43,40,1,2,8,50,38,33,2,3,12,28,23,22,1,0,5
S01010202,535,288,189,12,87,247,262,109,58,5,46,153,152,100,70,1,29,52,44,34,24,1,9,10,34,20,16,1,3,14,43,25,21,4,0,18
S01010203,517,397,338,32,27,120,146,77,61,10,6,69,152,127,107,8,12,25,83,67,56,5,6,16,55,48,45,2,1,7,81,78,69,7,2,3
S01010204,628,314,245,8,61,314,342,125,100,3,22,217,139,90,64,1,25,49,59,35,29,1,5,24,39,25,19,2,4,14,49,39,33,1,5,10
S01010205,568,317,266,21,30,251,263,93,73,7,13,170,130,94,76,4,14,36,57,43,41,2,0,14,39,29,22,5,2,10,79,58,54,3,1,21
S01010206,341,72,40,3,29,269,151,23,11,0,12,128,61,15,8,2,5,46,19,5,1,0,4,14,34,7,5,1,1,27,76,22,15,0,7,54
S01010207,476,193,123,12,58,283,203,49,33,4,12,154,125,64,35,4,25,61,33,17,10,0,7,16,49,26,22,2,2,23,66,37,23,2,12,29
S01010208,794,521,438,33,50,273,281,107,88,7,12,174,161,121,94,7,20,40,97,84,69,8,7,13,92,69,57,8,4,23,163,140,130,3,7,23
S01010209,820,425,334,24,67,395,397,116,84,5,27,281,177,117,86,10,21,60,62,50,44,1,5,12,57,42,32,3,7,15,127,100,88,5,7,27
S01010210,753,392,327,23,42,361,325,87,69,4,14,238,164,109,86,6,17,55,83,54,47,5,2,29,72,56,51,3,2,16,109,86,74,5,7,23
S01010211,713,318,252,11,55,395,393,109,83,3,23,284,149,87,65,2,20,62,66,43,36,1,6,23,49,37,31,2,4,12,56,42,37,3,2,14
S01010212,877,427,329,15,83,450,434,131,91,2,38,303,221,138,107,4,27,83,72,50,43,1,6,22,53,40,33,5,2,13,97,68,55,3,10,29
S01010213,796,389,340,13,36,407,435,136,119,4,13,299,188,124,109,5,10,64,60,42,36,1,5,18,54,38,35,1,2,16,59,49,41,2,6,10
S01010214,800,483,412,28,43,317,302,101,86,6,9,201,200,153,126,9,18,47,106,85,67,8,10,21,70,55,49,3,3,15,122,89,84,2,3,33
S01010215,705,309,238,11,60,396,376,98,70,5,23,278,164,97,77,1,19,67,45,27,21,1,5,18,58,39,32,1,6,19,62,48,38,3,7,14
S01010216,528,254,196,19,39,274,279,77,54,6,17,202,111,76,55,4,17,35,37,23,19,3,1,14,41,30,26,1,3,11,60,48,42,5,1,12
S01010217,622,366,267,12,87,256,238,103,73,1,29,135,165,105,67,5,33,60,56,40,32,1,7,16,49,38,28,2,8,11,114,80,67,3,10,34
S01010218,839,542,419,34,89,297,312,120,80,8,32,192,197,154,116,7,31,43,97,74,56,6,12,23,85,67,58,4,5,18,148,127,109,9,9,21
S01010219,400,227,164,8,55,173,137,52,34,1,17,85,65,36,20,1,15,29,30,19,8,0,11,11,48,31,26,1,4,17,120,89,76,5,8,31
S01010220,434,352,288,51,13,82,32,24,19,2,3,8,45,35,27,6,2,10,52,40,35,4,1,12,65,42,38,4,0,23,240,211,169,35,7,29
S01010221,470,199,154,6,39,271,241,62,44,1,17,179,96,59,44,1,14,37,29,20,17,0,3,9,31,17,16,0,1,14,73,41,33,4,4,32
S01010222,437,275,223,11,41,162,170,64,44,4,16,106,98,72,56,3,13,26,52,38,35,0,3,14,46,40,35,1,4,6,71,61,53,3,5,10
S01010223,495,262,205,19,38,233,231,74,53,3,18,157,109,65,52,8,5,44,43,36,27,3,6,7,42,36,29,2,5,6,70,51,44,3,4,19
S01010224,799,406,294,24,88,393,396,125,81,7,37,271,197,133,97,5,31,64,47,27,21,0,6,20,64,47,36,2,9,17,95,74,59,10,5,21
S01010225,664,380,315,14,51,284,253,86,67,5,14,167,163,106,85,3,18,57,75,52,48,1,3,23,58,47,34,1,12,11,115,89,81,4,4,26
S01010226,589,316,207,32,77,273,204,74,42,7,25,130,128,74,46,7,21,54,56,34,25,1,8,22,70,43,33,2,8,27,131,91,61,15,15,40
S01010227,466,243,152,17,74,223,184,66,35,2,29,118,78,33,18,2,13,45,46,28,20,0,8,18,48,38,20,1,17,10,110,78,59,12,7,32
S01010228,615,258,211,10,37,357,365,80,63,4,13,285,131,91,69,3,19,40,49,36,36,0,0,13,32,24,20,2,2,8,38,27,23,1,3,11
S01010229,827,497,408,29,60,330,414,173,143,8,22,241,197,139,109,7,23,58,81,67,54,5,8,14,62,50,46,1,3,12,73,68,56,8,4,5
S01010230,834,443,314,11,118,391,372,111,62,3,46,261,144,94,64,1,29,50,42,25,24,1,0,17,88,65,54,1,10,23,188,148,110,5,33,40
S01010231,782,448,345,24,79,334,363,131,97,6,28,232,170,126,96,3,27,44,64,50,40,0,10,14,73,59,50,4,5,14,112,82,62,11,9,30
S01010232,805,509,368,24,117,296,297,135,99,7,29,162,209,143,104,6,33,66,73,56,37,4,15,17,81,60,40,2,18,21,145,115,88,5,22,30
S01010233,738,398,276,13,109,340,344,126,77,6,43,218,163,100,69,3,28,63,54,33,23,0,10,21,66,50,37,2,11,16,111,89,70,2,17,22
S01010234,868,552,459,56,37,316,224,62,51,4,7,162,82,51,40,4,7,31,109,73,63,3,7,36,82,61,54,4,3,21,371,305,251,41,13,66
S01010235,837,592,522,28,42,245,122,18,15,0,3,104,63,45,34,4,7,18,148,106,94,4,8,42,73,65,53,5,7,8,431,358,326,15,17,73
S01010236,652,452,367,44,41,200,105,38,27,4,7,67,92,57,45,3,9,35,95,67,55,5,7,28,79,62,50,5,7,17,281,228,190,27,11,53
S01010237,575,411,338,46,27,164,109,40,34,2,4,69,75,53,39,5,9,22,83,57,43,9,5,26,51,44,36,5,3,7,257,217,186,25,6,40
S01010238,744,523,430,44,49,221,173,55,44,3,8,118,105,78,60,4,14,27,119,90,76,5,9,29,77,68,58,7,3,9,270,232,192,25,15,38
S01010239,674,369,301,15,53,305,301,98,67,5,26,203,119,78,62,3,13,41,70,42,34,1,7,28,54,43,39,1,3,11,130,108,99,5,4,22
S01010240,616,396,335,23,38,220,174,48,39,0,9,126,100,68,56,4,8,32,86,64,55,2,7,22,56,47,40,3,4,9,200,169,145,14,10,31
S01010241,936,584,454,47,83,352,309,82,57,5,20,227,131,94,67,5,22,37,111,93,71,7,15,18,98,80,58,8,14,18,287,235,201,22,12,52
S01010242,656,436,345,24,67,220,196,80,54,8,18,116,143,89,70,3,16,54,91,71,57,3,11,20,67,59,47,1,11,8,159,137,117,9,11,22
S01010243,848,568,416,32,120,280,262,116,83,4,29,146,173,126,85,8,33,47,145,103,76,2,25,42,76,62,42,3,17,14,192,161,130,15,16,31
S01010244,633,325,220,19,86,308,287,104,62,6,36,183,120,75,47,2,26,45,60,36,28,2,6,24,56,42,29,4,9,14,110,68,54,5,9,42
S01010245,784,364,246,21,97,420,483,164,110,8,46,319,167,106,68,3,35,61,45,24,19,2,3,21,41,35,27,0,8,6,48,35,22,8,5,13
S01010246,678,362,286,18,58,316,317,114,82,4,28,203,158,107,86,5,16,51,60,32,24,1,7,28,49,31,25,3,3,18,94,78,69,5,4,16
S01010247,647,396,339,26,31,251,292,100,82,8,10,192,160,134,117,8,9,26,65,48,35,8,5,17,51,45,41,2,2,6,79,69,64,0,5,10
S01010248,778,565,463,53,49,213,134,36,25,6,5,98,74,58,41,6,11,16,125,75,64,2,9,50,75,62,53,4,5,13,370,334,280,35,19,36
S01010249,634,445,368,24,53,189,122,41,29,1,11,81,97,72,57,1,14,25,125,85,70,2,13,40,61,51,42,1,8,10,229,196,170,19,7,33
S01010250,700,521,430,46,45,179,84,26,24,1,1,58,63,46,36,5,5,17,147,91,71,6,14,56,81,69,60,6,3,12,325,289,239,28,22,36
S01010251,566,433,370,31,32,133,35,12,6,4,2,23,60,48,41,5,2,12,112,70,56,5,9,42,81,69,61,1,7,12,278,234,206,16,12,44
S01010252,543,375,322,32,21,168,101,29,23,2,4,72,84,45,34,4,7,39,70,52,47,2,3,18,53,46,38,5,3,7,235,203,180,19,4,32
S01010253,527,265,202,8,55,262,218,66,44,2,20,152,102,63,47,2,14,39,57,43,32,0,11,14,44,34,31,0,3,10,106,59,48,4,7,47
S01010254,933,526,452,21,53,407,378,90,70,4,16,288,176,118,97,3,18,58,113,83,72,5,6,30,81,72,62,4,6,9,185,163,151,5,7,22
S01010255,558,311,216,15,80,247,235,70,42,4,24,165,116,77,52,3,22,39,49,37,24,1,12,12,52,37,31,1,5,15,106,90,67,6,17,16
S01010256,721,410,292,37,81,311,296,102,70,5,27,194,187,131,86,12,33,56,73,45,35,3,7,28,74,57,44,7,6,17,91,75,57,10,8,16
S01010257,793,389,291,30,68,404,134,34,23,3,8,100,99,52,33,4,15,47,160,78,54,6,18,82,79,53,36,6,11,26,321,172,145,11,16,149
S01010258,1469,576,430,34,112,893,31,10,7,2,1,21,132,35,23,3,9,97,428,167,114,6,47,261,120,51,36,5,10,69,758,313,250,18,45,445
S01010259,1163,456,315,20,121,707,292,81,56,4,21,211,205,85,56,4,25,120,303,136,95,4,37,167,96,55,35,3,17,41,267,99,73,5,21,168
S01010260,1827,808,588,72,148,1019,170,55,40,5,10,115,209,78,48,8,22,131,638,256,175,8,73,382,148,78,58,6,14,70,662,341,267,45,29,321
S01010261,2469,932,598,22,312,1537,327,63,45,2,16,264,256,97,58,3,36,159,1047,469,302,6,161,578,236,113,73,3,37,123,603,190,120,8,62,413
S01010262,811,319,244,16,59,492,411,94,71,1,22,317,113,48,34,3,11,65,120,83,63,6,14,37,35,18,14,0,4,17,132,76,62,6,8,56
S01010263,721,485,402,39,44,236,49,19,11,5,3,30,42,28,20,4,4,14,108,74,65,2,7,34,55,50,42,5,3,5,467,314,264,23,27,153
S01010264,815,537,430,41,66,278,121,27,17,1,9,94,95,51,33,2,16,44,142,96,77,6,13,46,77,61,43,8,10,16,380,302,260,24,18,78
S01010265,1019,653,526,62,65,366,24,8,3,5,0,16,69,39,29,6,4,30,287,145,108,7,30,142,78,46,33,6,7,32,561,415,353,38,24,146
S01010266,490,282,217,35,30,208,53,17,7,6,4,36,40,17,9,4,4,23,113,51,41,1,9,62,43,30,25,1,4,13,241,167,135,23,9,74
S01010267,583,363,299,34,30,220,20,8,8,0,0,12,61,40,28,8,4,21,186,97,78,8,11,89,41,31,27,0,4,10,275,187,158,18,11,88
S01010268,773,466,339,51,76,307,99,27,21,3,3,72,77,38,29,0,9,39,193,93,60,3,30,100,81,62,42,10,10,19,323,246,187,35,24,77
S01010269,506,274,220,25,29,232,69,25,15,5,5,44,46,14,11,3,0,32,90,45,31,5,9,45,48,26,21,4,1,22,253,164,142,8,14,89
S01010270,1122,444,343,40,61,678,480,88,54,4,30,392,132,59,44,4,11,73,136,50,39,7,4,86,55,35,27,5,3,20,319,212,179,20,13,107
S01010271,722,377,296,35,46,345,120,28,20,2,6,92,67,38,27,4,7,29,212,102,77,6,19,110,71,39,32,2,5,32,252,170,140,21,9,82
S01010272,928,526,396,43,87,402,254,63,39,6,18,191,123,76,48,9,19,47,134,82,68,5,9,52,83,64,49,1,14,19,334,241,192,22,27,93
S01010273,643,465,400,38,27,178,30,13,6,3,4,17,56,39,29,8,2,17,155,110,92,8,10,45,76,65,62,1,2,11,326,238,211,18,9,88
S01010274,552,377,318,37,22,175,47,16,10,2,4,31,37,26,22,3,1,11,108,65,59,2,4,43,58,39,27,8,4,19,302,231,200,22,9,71
S01010275,579,424,349,46,29,155,29,15,8,2,5,14,48,31,18,9,4,17,140,107,91,7,9,33,57,44,34,5,5,13,305,227,198,23,6,78
S01010276,926,704,556,106,42,222,62,37,25,10,2,25,94,78,59,8,11,16,114,65,52,10,3,49,109,89,71,12,6,20,547,435,349,66,20,112
S01010277,521,268,212,22,34,253,209,64,53,6,5,145,101,53,38,3,12,48,63,43,30,4,9,20,54,37,28,3,6,17,94,71,63,6,2,23
S01010278,508,311,247,27,37,197,158,55,44,4,7,103,111,77,59,6,12,34,58,40,32,3,5,18,52,37,30,2,5,15,129,102,82,12,8,27
S01010279,537,320,252,27,41,217,97,34,25,7,2,63,91,54,40,3,11,37,114,60,45,3,12,54,53,40,27,3,10,13,182,132,115,11,6,50
S01010280,730,536,432,44,60,194,60,24,15,3,6,36,75,50,37,2,11,25,165,97,73,10,14,68,76,66,56,2,8,10,354,299,251,27,21,55
S01010281,731,502,415,50,37,229,48,19,16,1,2,29,65,46,33,9,4,19,138,62,48,4,10,76,65,50,40,8,2,15,415,325,278,28,19,90
S01010282,902,562,461,36,65,340,186,49,37,3,9,137,108,66,49,1,16,42,128,75,54,6,15,53,69,58,45,5,8,11,411,314,276,21,17,97
S01010283,496,383,327,29,27,113,70,33,26,1,6,37,38,30,23,4,3,8,75,52,44,2,6,23,42,37,29,4,4,5,271,231,205,18,8,40
S01010284,1354,728,579,75,74,626,77,31,19,6,6,46,97,36,25,4,7,61,147,78,71,3,4,69,93,64,54,4,6,29,940,519,410,58,51,421
S01010285,736,465,350,64,51,271,79,29,18,7,4,50,67,35,27,3,5,32,210,111,85,10,16,99,66,51,37,4,10,15,314,239,183,40,16,75
S01010286,1455,646,449,47,150,809,71,24,16,1,7,47,165,62,45,3,14,103,332,129,82,3,44,203,130,66,49,2,15,64,757,365,257,38,70,392
S01010287,827,509,392,65,52,318,54,26,18,6,2,28,67,38,25,6,7,29,246,104,76,9,19,142,45,35,23,5,7,10,415,306,250,39,17,109
S01010288,754,496,389,67,40,258,36,14,9,3,2,22,75,29,20,2,7,46,200,99,77,6,16,101,56,42,31,8,3,14,387,312,252,48,12,75
S01010289,689,526,378,124,24,163,32,13,9,3,1,19,62,30,17,8,5,32,98,58,40,16,2,40,44,28,18,6,4,16,453,397,294,91,12,56
S01010290,493,315,243,39,33,178,45,16,11,3,2,29,51,24,19,1,4,27,120,74,51,9,14,46,38,22,16,4,2,16,239,179,146,22,11,60
S01010291,997,518,379,53,86,479,117,33,19,4,10,84,101,43,35,2,6,58,299,135,91,9,35,164,75,48,33,5,10,27,405,259,201,33,25,146
S01010292,844,535,424,59,52,309,51,24,18,3,3,27,51,30,18,4,8,21,235,93,74,6,13,142,63,50,40,4,6,13,444,338,274,42,22,106
S01010293,756,457,363,35,59,299,87,24,14,4,6,63,67,31,20,2,9,36,225,117,87,7,23,108,69,45,38,2,5,24,308,240,204,20,16,68
S01010294,643,339,277,26,36,304,58,17,10,4,3,41,39,21,14,1,6,18,271,106,84,5,17,165,44,27,21,3,3,17,231,168,148,13,7,63
S01010295,892,523,409,55,59,369,83,32,18,6,8,51,73,33,25,6,2,40,255,110,81,8,21,145,88,51,38,3,10,37,393,297,247,32,18,96
S01010296,575,334,257,30,47,241,91,24,22,1,1,67,65,42,30,3,9,23,149,63,48,3,12,86,53,39,30,3,6,14,217,166,127,20,19,51
S01010297,989,501,402,32,67,488,330,70,56,3,11,260,129,66,56,4,6,63,129,80,62,4,14,49,102,73,54,6,13,29,299,212,174,15,23,87
S01010298,820,418,337,42,39,402,247,40,28,7,5,207,91,39,26,2,11,52,134,77,65,5,7,57,59,47,39,4,4,12,289,215,179,24,12,74
S01010299,456,201,146,20,35,255,201,47,26,8,13,154,86,39,25,4,10,47,43,25,23,1,1,18,29,16,12,0,4,13,97,74,60,7,7,23
S01010300,837,451,357,38,56,386,230,53,41,5,7,177,109,54,41,3,10,55,130,86,68,8,10,44,64,38,31,1,6,26,304,220,176,21,23,84
S01010301,466,305,244,22,39,161,50,22,12,4,6,28,50,31,22,3,6,19,96,55,44,5,6,41,49,36,27,2,7,13,221,161,139,8,14,60
S01010302,557,249,155,16,78,308,244,54,27,2,25,190,117,69,40,4,25,48,46,23,17,0,6,23,47,27,16,1,10,20,103,76,55,9,12,27
S01010303,398,189,129,14,46,209,157,53,35,4,14,104,95,44,23,4,17,51,40,26,18,1,7,14,40,21,16,2,3,19,66,45,37,3,5,21
S01010304,481,255,202,12,41,226,157,26,17,2,7,131,72,48,32,2,14,24,67,47,39,2,6,20,49,41,35,2,4,8,136,93,79,4,10,43
S01010305,766,430,347,38,45,336,231,49,41,3,5,182,87,48,37,1,10,39,102,59,43,7,9,43,67,48,37,7,4,19,279,226,189,20,17,53
S01010306,692,472,375,37,60,220,76,34,18,3,13,42,66,45,29,3,13,21,131,73,57,1,15,58,63,45,36,4,5,18,356,275,235,26,14,81
S01010307,754,545,440,70,35,209,57,21,16,2,3,36,46,29,24,1,4,17,148,70,52,10,8,78,35,29,20,6,3,6,468,396,328,51,17,72
S01010308,876,593,455,83,55,283,56,20,11,1,8,36,68,45,25,10,10,23,138,64,46,6,12,74,61,43,32,5,6,18,553,421,341,61,19,132
S01010309,388,193,157,6,30,195,237,80,65,4,11,157,67,45,34,0,11,22,27,24,22,0,2,3,22,21,16,0,5,1,35,23,20,2,1,12
S01010310,556,329,247,20,62,227,234,96,58,4,34,138,139,98,80,2,16,41,45,33,28,2,3,12,50,40,35,2,3,10,88,62,46,10,6,26
S01010311,582,277,207,8,62,305,318,111,79,1,31,207,125,69,45,3,21,56,39,27,21,3,3,12,38,23,19,0,4,15,62,47,43,1,3,15
S01010312,676,327,243,14,70,349,368,121,85,6,30,247,178,115,87,3,25,63,51,31,26,1,4,20,37,28,22,2,4,9,42,32,23,2,7,10
S01010313,548,271,196,14,61,277,281,96,68,3,25,185,133,72,48,2,22,61,56,42,28,4,10,14,30,25,23,1,1,5,48,36,29,4,3,12
S01010314,1112,544,404,37,103,568,389,98,76,7,15,291,203,123,87,4,32,80,139,76,51,4,21,63,93,63,53,1,9,30,288,184,137,21,26,104
S01010315,703,481,383,31,67,222,198,81,60,5,16,117,191,145,100,11,34,46,76,60,51,3,6,16,67,57,52,1,4,10,171,138,120,11,7,33
S01010316,422,250,197,13,40,172,123,37,27,2,8,86,106,61,41,1,19,45,60,41,37,1,3,19,45,34,29,2,3,11,88,77,63,7,7,11
S01010317,690,482,397,58,27,208,70,9,7,1,1,61,41,25,18,6,1,16,151,76,64,5,7,75,53,43,32,5,6,10,375,329,276,41,12,46
S01010318,1513,633,403,29,201,880,127,44,29,4,11,83,170,83,52,5,26,87,873,320,191,4,125,553,118,63,46,4,13,55,225,123,85,12,26,102
S01010319,647,443,373,33,37,204,135,50,35,10,5,85,63,46,36,3,7,17,96,60,54,2,4,36,57,48,39,3,6,9,296,239,209,15,15,57
S01010320,624,371,286,32,53,253,150,38,25,2,11,112,70,47,32,1,14,23,92,47,36,5,6,45,54,39,27,2,10,15,258,200,166,22,12,58
S01010321,784,443,361,27,55,341,247,58,46,1,11,189,115,58,38,2,18,57,99,61,46,5,10,38,49,40,35,0,5,9,274,226,196,19,11,48
S01010322,952,688,549,99,40,264,77,26,17,5,4,51,69,46,35,3,8,23,152,89,72,11,6,63,53,45,36,5,4,8,601,482,389,75,18,119
S01010323,512,237,173,5,59,275,306,92,62,1,29,214,82,62,43,1,18,20,30,11,8,1,2,19,37,28,21,0,7,9,57,44,39,2,3,13
S01010324,663,285,239,18,28,378,391,110,87,11,12,281,140,94,84,2,8,46,60,43,36,2,5,17,43,26,23,1,2,17,29,12,9,2,1,17
S01010325,824,332,265,20,47,492,505,122,93,5,24,383,147,89,74,4,11,58,70,48,43,3,2,22,43,29,21,2,6,14,59,44,34,6,4,15
S01010326,742,360,243,20,97,382,398,134,81,9,44,264,176,105,69,3,33,71,59,39,28,2,9,20,39,27,22,2,3,12,70,55,43,4,8,15
S01010327,770,442,351,33,58,328,381,142,103,8,31,239,156,117,99,6,12,39,59,49,43,0,6,10,54,44,31,7,6,10,120,90,75,12,3,30
S01010328,811,457,365,42,50,354,356,120,93,13,14,236,201,144,109,15,20,57,93,62,54,3,5,31,71,56,49,4,3,15,90,75,60,7,8,15
S01010329,495,267,213,30,24,228,242,79,63,8,8,163,104,67,55,4,8,37,48,39,30,4,5,9,38,33,25,6,2,5,63,49,40,8,1,14
S01010330,506,261,187,16,58,245,263,89,57,8,24,174,124,84,55,5,24,40,42,33,30,1,2,9,33,24,18,0,6,9,44,31,27,2,2,13
S01010331,776,363,299,16,48,413,449,116,86,8,22,333,158,112,97,2,13,46,48,45,40,3,2,3,60,46,38,2,6,14,61,44,38,1,5,17
S01010332,578,294,223,14,57,284,303,110,75,7,28,193,150,104,84,1,19,46,48,32,24,3,5,16,33,18,15,0,3,15,44,30,25,3,2,14
S01010333,793,441,353,36,52,352,359,122,94,12,16,237,201,145,116,6,23,56,78,55,44,7,4,23,80,62,50,8,4,18,75,57,49,3,5,18
S01010334,736,445,380,34,31,291,324,120,100,12,8,204,193,144,116,14,14,49,80,65,55,5,5,15,71,61,55,3,3,10,68,55,54,0,1,13
S01010335,695,316,243,22,51,379,385,111,78,10,23,274,152,102,78,5,19,50,58,35,28,2,5,23,59,42,37,1,4,17,41,26,22,4,0,15
S01010336,502,261,175,14,72,241,251,97,56,6,35,154,142,99,66,5,28,43,41,24,22,1,1,17,33,24,17,0,7,9,35,17,14,2,1,18
S01010337,529,285,238,10,37,244,284,107,87,5,15,177,112,73,58,1,14,39,61,45,41,1,3,16,34,28,24,1,3,6,38,32,28,2,2,6
S01010338,570,280,206,17,57,290,293,103,61,11,31,190,144,87,68,1,18,57,52,33,25,2,6,19,42,32,29,1,2,10,39,25,23,2,0,14
S01010339,552,270,210,16,44,282,287,92,67,6,19,195,134,80,62,4,14,54,44,28,22,2,4,16,39,34,29,0,5,5,48,36,30,4,2,12
S01010340,595,362,282,25,55,233,257,106,77,10,19,151,168,127,91,11,25,41,58,44,40,0,4,14,56,44,38,1,5,12,56,41,36,3,2,15
S01010341,468,283,238,20,25,185,177,63,46,10,7,114,119,88,75,5,8,31,67,46,40,2,4,21,54,47,41,1,5,7,51,39,36,2,1,12
S01010342,532,397,355,29,13,135,151,83,70,9,4,68,161,126,114,8,4,35,86,78,70,5,3,8,47,43,38,4,1,4,87,67,63,3,1,20
S01010343,757,603,514,51,38,154,168,107,86,13,8,61,229,182,147,17,18,47,146,129,117,5,7,17,82,68,62,5,1,14,132,117,102,11,4,15
S01010344,584,292,218,14,60,292,283,92,66,4,22,191,170,115,82,8,25,55,59,40,33,2,5,19,40,23,16,0,7,17,32,22,21,0,1,10
S01010345,350,270,218,36,16,80,48,26,18,6,2,22,94,73,59,6,8,21,46,34,29,4,1,12,35,30,24,5,1,5,127,107,88,15,4,20
S01010346,876,589,496,64,29,287,276,94,77,14,3,182,164,122,98,12,12,42,107,86,75,5,6,21,72,61,50,8,3,11,257,226,196,25,5,31
S01010347,939,470,364,35,71,469,284,96,67,2,27,188,226,123,95,7,21,103,188,80,62,6,12,108,81,60,54,1,5,21,160,111,86,19,6,49
S01010348,806,469,410,21,38,337,367,126,106,6,14,241,197,141,125,8,8,56,86,72,60,3,9,14,53,40,38,1,1,13,103,90,81,3,6,13
S01010349,745,408,343,21,44,337,349,104,79,8,17,245,216,156,131,7,18,60,69,55,48,3,4,14,45,40,39,0,1,5,66,53,46,3,4,13
S01010350,729,393,298,15,80,336,344,114,71,8,35,230,191,133,100,5,28,58,64,44,37,1,6,20,65,54,45,1,8,11,65,48,45,0,3,17
S01010351,691,446,377,31,38,245,218,95,75,6,14,123,178,123,102,8,13,55,97,71,61,8,2,26,62,49,40,2,7,13,136,108,99,7,2,28
S01010352,454,223,184,8,31,231,237,75,62,1,12,162,101,69,49,4,16,32,38,23,22,0,1,15,32,22,21,0,1,10,46,34,30,3,1,12
S01010353,764,338,231,21,86,426,370,98,60,3,35,272,184,93,60,8,25,91,61,45,33,3,9,16,65,43,35,1,7,22,84,59,43,6,10,25
S01010354,613,328,267,22,39,285,247,76,57,6,13,171,147,84,67,5,12,63,55,41,33,2,6,14,61,47,41,2,4,14,103,80,69,7,4,23
S01010355,621,361,293,26,42,260,257,90,72,7,11,167,132,90,70,2,18,42,74,58,52,2,4,16,63,44,36,5,3,19,95,79,63,10,6,16
S01010356,549,410,345,25,40,139,132,84,67,7,10,48,128,99,78,6,15,29,81,62,54,3,5,19,62,45,40,2,3,17,146,120,106,7,7,26
S01010357,503,266,206,11,49,237,222,70,53,0,17,152,106,62,37,5,20,44,42,33,29,0,4,9,44,34,28,3,3,10,89,67,59,3,5,22
S01010358,714,351,267,16,68,363,348,108,70,6,32,240,156,95,71,3,21,61,61,46,38,0,8,15,45,33,28,1,4,12,104,69,60,6,3,35
S01010359,648,307,213,25,69,341,312,95,60,5,30,217,168,93,67,4,22,75,41,28,19,3,6,13,52,40,30,5,5,12,75,51,37,8,6,24
S01010360,445,260,194,16,50,185,158,55,37,2,16,103,99,55,39,2,14,44,54,36,28,1,7,18,33,28,20,2,6,5,101,86,70,9,7,15
S01010361,518,287,173,12,102,231,228,78,42,4,32,150,131,87,52,1,34,44,47,35,22,1,12,12,37,28,19,0,9,9,75,59,38,6,15,16
S01010362,742,386,253,8,125,356,339,103,69,0,34,236,167,110,61,1,48,57,80,46,27,1,18,34,47,39,28,1,10,8,109,88,68,5,15,21
S01010363,655,453,363,53,37,202,92,24,19,3,2,68,72,49,32,6,11,23,95,59,44,10,5,36,66,54,44,6,4,12,330,267,224,28,15,63
S01010364,762,491,388,74,29,271,116,45,29,9,7,71,82,38,29,5,4,44,101,59,48,6,5,42,75,55,40,8,7,20,388,294,242,46,6,94
S01010365,869,584,434,124,26,285,110,41,23,16,2,69,85,45,36,7,2,40,124,74,52,15,7,50,46,39,33,3,3,7,504,385,290,83,12,119
S01010366,909,618,504,75,39,291,96,36,23,7,6,60,105,59,45,8,6,46,130,84,64,11,9,46,64,54,45,6,3,10,514,385,327,43,15,129
S01010367,1488,707,542,88,77,781,93,25,16,7,2,68,150,48,32,6,10,102,320,130,93,13,24,190,104,60,45,9,6,44,821,444,356,53,35,377
S01010368,639,412,298,96,18,227,35,7,3,4,0,28,53,18,14,3,1,35,91,57,36,15,6,34,29,19,14,1,4,10,431,311,231,73,7,120
S01010369,672,503,414,61,28,169,85,28,14,8,6,57,67,44,39,4,1,23,78,52,43,4,5,26,62,51,37,7,7,11,380,328,281,38,9,52
S01010370,630,468,348,85,35,162,29,13,8,5,0,16,56,33,23,4,6,23,89,47,32,6,9,42,43,28,23,3,2,15,413,347,262,67,18,66
S01010371,908,613,470,97,46,295,37,12,5,3,4,25,61,36,21,6,9,25,181,83,64,9,10,98,76,62,43,9,10,14,553,420,337,70,13,133
S01010372,454,333,265,50,18,121,40,5,2,3,0,35,28,15,10,4,1,13,72,50,38,5,7,22,33,24,19,2,3,9,281,239,196,36,7,42
S01010373,687,461,364,65,32,226,76,12,8,2,2,64,47,24,18,5,1,23,97,62,41,10,11,35,36,29,22,5,2,7,431,334,275,43,16,97
S01010374,830,562,428,97,37,268,45,12,7,5,0,33,54,30,21,3,6,24,171,89,62,9,18,82,62,47,36,6,5,15,498,384,302,74,8,114
S01010375,501,249,200,23,26,252,21,6,4,2,0,15,29,11,6,3,2,18,234,78,58,4,16,156,27,15,9,3,3,12,190,139,123,11,5,51
S01010376,667,381,310,39,32,286,16,4,4,0,0,12,45,19,13,2,4,26,184,88,73,3,12,96,31,23,18,3,2,8,391,247,202,31,14,144
S01010377,857,443,330,56,57,414,59,16,11,3,2,43,76,40,27,3,10,36,310,115,83,6,26,195,56,37,23,5,9,19,356,235,186,39,10,121
S01010378,689,350,272,26,52,339,21,7,4,1,2,14,59,21,14,2,5,38,301,107,77,1,29,194,41,24,18,2,4,17,267,191,159,20,12,76
S01010379,1076,522,404,55,63,554,61,21,13,4,4,40,103,40,29,3,8,63,365,116,84,7,25,249,83,48,39,5,4,35,464,297,239,36,22,167
S01010380,889,583,462,73,48,306,77,19,12,6,1,58,59,31,23,1,7,28,167,85,63,9,13,82,63,41,30,7,4,22,523,407,334,50,23,116
S01010381,569,373,318,30,25,196,45,18,14,1,3,27,41,23,19,2,2,18,145,72,58,4,10,73,37,31,24,5,2,6,301,229,203,18,8,72
S01010382,793,558,448,53,57,235,80,21,15,1,5,59,65,42,30,3,9,23,165,96,70,4,22,69,64,51,41,6,4,13,419,348,292,39,17,71
S01010383,595,339,256,29,54,256,136,44,30,5,9,92,88,56,43,3,10,32,101,57,38,5,14,44,54,42,34,2,6,12,216,140,111,14,15,76
S01010384,770,531,443,55,33,239,79,21,16,2,3,58,65,38,31,2,5,27,130,73,60,7,6,57,49,36,26,5,5,13,447,363,310,39,14,84
S01010385,783,493,384,60,49,290,121,23,16,4,3,98,84,54,36,5,13,30,141,72,57,6,9,69,69,55,39,8,8,14,368,289,236,37,16,79
S01010386,822,467,368,41,58,355,213,49,39,4,6,164,116,71,54,4,13,45,149,92,67,7,18,57,71,44,34,4,6,27,273,211,174,22,15,62
S01010387,972,647,542,47,58,325,157,45,36,4,5,112,96,70,56,5,9,26,165,100,74,6,20,65,75,52,38,8,6,23,479,380,338,24,18,99
S01010388,925,555,453,37,65,370,259,85,65,7,13,174,162,112,82,6,24,50,117,56,48,2,6,61,83,60,44,3,13,23,304,242,214,19,9,62
S01010389,973,746,624,73,49,227,60,29,24,3,2,31,108,80,64,7,9,28,131,96,78,6,12,35,95,75,63,6,6,20,579,466,395,51,20,113
S01010390,1002,792,664,57,71,210,110,38,29,1,8,72,124,92,68,11,13,32,152,115,87,10,18,37,104,95,81,7,7,9,512,452,399,28,25,60
S01010391,737,558,463,43,52,179,104,34,26,5,3,70,105,88,66,5,17,17,96,70,56,7,7,26,76,61,53,3,5,15,356,305,262,23,20,51
S01010392,634,508,415,75,18,126,23,14,7,6,1,9,67,46,33,5,8,21,78,64,56,7,1,14,66,54,45,6,3,12,400,330,274,51,5,70
S01010393,951,672,568,68,36,279,141,39,27,5,7,102,92,55,46,6,3,37,151,97,79,10,8,54,78,61,53,6,2,17,489,420,363,41,16,69
S01010394,731,366,272,38,56,365,243,52,32,3,17,191,139,81,57,7,17,58,91,52,41,5,6,39,60,42,33,2,7,18,198,139,109,21,9,59
S01010395,917,594,504,36,54,323,175,45,34,2,9,130,95,59,42,9,8,36,136,73,59,5,9,63,74,63,49,6,8,11,437,354,320,14,20,83
S01010396,945,589,474,59,56,356,190,48,32,3,13,142,109,68,56,0,12,41,155,89,75,6,8,66,63,47,39,2,6,16,428,337,272,48,17,91
S01010397,500,349,275,45,29,151,39,8,7,0,1,31,25,18,10,4,4,7,113,62,45,3,14,51,35,27,18,7,2,8,288,234,195,31,8,54
S01010398,1000,695,558,90,47,305,103,25,13,8,4,78,76,51,38,7,6,25,165,98,71,13,14,67,68,48,37,4,7,20,588,473,399,58,16,115
S01010399,979,766,661,74,31,213,30,7,5,2,0,23,43,28,25,2,1,15,116,66,56,6,4,50,56,47,38,7,2,9,734,618,537,57,24,116
S01010400,949,671,525,106,40,278,65,16,9,2,5,49,67,35,28,3,4,32,132,84,64,8,12,48,59,48,36,7,5,11,626,488,388,86,14,138
S01010401,669,397,304,66,27,272,88,15,9,5,1,73,48,27,18,3,6,21,136,60,46,7,7,76,42,31,26,5,0,11,355,264,205,46,13,91
S01010402,921,664,541,94,29,257,57,13,9,3,1,44,42,19,12,7,0,23,133,78,55,11,12,55,44,35,31,4,0,9,645,519,434,69,16,126
S01010403,930,611,484,94,33,319,51,9,4,4,1,42,76,33,20,6,7,43,133,60,47,6,7,73,48,27,16,6,5,21,622,482,397,72,13,140
S01010404,691,472,340,115,17,219,57,20,11,8,1,37,65,36,23,9,4,29,75,41,29,11,1,34,39,33,27,5,1,6,455,342,250,82,10,113
S01010405,689,512,397,89,26,177,24,3,2,0,1,21,37,19,14,5,0,18,91,52,31,15,6,39,53,38,30,6,2,15,484,400,320,63,17,84
S01010406,758,532,406,93,33,226,45,19,9,5,5,26,61,31,20,5,6,30,164,85,63,13,9,79,49,38,30,5,3,11,439,359,284,65,10,80
S01010407,844,464,372,52,40,380,40,10,6,3,1,30,46,26,20,4,2,20,293,104,81,2,21,189,59,35,29,1,5,24,406,289,236,42,11,117
S01010408,436,246,201,32,13,190,106,20,13,5,2,86,66,38,33,1,4,28,50,32,25,7,0,18,39,21,16,3,2,18,175,135,114,16,5,40
S01010409,541,348,276,56,16,193,87,28,15,11,2,59,78,41,33,6,2,37,77,48,42,4,2,29,44,33,29,4,0,11,255,198,157,31,10,57
S01010410,470,316,261,42,13,154,34,12,7,2,3,22,68,33,27,6,0,35,69,45,34,7,4,24,33,23,18,5,0,10,266,203,175,22,6,63
S01010411,798,537,425,88,24,261,62,25,20,4,1,37,68,35,25,6,4,33,115,69,56,5,8,46,56,29,24,5,0,27,497,379,300,68,11,118
S01010412,762,505,424,67,14,257,86,10,8,0,2,76,59,31,26,3,2,28,99,49,44,5,0,50,55,41,33,6,2,14,463,374,313,53,8,89
S01010413,612,322,242,66,14,290,69,14,9,5,0,55,69,28,18,9,1,41,80,37,28,6,3,43,29,19,15,1,3,10,365,224,172,45,7,141
S01010414,872,554,441,72,41,318,127,31,20,5,6,96,96,50,36,8,6,46,123,76,60,5,11,47,64,51,39,8,4,13,462,346,286,46,14,116
S01010415,886,491,372,65,54,395,293,77,55,11,11,216,138,83,59,10,14,55,125,70,51,7,12,55,72,56,40,7,9,16,258,205,167,30,8,53
S01010416,586,379,295,60,24,207,55,15,12,1,2,40,71,39,29,5,5,32,87,49,33,11,5,38,35,24,16,5,3,11,338,252,205,38,9,86
S01010417,488,338,288,41,9,150,55,13,9,2,2,42,39,26,21,4,1,13,46,27,21,6,0,19,40,30,27,1,2,10,308,242,210,28,4,66
S01010418,937,691,551,107,33,246,77,19,13,6,0,58,77,40,28,7,5,37,86,55,39,8,8,31,60,46,36,5,5,14,637,531,435,81,15,106
S01010419,836,579,479,80,20,257,65,11,10,1,0,54,70,26,21,3,2,44,93,60,44,10,6,33,67,45,35,9,1,22,541,437,369,57,11,104
S01010420,578,330,269,47,14,248,97,12,8,3,1,85,68,25,18,6,1,43,88,54,45,3,6,34,62,40,30,8,2,22,263,199,168,27,4,64
S01010421,704,456,361,65,30,248,85,21,13,4,4,64,71,36,27,3,6,35,90,56,46,6,4,34,55,42,32,7,3,13,403,301,243,45,13,102
S01010422,895,547,446,63,38,348,162,36,22,8,6,126,133,65,47,6,12,68,112,68,46,13,9,44,75,55,43,7,5,20,413,323,288,29,6,90
S01010423,702,430,338,21,71,272,229,76,44,4,28,153,144,102,82,1,19,42,80,56,41,5,10,24,70,56,48,3,5,14,179,140,123,8,9,39
S01010424,707,399,316,23,60,308,237,70,46,5,19,167,152,84,63,3,18,68,82,54,45,1,8,28,72,58,45,2,11,14,164,133,117,12,4,31
S01010425,875,529,425,35,69,346,281,88,62,5,21,193,200,128,100,5,23,72,105,74,61,6,7,31,86,70,55,5,10,16,203,169,147,14,8,34
S01010426,603,405,323,22,60,198,153,61,37,4,20,92,141,87,66,3,18,54,70,51,41,4,6,19,58,48,41,2,5,10,181,158,138,9,11,23
S01010427,802,407,276,38,93,395,337,104,61,10,33,233,149,83,60,3,20,66,76,45,25,4,16,31,60,42,30,2,10,18,180,133,100,19,14,47
S01010428,577,354,304,39,11,223,135,24,16,4,4,111,77,39,31,5,3,38,75,52,46,5,1,23,43,36,31,3,2,7,247,203,180,22,1,44
S01010429,772,551,471,56,24,221,100,25,16,5,4,75,88,59,42,9,8,29,95,55,41,9,5,40,62,51,46,4,1,11,427,361,326,29,6,66
S01010430,698,389,298,29,62,309,255,89,69,4,16,166,169,113,89,5,19,56,71,44,27,5,12,27,67,45,38,4,3,22,136,98,75,11,12,38
S01010431,549,379,307,52,20,170,67,20,11,5,4,47,49,21,13,5,3,28,83,51,41,6,4,32,47,34,28,3,3,13,303,253,214,33,6,50
S01010432,727,442,368,23,51,285,237,95,69,7,19,142,185,121,102,5,14,64,85,52,40,5,7,33,88,72,62,4,6,16,132,102,95,2,5,30
S01010433,546,315,185,22,108,231,213,104,68,7,29,109,154,93,40,5,48,61,42,23,15,2,6,19,47,32,23,2,7,15,90,63,39,6,18,27
S01010434,493,301,220,15,66,192,182,66,45,1,20,116,86,60,43,1,16,26,72,55,41,5,9,17,57,43,33,2,8,14,96,77,58,6,13,19
S01010435,528,310,265,16,29,218,219,71,65,2,4,148,128,94,77,6,11,34,60,44,36,2,6,16,42,34,34,0,0,8,79,67,53,6,8,12
S01010436,660,395,301,30,64,265,220,66,48,7,11,154,150,100,70,7,23,50,72,49,40,2,7,23,68,57,38,3,16,11,150,123,105,11,7,27
S01010437,467,258,207,16,35,209,171,49,38,6,5,122,113,67,48,3,16,46,55,34,26,1,7,21,50,42,38,3,1,8,78,66,57,3,6,12
S01010438,610,387,307,20,60,223,195,72,51,6,15,123,171,114,86,7,21,57,72,57,45,3,9,15,54,42,33,2,7,12,118,102,92,2,8,16
S01010439,798,556,461,23,72,242,213,103,80,4,19,110,201,143,119,6,18,58,104,80,67,6,7,24,73,57,48,1,8,16,207,173,147,6,20,34
S01010440,534,291,221,17,53,243,207,63,42,3,18,144,143,90,65,6,19,53,63,44,33,3,8,19,49,39,29,4,6,10,72,55,52,1,2,17
S01010441,694,579,508,25,46,115,100,55,42,3,10,45,160,128,102,6,20,32,101,91,82,4,5,10,127,115,102,7,6,12,206,190,180,5,5,16
S01010442,595,454,366,26,62,141,158,85,60,5,20,73,156,125,103,6,16,31,92,73,67,1,5,19,68,62,47,4,11,6,121,109,89,10,10,12
S01010443,436,262,215,25,22,174,185,76,66,6,4,109,106,70,51,7,12,36,43,31,26,5,0,12,32,23,19,2,2,9,70,62,53,5,4,8
S01010444,558,310,238,24,48,248,263,84,61,7,16,179,116,83,65,4,14,33,72,58,43,5,10,14,42,36,29,2,5,6,65,49,40,6,3,16
S01010445,785,338,278,30,30,447,389,91,68,8,15,298,179,105,84,13,8,74,84,52,45,4,3,32,44,32,28,2,2,12,89,58,53,3,2,31
S01010446,700,437,354,50,33,263,234,87,69,13,5,147,159,106,80,17,9,53,109,83,64,11,8,26,67,54,43,4,7,13,131,107,98,5,4,24
S01010447,816,415,322,28,65,401,338,99,69,8,22,239,212,134,97,8,29,78,76,51,42,4,5,25,88,54,46,2,6,34,102,77,68,6,3,25
S01010448,710,438,367,34,37,272,239,82,67,6,9,157,171,121,95,10,16,50,110,74,63,6,5,36,65,54,49,2,3,11,125,107,93,10,4,18
S01010449,654,326,275,18,33,328,329,86,70,6,10,243,138,95,79,3,13,43,49,35,26,4,5,14,49,35,34,1,0,14,89,75,66,4,5,14
S01010450,691,355,299,19,37,336,297,85,76,3,6,212,160,102,83,5,14,58,80,56,43,6,7,24,47,28,22,1,5,19,107,84,75,4,5,23
S01010451,703,358,255,26,77,345,265,63,39,2,22,202,161,90,59,4,27,71,62,40,32,4,4,22,67,54,40,3,11,13,148,111,85,13,13,37
S01010452,701,354,311,17,26,347,308,77,61,5,11,231,139,91,75,6,10,48,84,58,56,1,1,26,60,48,44,2,2,12,110,80,75,3,2,30
S01010453,539,320,211,24,85,219,170,68,33,5,30,102,142,85,55,7,23,57,46,30,24,2,4,16,58,44,28,3,13,14,123,93,71,7,15,30
S01010454,734,355,306,24,25,379,335,83,62,8,13,252,162,97,85,5,7,65,87,57,55,1,1,30,65,54,47,4,3,11,85,64,57,6,1,21
S01010455,833,359,276,26,57,474,437,110,85,7,18,327,145,84,59,5,20,61,102,71,58,3,10,31,65,47,40,2,5,18,84,47,34,9,4,37
S01010456,487,250,212,19,19,237,206,46,40,2,4,160,94,62,55,5,2,32,57,39,35,4,0,18,46,38,30,4,4,8,84,65,52,4,9,19
S01010457,535,292,211,32,49,243,205,54,39,10,5,151,119,82,58,6,18,37,62,45,30,5,10,17,53,39,35,2,2,14,96,72,49,9,14,24
S01010458,650,308,236,18,54,342,279,55,42,2,11,224,153,82,57,5,20,71,71,48,37,4,7,23,63,52,40,3,9,11,84,71,60,4,7,13
S01010459,474,215,175,22,18,259,184,37,26,8,3,147,111,59,48,4,7,52,42,22,18,2,2,20,38,25,21,1,3,13,99,72,62,7,3,27
S01010460,592,402,316,68,18,190,122,40,25,14,1,82,72,41,33,7,1,31,80,53,43,7,3,27,55,42,35,4,3,13,263,226,180,36,10,37
S01010461,616,300,226,20,54,316,258,70,43,5,22,188,128,80,60,4,16,48,63,32,27,2,3,31,49,31,24,3,4,18,118,87,72,6,9,31
S01010462,626,319,168,20,131,307,262,102,51,7,44,160,156,84,39,5,40,72,42,24,14,0,10,18,60,43,27,2,14,17,106,66,37,6,23,40
S01010463,665,391,306,47,38,274,221,71,54,11,6,150,124,80,62,4,14,44,89,56,44,8,4,33,66,55,38,10,7,11,165,129,108,14,7,36
S01010464,448,264,210,27,27,184,163,44,32,2,10,119,85,54,41,7,6,31,42,34,28,3,3,8,55,47,38,5,4,8,103,85,71,10,4,18
S01010465,798,602,534,38,30,196,125,45,38,3,4,80,148,105,93,7,5,43,121,95,81,6,8,26,99,81,72,1,8,18,305,276,250,21,5,29
S01010466,780,570,475,56,39,210,83,31,23,4,4,52,108,74,54,10,10,34,104,73,59,8,6,31,82,72,63,5,4,10,403,320,276,29,15,83
S01010467,786,379,311,46,22,407,186,29,21,7,1,157,103,48,37,8,3,55,98,54,44,6,4,44,64,43,35,5,3,21,335,205,174,20,11,130
S01010468,783,520,432,61,27,263,124,41,30,7,4,83,82,50,38,6,6,32,106,68,58,4,6,38,85,66,54,7,5,19,386,295,252,37,6,91
S01010469,520,315,259,14,42,205,109,20,13,3,4,89,89,42,31,1,10,47,50,40,29,5,6,10,47,32,25,1,6,15,225,181,161,4,16,44
S01010470,674,354,297,36,21,320,270,60,47,6,7,210,132,84,69,9,6,48,72,51,45,4,2,21,63,50,44,4,2,13,137,109,92,13,4,28
S01010471,536,294,240,16,38,242,221,62,51,4,7,159,104,61,43,2,16,43,61,40,34,2,4,21,46,40,35,0,5,6,104,91,77,8,6,13
S01010472,462,346,300,22,24,116,68,26,14,6,6,42,60,44,36,3,5,16,66,44,39,2,3,22,43,35,29,3,3,8,225,197,182,8,7,28
S01010473,668,447,382,25,40,221,157,53,43,3,7,104,106,70,57,4,9,36,94,65,58,1,6,29,73,59,51,5,3,14,238,200,173,12,15,38
S01010474,714,483,388,45,50,231,134,44,30,2,12,90,115,78,55,10,13,37,110,72,61,3,8,38,66,47,34,5,8,19,289,242,208,25,9,47
S01010475,591,449,403,32,14,142,61,18,17,1,0,43,74,59,46,6,7,15,98,62,55,4,3,36,65,55,51,3,1,10,293,255,234,18,3,38
S01010476,928,502,420,42,40,426,268,44,32,6,6,224,144,86,68,3,15,58,139,78,66,8,4,61,90,70,57,8,5,20,287,224,197,17,10,63
S01010477,628,371,313,27,31,257,228,59,47,7,5,169,126,91,77,4,10,35,93,72,65,2,5,21,61,48,37,7,4,13,120,101,87,7,7,19
S01010478,864,486,377,42,67,378,319,96,68,8,20,223,190,133,99,10,24,57,105,65,54,5,6,40,105,86,71,5,10,19,145,106,85,14,7,39
S01010479,839,472,395,23,54,367,323,105,81,8,16,218,180,116,88,8,20,64,116,77,66,2,9,39,85,68,62,1,5,17,135,106,98,4,4,29
S01010480,505,259,214,23,22,246,201,41,29,2,10,160,123,77,64,8,5,46,55,41,31,5,5,14,50,40,37,2,1,10,76,60,53,6,1,16
S01010481,476,266,188,17,61,210,203,78,51,6,21,125,142,99,61,8,30,43,50,26,21,2,3,24,33,24,21,0,3,9,48,39,34,1,4,9
S01010482,655,361,297,28,36,294,265,80,55,12,13,185,132,77,57,8,12,55,96,74,66,3,5,22,54,42,37,1,4,12,108,88,82,4,2,20
S01010483,858,479,399,44,36,379,327,90,73,8,9,237,187,118,98,11,9,69,99,77,57,11,9,22,88,65,55,6,4,23,157,129,116,8,5,28
S01010484,460,280,228,19,33,180,183,67,52,5,10,116,113,78,59,5,14,35,56,38,31,2,5,18,42,35,29,3,3,7,66,62,57,4,1,4
S01010485,794,480,390,42,48,314,239,75,57,6,12,164,185,128,99,10,19,57,124,88,74,6,8,36,85,67,56,6,5,18,161,122,104,14,4,39
S01010486,784,517,431,64,22,267,179,53,39,11,3,126,178,138,115,15,8,40,143,106,86,15,5,37,88,74,64,9,1,14,196,146,127,14,5,50
S01010487,815,480,406,31,43,335,318,106,87,9,10,212,207,148,123,7,18,59,105,86,69,6,11,19,81,68,61,5,2,13,104,72,66,4,2,32
S01010488,583,351,265,17,69,232,238,83,63,3,17,155,180,136,96,5,35,44,60,51,41,4,6,9,50,39,32,1,6,11,55,42,33,4,5,13
S01010489,877,455,361,22,72,422,395,112,78,8,26,283,229,157,128,3,26,72,90,70,55,5,10,20,74,56,52,2,2,18,89,60,48,4,8,29
S01010490,526,296,210,14,72,230,202,78,46,3,29,124,166,103,69,4,30,63,49,32,26,1,5,17,55,38,28,3,7,17,54,45,41,3,1,9
S01010491,633,368,256,17,95,265,292,116,78,3,35,176,182,127,84,8,35,55,48,40,29,2,9,8,65,48,35,2,11,17,46,37,30,2,5,9
S01010492,425,197,131,6,60,228,234,80,52,1,27,154,113,67,39,3,25,46,33,19,16,1,2,14,28,22,16,0,6,6,17,9,8,1,0,8
S01010493,487,281,181,11,89,206,232,105,61,4,40,127,143,94,55,4,35,49,35,28,24,1,3,7,46,34,26,1,7,12,31,20,15,1,4,11
S01010494,467,321,250,19,52,146,172,77,60,5,12,95,150,116,82,8,26,34,50,42,30,3,9,8,45,40,37,2,1,5,50,46,41,1,4,4
S01010495,644,359,272,9,78,285,304,125,91,5,29,179,160,112,81,3,28,48,77,50,35,1,14,27,58,39,33,0,6,19,45,33,32,0,1,12
S01010496,651,339,246,15,78,312,300,91,68,1,22,209,215,149,98,8,43,66,40,26,23,0,3,14,47,39,31,2,6,8,49,34,26,4,4,15
S01010497,552,351,254,27,70,201,229,97,61,7,29,132,164,123,94,7,22,41,57,45,34,3,8,12,48,42,32,3,7,6,54,44,33,7,4,10
S01010498,642,361,263,11,87,281,337,134,94,2,38,203,153,104,75,2,27,49,58,51,39,2,10,7,46,36,26,2,8,10,48,36,29,3,4,12
S01010499,692,282,166,9,107,410,384,99,49,4,46,285,158,90,56,1,33,68,52,33,23,2,8,19,48,31,22,1,8,17,50,29,16,1,12,21
S01010500,747,424,317,19,88,323,316,114,80,3,31,202,221,152,111,5,36,69,92,68,56,2,10,24,63,44,33,5,6,19,55,46,37,4,5,9
S01010501,728,434,347,20,67,294,308,110,76,6,28,198,210,149,116,7,26,61,82,68,59,2,7,14,69,57,52,2,3,12,59,50,44,3,3,9
S01010502,612,446,363,32,51,166,223,119,90,8,21,104,198,161,133,15,13,37,78,67,58,4,5,11,47,38,34,1,3,9,66,61,48,4,9,5
S01010503,547,276,230,10,36,271,268,84,72,3,9,184,157,109,91,4,14,48,57,31,25,2,4,26,34,29,22,1,6,5,31,23,20,0,3,8
S01010504,433,266,130,131,5,167,78,25,11,13,1,53,80,52,31,20,1,28,51,38,24,14,0,13,38,27,11,13,3,11,186,124,53,71,0,62
S01010505,453,298,184,100,14,155,82,26,16,6,4,56,103,81,47,26,8,22,76,61,34,26,1,15,39,32,20,11,1,7,153,98,67,31,0,55
S01010506,690,467,304,142,21,223,157,64,39,24,1,93,143,109,72,31,6,34,101,78,47,25,6,23,62,50,34,15,1,12,227,166,112,47,7,61
S01010507,649,457,327,90,40,192,209,108,74,20,14,101,186,156,113,32,11,30,85,65,51,12,2,20,48,38,27,4,7,10,121,90,62,22,6,31
S01010508,820,519,366,134,19,301,179,82,62,17,3,97,203,142,89,46,7,61,114,79,59,16,4,35,68,52,39,12,1,16,256,164,117,43,4,92
S01010509,793,557,417,125,15,236,185,99,65,28,6,86,192,131,106,19,6,61,107,81,63,18,0,26,62,57,40,16,1,5,247,189,143,44,2,58
S01010510,696,399,339,45,15,297,247,76,61,13,2,171,148,99,83,12,4,49,92,71,61,4,6,21,53,44,39,5,0,9,156,109,95,11,3,47
S01010511,669,462,392,34,36,207,256,129,104,16,9,127,197,160,136,10,14,37,88,73,66,3,4,15,54,46,38,2,6,8,74,54,48,3,3,20
S01010512,501,290,233,41,16,211,166,56,42,11,3,110,128,88,72,10,6,40,69,56,48,6,2,13,33,24,20,3,1,9,105,66,51,11,4,39
S01010513,618,429,347,70,12,189,120,46,35,7,4,74,152,114,89,18,7,38,90,74,64,10,0,16,53,46,43,2,1,7,203,149,116,33,0,54
S01010514,558,374,333,28,13,184,218,110,96,9,5,108,166,124,110,8,6,42,73,60,56,3,1,13,34,31,25,5,1,3,67,49,46,3,0,18
S01010515,662,441,384,27,30,221,259,120,99,10,11,139,216,175,157,4,14,41,83,66,58,5,3,17,28,20,17,2,1,8,76,60,53,6,1,16
S01010516,515,347,240,91,16,168,135,60,27,26,7,75,107,81,54,20,7,26,59,47,39,8,0,12,52,38,24,12,2,14,162,121,96,25,0,41
S01010517,685,481,375,59,47,204,171,79,56,10,13,92,176,121,92,8,21,55,113,93,80,10,3,20,59,46,37,6,3,13,166,142,110,25,7,24
S01010518,543,398,326,44,28,145,117,50,33,11,6,67,146,117,95,11,11,29,93,82,66,12,4,11,51,46,43,1,2,5,136,103,89,9,5,33
S01010519,568,410,346,30,34,158,143,82,70,6,6,61,169,125,94,10,21,44,95,75,69,3,3,20,49,40,37,1,2,9,112,88,76,10,2,24
S01010520,755,511,454,41,16,244,242,78,66,7,5,164,204,164,144,13,7,40,122,108,98,7,3,14,48,44,40,3,1,4,139,117,106,11,0,22
S01010521,608,428,341,60,27,180,209,97,73,16,8,112,176,133,107,15,11,43,77,69,60,6,3,8,37,33,25,7,1,4,109,96,76,16,4,13
S01010522,514,330,267,40,23,184,171,51,32,14,5,120,147,119,95,11,13,28,73,63,59,2,2,10,37,31,25,5,1,6,86,66,56,8,2,20
S01010523,457,305,254,25,26,152,165,84,72,6,6,81,138,97,81,3,13,41,56,43,36,6,1,13,26,21,17,1,3,5,72,60,48,9,3,12
S01010524,462,297,214,75,8,165,118,45,29,16,0,73,71,53,34,16,3,18,68,51,35,12,4,17,45,34,29,4,1,11,160,114,87,27,0,46
S01010525,545,324,232,82,10,221,100,35,23,11,1,65,111,72,53,14,5,39,85,56,42,12,2,29,57,41,30,9,2,16,192,120,84,36,0,72
S01010526,675,435,319,97,19,240,167,56,36,19,1,111,150,104,75,24,5,46,98,78,63,8,7,20,56,47,35,11,1,9,204,150,110,35,5,54
S01010527,742,467,376,43,48,275,224,82,56,11,15,142,214,160,131,9,20,54,96,81,71,4,6,15,40,32,27,1,4,8,168,112,91,18,3,56
S01010528,503,342,250,84,8,161,113,53,34,18,1,60,102,75,57,16,2,27,59,47,38,9,0,12,52,44,31,10,3,8,177,123,90,31,2,54
S01010529,584,384,295,76,13,200,153,56,39,13,4,97,139,112,92,14,6,27,91,75,61,12,2,16,50,35,27,8,0,15,151,106,76,29,1,45
S01010530,547,374,252,107,15,173,140,66,40,22,4,74,116,93,70,20,3,23,81,55,36,15,4,26,49,36,25,9,2,13,161,124,81,41,2,37
S01010531,930,615,454,139,22,315,226,99,66,28,5,127,195,154,120,26,8,41,141,112,85,24,3,29,89,65,50,13,2,24,279,185,133,48,4,94
S01010532,462,302,200,82,20,160,112,53,32,13,8,59,97,79,57,20,2,18,66,46,33,11,2,20,51,41,29,10,2,10,136,83,49,28,6,53
S01010533,518,300,223,67,10,218,125,39,29,10,0,86,106,74,53,17,4,32,70,44,33,11,0,26,31,24,13,9,2,7,186,119,95,20,4,67
S01010534,706,473,371,78,24,233,158,72,54,14,4,86,183,140,104,25,11,43,114,87,69,14,4,27,55,41,37,4,0,14,196,133,107,21,5,63
S01010535,572,378,273,89,16,194,104,45,28,14,3,59,99,64,40,20,4,35,88,73,51,17,5,15,51,45,34,8,3,6,230,151,120,30,1,79
S01010536,703,477,393,58,26,226,215,91,74,13,4,124,183,142,114,15,13,41,102,85,76,4,5,17,53,45,38,5,2,8,150,114,91,21,2,36
S01010537,672,509,431,59,19,163,155,73,62,6,5,82,176,138,126,8,4,38,85,71,62,7,2,14,83,75,62,9,4,8,173,152,119,29,4,21
S01010538,600,472,380,62,30,128,82,48,29,11,8,34,150,122,100,13,9,28,99,77,66,8,3,22,71,62,52,9,1,9,198,163,133,21,9,35
S01010539,962,750,612,110,28,212,164,85,67,12,6,79,248,199,156,28,15,49,117,95,82,12,1,22,95,86,72,14,0,9,338,285,235,44,6,53
S01010540,540,341,250,75,16,199,125,58,38,19,1,67,115,90,74,7,9,25,52,35,21,12,2,17,47,33,22,9,2,14,201,125,95,28,2,76
S01010541,706,475,357,101,17,231,142,63,47,12,4,79,133,88,61,21,6,45,105,82,64,15,3,23,74,62,44,18,0,12,252,180,141,35,4,72
S01010542,755,483,360,102,21,272,150,67,39,22,6,83,159,100,72,22,6,59,100,74,58,11,5,26,62,42,32,10,0,20,284,200,159,37,4,84
S01010543,508,351,229,117,5,157,106,48,28,19,1,58,101,79,55,23,1,22,82,65,43,20,2,17,52,40,28,12,0,12,167,119,75,43,1,48
S01010544,692,464,352,75,37,228,210,104,73,22,9,106,182,137,103,19,15,45,94,76,54,13,9,18,55,46,37,8,1,9,151,101,85,13,3,50
S01010545,586,356,259,74,23,230,143,47,32,7,8,96,151,105,84,15,6,46,71,47,35,10,2,24,39,36,30,4,2,3,182,121,78,38,5,61
S01010546,710,402,312,65,25,308,226,75,65,8,2,151,142,94,72,14,8,48,90,70,56,11,3,20,49,32,22,8,2,17,203,131,97,24,10,72
S01010547,622,397,289,93,15,225,144,58,33,24,1,86,155,106,76,23,7,49,92,66,52,12,2,26,65,56,43,12,1,9,166,111,85,22,4,55
S01010548,574,319,227,75,17,255,155,49,32,14,3,106,132,82,60,17,5,50,72,58,39,15,4,14,57,39,32,4,3,18,158,91,64,25,2,67
S01010549,710,483,428,39,16,227,110,43,36,3,4,67,180,119,105,8,6,61,101,82,76,6,0,19,90,74,66,3,5,16,229,165,145,19,1,64
S01010550,447,293,240,40,13,154,116,33,25,5,3,83,105,77,63,9,5,28,72,61,48,11,2,11,38,30,26,2,2,8,116,92,78,13,1,24
S01010551,511,356,238,101,17,155,87,47,26,17,4,40,119,82,56,20,6,37,75,58,40,17,1,17,57,51,35,14,2,6,173,118,81,33,4,55
S01010552,630,424,322,87,15,206,123,63,44,14,5,60,123,85,70,13,2,38,83,67,50,15,2,16,57,43,29,12,2,14,244,166,129,33,4,78
S01010553,514,348,231,99,18,166,95,48,24,23,1,47,121,85,55,21,9,36,83,61,47,13,1,22,53,42,30,11,1,11,162,112,75,31,6,50
S01010554,637,407,321,60,26,230,158,53,38,9,6,105,158,122,100,12,10,36,79,58,50,7,1,21,53,44,31,9,4,9,189,130,102,23,5,59
S01010555,771,523,413,66,44,248,161,60,41,11,8,101,205,153,120,16,17,52,127,99,89,6,4,28,78,61,47,9,5,17,200,150,116,24,10,50
S01010556,810,411,334,32,45,399,293,66,47,9,10,227,246,170,133,11,26,76,102,69,61,2,6,33,58,48,41,5,2,10,111,58,52,5,1,53
S01010557,510,304,263,13,28,206,177,63,44,4,15,114,134,96,82,6,8,38,62,48,46,1,1,14,46,38,34,1,3,8,91,59,57,1,1,32
S01010558,669,349,272,43,34,320,218,54,36,8,10,164,155,105,82,8,15,50,103,70,56,8,6,33,41,35,29,5,1,6,152,85,69,14,2,67
S01010559,674,307,228,63,16,367,155,19,16,2,1,136,126,55,45,8,2,71,75,46,34,7,5,29,48,34,27,4,3,14,270,153,106,42,5,117
S01010560,564,345,288,45,12,219,136,35,30,4,1,101,107,73,60,8,5,34,83,68,60,5,3,15,53,41,26,12,3,12,185,128,112,16,0,57
S01010561,604,338,278,51,9,266,113,28,23,5,0,85,124,77,61,12,4,47,96,63,52,9,2,33,59,41,35,5,1,18,212,129,107,20,2,83
S01010562,623,415,356,40,19,208,133,43,36,5,2,90,185,143,127,9,7,42,109,82,72,5,5,27,61,52,46,4,2,9,135,95,75,17,3,40
S01010563,415,293,239,26,28,122,125,60,48,5,7,65,124,103,79,9,15,21,53,47,43,2,2,6,35,26,23,2,1,9,78,57,46,8,3,21
S01010564,442,243,193,24,26,199,188,62,47,7,8,126,118,78,62,5,11,40,54,45,34,5,6,9,31,22,17,4,1,9,51,36,33,3,0,15
S01010565,543,312,265,18,29,231,154,47,41,2,4,107,148,104,82,6,16,44,85,63,59,2,2,22,44,31,23,3,5,13,112,67,60,5,2,45
S01010566,876,614,472,117,25,262,138,60,47,11,2,78,229,175,134,34,7,54,115,86,63,17,6,29,95,85,70,12,3,10,299,208,158,43,7,91
S01010567,885,595,450,123,22,290,186,65,43,19,3,121,193,140,95,37,8,53,145,113,87,22,4,32,79,63,49,11,3,16,282,214,176,34,4,68
S01010568,789,552,442,91,19,237,181,91,61,25,5,90,201,145,113,24,8,56,102,82,68,10,4,20,61,48,42,4,2,13,244,186,158,28,0,58
S01010569,722,539,423,99,17,183,137,64,42,22,0,73,247,200,167,27,6,47,109,87,71,12,4,22,67,56,46,7,3,11,162,132,97,31,4,30
S01010570,860,560,464,54,42,300,285,141,117,10,14,144,234,159,130,10,19,75,115,85,73,8,4,30,64,51,44,5,2,13,162,124,100,21,3,38
S01010571,655,515,452,41,22,140,134,76,60,13,3,58,166,140,123,12,5,26,104,96,82,6,8,8,71,59,54,3,2,12,180,144,133,7,4,36
S01010572,613,450,386,26,38,163,153,76,60,4,12,77,191,156,130,10,16,35,96,78,65,5,8,18,55,50,46,3,1,5,118,90,85,4,1,28
S01010573,426,326,292,22,12,100,132,73,68,2,3,59,120,99,90,4,5,21,59,53,42,8,3,6,49,43,37,5,1,6,66,58,55,3,0,8
S01010574,473,330,283,34,13,143,104,39,30,6,3,65,107,77,67,8,2,30,87,72,63,6,3,15,51,40,33,5,2,11,124,102,90,9,3,22
S01010575,577,373,318,32,23,204,116,44,36,5,3,72,128,89,76,8,5,39,94,67,57,5,5,27,43,34,31,3,0,9,196,139,118,11,10,57
S01010576,680,447,368,59,20,233,107,41,30,6,5,66,141,101,82,13,6,40,118,84,75,7,2,34,65,53,44,5,4,12,249,168,137,28,3,81
S01010577,691,474,394,43,37,217,227,120,100,11,9,107,236,177,148,11,18,59,84,67,51,11,5,17,49,36,30,4,2,13,95,74,65,6,3,21
S01010578,461,351,306,29,16,110,117,54,51,3,0,63,165,140,119,11,10,25,67,55,44,7,4,12,32,31,28,3,0,1,80,71,64,5,2,9
S01010579,631,443,379,53,11,188,132,53,44,7,2,79,159,119,101,15,3,40,138,109,94,14,1,29,68,56,50,5,1,12,134,106,90,12,4,28
S01010580,464,331,297,24,10,133,86,34,28,4,2,52,103,73,66,5,2,30,80,63,55,5,3,17,58,45,42,1,2,13,137,116,106,9,1,21
S01010581,423,334,289,31,14,89,60,28,20,6,2,32,99,82,72,6,4,17,78,67,61,3,3,11,54,47,35,10,2,7,132,110,101,6,3,22
S01010582,410,265,220,36,9,145,91,32,24,5,3,59,82,56,43,10,3,26,61,50,41,7,2,11,36,32,30,2,0,4,140,95,82,12,1,45
S01010583,810,584,515,49,20,226,155,71,63,6,2,84,184,138,119,8,11,46,132,117,107,6,4,15,93,76,69,6,1,17,246,182,157,23,2,64
S01010584,596,464,382,58,24,132,71,30,20,6,4,41,158,127,95,22,10,31,96,78,67,7,4,18,85,72,60,10,2,13,186,157,140,13,4,29
S01010585,599,529,455,57,17,70,43,28,23,1,4,15,155,134,110,17,7,21,103,89,76,11,2,14,98,93,81,11,1,5,200,185,165,17,3,15
S01010586,621,447,375,55,17,174,78,32,24,7,1,46,124,95,73,15,7,29,98,76,62,10,4,22,79,61,55,4,2,18,242,183,161,19,3,59
S01010587,588,385,313,56,16,203,95,35,21,10,4,60,128,85,71,7,7,43,84,61,52,8,1,23,73,60,48,11,1,13,208,144,121,20,3,64
S01010588,509,342,293,29,20,167,81,29,21,6,2,52,112,84,67,9,8,28,92,67,56,6,5,25,48,36,30,3,3,12,176,126,119,5,2,50
S01010589,504,377,339,25,13,127,138,70,62,3,5,68,142,110,98,7,5,32,72,64,59,4,1,8,52,43,37,5,1,9,100,90,83,6,1,10
S01010590,627,484,408,60,16,143,77,37,24,8,5,40,116,95,77,16,2,21,93,69,65,3,1,24,82,67,59,6,2,15,259,216,183,27,6,43
S01010591,540,466,414,30,22,74,49,31,22,3,6,18,139,116,104,7,5,23,92,82,75,6,1,10,88,80,72,4,4,8,172,157,141,10,6,15
S01010592,429,317,286,21,10,112,85,32,30,2,0,53,118,98,84,8,6,20,66,54,49,3,2,12,56,46,42,3,1,10,104,87,81,5,1,17
S01010593,512,350,298,49,3,162,98,33,30,3,0,65,112,81,57,21,3,31,85,70,61,9,0,15,45,36,27,9,0,9,172,130,123,7,0,42
S01010594,508,407,352,41,14,101,73,29,25,3,1,44,114,93,82,11,0,21,90,83,72,5,6,7,75,69,60,7,2,6,156,133,113,15,5,23
S01010595,561,477,424,35,18,84,46,22,18,1,3,24,160,135,114,12,9,25,92,82,77,3,2,10,71,64,59,3,2,7,192,174,156,16,2,18
S01010596,628,488,386,81,21,140,79,32,20,11,1,47,141,109,85,17,7,32,101,89,71,14,4,12,73,70,54,12,4,3,234,188,156,27,5,46
S01010597,485,410,344,47,19,75,51,27,15,8,4,24,131,104,86,11,7,27,87,78,62,11,5,9,68,67,58,7,2,1,148,134,123,10,1,14
S01010598,740,622,541,62,19,118,58,34,24,9,1,24,203,162,130,17,15,41,124,106,99,6,1,18,119,109,98,9,2,10,236,211,190,21,0,25
S01010599,474,348,306,25,17,126,56,25,17,5,3,31,101,77,69,3,5,24,80,62,57,1,4,18,54,43,41,2,0,11,183,141,122,14,5,42
S01010600,808,494,410,66,18,314,164,48,36,8,4,116,187,131,104,18,9,56,110,90,73,14,3,20,97,73,65,7,1,24,250,152,132,19,1,98
S01010601,603,301,263,28,10,302,127,27,25,2,0,100,132,69,64,3,2,63,87,61,49,8,4,26,47,31,23,5,3,16,210,113,102,10,1,97
S01010602,449,338,291,27,20,111,76,32,27,4,1,44,88,78,71,4,3,10,83,61,51,7,3,22,58,46,38,4,4,12,144,121,104,8,9,23
S01010603,697,452,391,42,19,245,114,38,27,8,3,76,162,106,90,10,6,56,113,91,81,7,3,22,75,60,51,6,3,15,233,157,142,11,4,76
S01010604,393,260,220,27,13,133,54,17,14,3,0,37,67,45,37,6,2,22,72,54,42,8,4,18,31,23,19,3,1,8,169,121,108,7,6,48
S01010605,765,468,388,67,13,297,169,62,43,15,4,107,141,89,75,11,3,52,135,99,84,14,1,36,78,58,50,6,2,20,242,160,136,21,3,82
S01010606,659,422,351,44,27,237,211,89,71,9,9,122,172,131,107,16,8,41,92,64,53,7,4,28,58,46,37,6,3,12,126,92,83,6,3,34
S01010607,695,468,381,68,19,227,103,38,30,7,1,65,140,94,65,20,9,46,87,71,57,9,5,16,69,59,52,6,1,10,296,206,177,26,3,90
S01010608,503,325,267,18,40,178,160,69,52,3,14,91,167,117,99,4,14,50,63,53,41,7,5,10,43,34,28,2,4,9,70,52,47,2,3,18
S01010609,452,310,270,23,17,142,139,66,55,4,7,73,152,127,115,6,6,25,57,43,40,2,1,14,40,31,28,2,1,9,64,43,32,9,2,21
S01010610,616,359,286,42,31,257,108,33,23,5,5,75,105,63,47,7,9,42,97,72,54,10,8,25,44,33,31,1,1,11,262,158,131,19,8,104
S01010611,779,551,476,40,35,228,209,90,77,6,7,119,226,178,151,14,13,48,120,97,88,6,3,23,75,65,54,7,4,10,149,121,106,7,8,28
S01010612,620,420,368,32,20,200,172,70,61,5,4,102,158,124,106,8,10,34,118,92,82,7,3,26,56,46,40,3,3,10,116,88,79,9,0,28
S01010613,602,341,305,23,13,261,186,41,39,2,0,145,122,86,75,4,7,36,91,67,58,6,3,24,39,32,29,2,1,7,164,115,104,9,2,49
S01010614,443,291,248,14,29,152,177,84,73,4,7,93,138,109,93,4,12,29,48,38,35,1,2,10,36,27,21,1,5,9,44,33,26,4,3,11
S01010615,658,518,466,31,21,140,108,53,40,10,3,55,158,132,116,9,7,26,91,75,70,2,3,16,75,65,61,1,3,10,226,193,179,9,5,33
S01010616,731,485,439,38,8,246,163,52,43,8,1,111,164,119,106,8,5,45,129,103,96,6,1,26,75,65,58,7,0,10,200,146,136,9,1,54
S01010617,737,542,481,47,14,195,141,70,61,9,0,71,205,167,146,16,5,38,102,86,75,8,3,16,77,67,57,8,2,10,212,152,142,6,4,60
S01010618,633,497,436,45,16,136,119,63,52,8,3,56,171,144,128,12,4,27,118,102,87,11,4,16,73,64,57,4,3,9,152,124,112,10,2,28
S01010619,519,409,346,26,37,110,102,61,52,3,6,41,177,148,118,10,20,29,67,54,46,4,4,13,60,54,49,1,4,6,113,92,81,8,3,21
S01010620,560,435,334,27,74,125,89,45,22,3,20,44,169,127,84,5,38,42,90,78,66,4,8,12,61,55,48,4,3,6,151,130,114,11,5,21
S01010621,803,544,430,76,38,259,147,52,39,3,10,95,170,136,110,16,10,34,107,78,67,7,4,29,67,54,45,7,2,13,312,224,169,43,12,88
S01010622,520,354,290,24,40,166,165,70,52,4,14,95,156,119,100,7,12,37,60,46,40,1,5,14,56,47,38,3,6,9,83,72,60,9,3,11
S01010623,554,425,364,26,35,129,57,29,24,2,3,28,210,167,144,8,15,43,87,72,63,2,7,15,66,52,43,4,5,14,134,105,90,10,5,29
S01010624,553,364,324,18,22,189,142,66,57,3,6,76,118,92,84,1,7,26,90,58,47,6,5,32,31,20,17,2,1,11,172,128,119,6,3,44
S01010625,687,390,314,69,7,297,114,28,20,5,3,86,104,69,47,21,1,35,110,71,57,13,1,39,65,51,49,2,0,14,294,171,141,28,2,123
S01010626,794,402,322,68,12,392,194,47,36,8,3,147,125,73,57,14,2,52,88,50,36,12,2,38,51,31,26,3,2,20,336,201,167,31,3,135
S01010627,729,492,392,73,27,237,158,59,39,12,8,99,139,92,74,11,7,47,88,74,59,12,3,14,79,66,56,5,5,13,265,201,164,33,4,64
S01010628,895,587,483,66,38,308,179,58,44,8,6,121,185,124,95,12,17,61,114,89,78,5,6,25,93,69,57,10,2,24,324,247,209,31,7,77
S01010629,812,456,357,76,23,356,197,51,41,4,6,146,110,71,56,10,5,39,97,63,49,11,3,34,66,55,48,4,3,11,342,216,163,47,6,126
S01010630,486,317,263,37,17,169,134,50,35,11,4,84,132,89,73,9,7,43,66,51,44,5,2,15,50,46,41,2,3,4,104,81,70,10,1,23
S01010631,558,372,312,37,23,186,119,32,26,2,4,87,108,81,65,9,7,27,68,55,49,3,3,13,57,52,41,8,3,5,206,152,131,15,6,54
S01010632,805,461,373,50,38,344,279,72,58,5,9,207,194,142,105,22,15,52,115,86,70,9,7,29,70,57,52,1,4,13,147,104,88,13,3,43
S01010633,814,478,405,26,47,336,307,112,94,9,9,195,257,173,142,8,23,84,89,68,60,2,6,21,65,55,49,3,3,10,96,70,60,4,6,26
S01010634,535,346,284,37,25,189,219,94,79,10,5,125,144,110,87,13,10,34,67,57,50,5,2,10,42,36,29,5,2,6,63,49,39,4,6,14
S01010635,641,396,331,34,31,245,260,91,71,10,10,169,151,121,103,6,12,30,70,54,49,3,2,16,45,37,33,2,2,8,115,93,75,13,5,22
S01010636,692,467,381,71,15,225,173,71,49,18,4,102,141,109,93,12,4,32,87,62,48,11,3,25,65,55,47,7,1,10,226,170,144,23,3,56
S01010637,509,331,268,37,26,178,182,75,62,8,5,107,111,84,62,12,10,27,69,59,47,7,5,10,39,32,28,3,1,7,108,81,69,7,5,27
S01010638,741,395,320,50,25,346,308,85,68,13,4,223,155,110,87,10,13,45,80,53,39,12,2,27,55,44,37,5,2,11,143,103,89,10,4,40
S01010639,952,627,517,45,65,325,305,139,108,14,17,166,250,175,130,12,33,75,130,99,88,3,8,31,87,74,68,3,3,13,180,140,123,13,4,40
S01010640,727,545,437,72,36,182,178,84,54,19,11,94,144,117,89,16,12,27,108,90,79,6,5,18,88,75,65,8,2,13,209,179,150,23,6,30
S01010641,782,487,389,34,64,295,245,97,74,7,16,148,268,189,153,12,24,79,90,70,55,6,9,20,69,54,41,4,9,15,110,77,66,5,6,33
S01010642,736,464,372,27,65,272,293,137,107,3,27,156,209,141,114,7,20,68,74,56,37,8,11,18,74,61,56,2,3,13,86,69,58,7,4,17
S01010643,520,354,277,19,58,166,197,105,80,7,18,92,164,121,92,4,25,43,51,40,32,2,6,11,41,32,28,2,2,9,67,56,45,4,7,11
S01010644,515,295,227,12,56,220,219,87,62,5,20,132,168,113,87,3,23,55,49,37,29,1,7,12,33,29,23,1,5,4,46,29,26,2,1,17
S01010645,476,360,318,32,10,116,89,42,34,5,3,47,121,95,78,12,5,26,87,72,68,3,1,15,45,42,37,4,1,3,134,109,101,8,0,25
S01010646,577,388,340,29,19,189,119,47,40,4,3,72,130,92,79,9,4,38,106,83,71,5,7,23,51,41,36,3,2,10,171,125,114,8,3,46
S01010647,633,407,352,38,17,226,173,71,54,10,7,102,161,113,101,7,5,48,81,61,55,4,2,20,43,38,35,1,2,5,175,124,107,16,1,51
S01010648,561,391,333,32,26,170,129,52,38,6,8,77,147,109,89,11,9,38,97,79,73,2,4,18,61,52,48,1,3,9,127,99,85,12,2,28
S01010649,519,316,275,30,11,203,137,39,34,4,1,98,101,68,59,7,2,33,87,67,58,6,3,20,42,37,31,4,2,5,152,105,93,9,3,47
S01010650,416,264,209,39,16,152,105,36,24,7,5,69,112,80,66,10,4,32,71,52,41,7,4,19,38,31,25,6,0,7,90,65,53,9,3,25
S01010651,566,379,312,39,28,187,179,79,67,7,5,100,166,122,98,11,13,44,77,68,55,8,5,9,49,38,32,5,1,11,95,72,60,8,4,23
S01010652,614,408,346,33,29,206,142,52,41,7,4,90,145,101,81,9,11,44,106,81,72,5,4,25,62,53,44,4,5,9,159,121,108,8,5,38
S01010653,534,368,322,37,9,166,144,59,52,7,0,85,150,113,94,11,8,37,79,61,54,6,1,18,62,55,52,3,0,7,99,80,70,10,0,19
S01010654,638,448,364,45,39,190,184,86,61,12,13,98,210,159,130,13,16,51,105,88,71,13,4,17,58,47,43,2,2,11,81,68,59,5,4,13
S01010655,729,494,335,139,20,235,148,60,30,26,4,88,161,108,68,35,5,53,122,96,68,23,5,26,57,49,39,9,1,8,241,181,130,46,5,60
S01010656,364,233,175,43,15,131,101,34,25,7,2,67,89,64,51,8,5,25,55,43,31,9,3,12,29,22,17,5,0,7,90,70,51,14,5,20
S01010657,534,371,266,88,17,163,97,44,26,14,4,53,114,84,63,15,6,30,90,67,46,18,3,23,43,37,24,12,1,6,190,139,107,29,3,51
S01010658,602,398,307,69,22,204,121,47,33,8,6,74,110,71,51,14,6,39,95,77,58,17,2,18,49,42,35,5,2,7,227,161,130,25,6,66
S01010659,544,354,264,70,20,190,97,37,24,11,2,60,105,64,49,10,5,41,68,53,35,15,3,15,56,44,34,8,2,12,218,156,122,26,8,62
S01010660,511,311,247,49,15,200,142,53,36,14,3,89,125,80,63,13,4,45,67,50,40,6,4,17,53,42,38,3,1,11,124,86,70,13,3,38
S01010661,518,350,287,44,19,168,168,67,49,15,3,101,133,102,84,10,8,31,81,70,58,9,3,11,44,42,34,5,3,2,92,69,62,5,2,23
S01010662,614,407,319,79,9,207,123,35,22,12,1,88,166,118,92,23,3,48,89,74,58,11,5,15,66,53,47,6,0,13,170,127,100,27,0,43
S01010663,777,501,374,110,17,276,178,77,47,25,5,101,164,110,84,24,2,54,121,96,66,27,3,25,66,51,40,11,0,15,248,167,137,23,7,81
S01010664,678,450,316,121,13,228,116,40,19,17,4,76,130,97,67,28,2,33,109,76,51,23,2,33,60,43,31,11,1,17,263,194,148,42,4,69
S01010665,774,459,320,119,20,315,166,55,36,18,1,111,186,117,86,25,6,69,104,76,56,18,2,28,69,50,32,15,3,19,249,161,110,43,8,88
S01010666,769,474,365,83,26,295,167,58,45,10,3,109,182,129,93,23,13,53,124,81,67,12,2,43,90,74,54,15,5,16,206,132,106,23,3,74
S01010667,570,397,275,112,10,173,114,41,24,15,2,73,127,97,67,25,5,30,84,64,46,18,0,20,36,31,23,7,1,5,209,164,115,47,2,45
S01010668,948,579,395,148,36,369,239,91,52,32,7,148,233,160,117,31,12,73,130,88,60,26,2,42,80,64,41,19,4,16,266,176,125,40,11,90
S01010669,489,302,209,73,20,187,117,52,31,16,5,65,116,77,49,20,8,39,73,60,43,15,2,13,33,23,18,3,2,10,150,90,68,19,3,60
S01010670,576,380,267,91,22,196,122,54,38,14,2,68,125,87,59,23,5,38,96,73,50,14,9,23,52,41,31,7,3,11,181,125,89,33,3,56
S01010671,628,390,254,108,28,238,101,33,19,8,6,68,127,87,55,22,10,40,121,83,57,20,6,38,55,42,26,15,1,13,224,145,97,43,5,79
S01010672,532,338,251,50,37,194,138,49,34,8,7,89,152,104,77,15,12,48,90,72,54,10,8,18,50,40,28,5,7,10,102,73,58,12,3,29
S01010673,772,486,318,136,32,286,178,62,36,14,12,116,157,107,65,32,10,50,101,77,57,18,2,24,74,57,35,19,3,17,262,183,125,53,5,79
S01010674,759,515,320,165,30,244,147,63,32,28,3,84,170,125,70,41,14,45,133,103,69,25,9,30,64,54,37,17,0,10,245,170,112,54,4,75
S01010675,534,325,201,105,19,209,138,53,29,20,4,85,130,91,56,28,7,39,68,55,37,17,1,13,32,22,17,5,0,10,166,104,62,35,7,62
S01010676,770,460,304,139,17,310,126,43,24,17,2,83,132,81,44,31,6,51,118,70,45,21,4,48,71,51,36,15,0,20,323,215,155,55,5,108
S01010677,420,243,173,59,11,177,78,24,15,7,2,54,74,46,31,11,4,28,78,61,44,15,2,17,32,18,15,3,0,14,158,94,68,23,3,64
S01010678,531,336,232,80,24,195,154,52,30,18,4,102,118,91,64,19,8,27,69,58,42,11,5,11,36,29,19,6,4,7,154,106,77,26,3,48
S01010679,508,314,221,64,29,194,146,50,34,11,5,96,111,79,54,16,9,32,76,67,39,18,10,9,43,28,23,3,2,15,132,90,71,16,3,42
S01010680,533,342,246,73,23,191,152,53,29,19,5,99,127,96,72,17,7,31,83,65,51,10,4,18,49,39,31,7,1,10,122,89,63,20,6,33
S01010681,831,580,437,85,58,251,173,76,51,16,9,97,232,169,122,24,23,63,137,112,85,19,8,25,80,71,55,11,5,9,209,152,124,15,13,57
S01010682,777,534,356,149,29,243,172,73,45,26,2,99,173,139,89,38,12,34,132,104,74,21,9,28,63,52,32,19,1,11,237,166,116,45,5,71
S01010683,833,489,311,148,30,344,234,89,46,32,11,145,163,106,74,26,6,57,144,110,72,33,5,34,59,44,30,10,4,15,233,140,89,47,4,93
S01010684,684,414,256,135,23,270,156,53,26,26,1,103,145,99,54,35,10,46,100,71,51,14,6,29,53,43,24,17,2,10,230,148,101,43,4,82
S01010685,532,306,168,118,20,226,123,43,24,15,4,80,106,76,49,20,7,30,76,58,35,19,4,18,57,31,19,11,1,26,170,98,41,53,4,72
S01010686,585,369,229,119,21,216,124,40,28,11,1,84,140,94,64,22,8,46,80,60,37,18,5,20,49,39,24,14,1,10,192,136,76,54,6,56
S01010687,699,410,284,106,20,289,169,54,40,12,2,115,143,93,66,20,7,50,93,73,48,20,5,20,64,50,34,14,2,14,230,140,96,40,4,90
S01010688,619,388,234,139,15,231,114,46,20,22,4,68,129,89,62,22,5,40,77,59,41,16,2,18,47,35,20,14,1,12,252,159,91,65,3,93
S01010689,669,349,220,116,13,320,179,48,25,19,4,131,121,71,45,26,0,50,94,67,46,16,5,27,54,36,24,11,1,18,221,127,80,44,3,94
S01010690,566,355,244,91,20,211,159,43,29,12,2,116,123,97,69,19,9,26,81,59,38,18,3,22,41,35,20,12,3,6,162,121,88,30,3,41
S01010691,622,409,232,161,16,213,106,46,21,23,2,60,124,86,49,32,5,38,99,71,44,22,5,28,55,38,24,14,0,17,238,168,94,70,4,70
S01010692,599,420,319,89,12,179,133,62,43,15,4,71,175,125,97,25,3,50,103,87,67,19,1,16,45,39,31,6,2,6,143,107,81,24,2,36
S01010693,397,263,162,91,10,134,70,30,17,11,2,40,85,67,39,24,4,18,61,41,24,14,3,20,33,25,14,10,1,8,148,100,68,32,0,48
S01010694,520,256,177,70,9,264,120,35,19,15,1,85,121,75,52,19,4,46,77,43,29,13,1,34,42,27,16,10,1,15,160,76,61,13,2,84
S01010695,614,410,288,99,23,204,123,54,29,22,3,69,130,97,71,17,9,33,92,76,53,18,5,16,54,32,23,8,1,22,215,151,112,34,5,64
S01010696,838,542,424,99,19,296,212,75,50,21,4,137,200,145,121,14,10,55,113,87,71,15,1,26,81,64,54,9,1,17,232,171,128,40,3,61
S01010697,921,546,414,114,18,375,227,76,54,19,3,151,211,147,109,31,7,64,146,103,73,24,6,43,67,42,32,10,0,25,270,178,146,30,2,92
S01010698,610,378,252,102,24,232,167,62,43,15,4,105,142,101,76,16,9,41,77,57,36,14,7,20,46,34,23,11,0,12,178,124,74,46,4,54
S01010699,491,351,257,79,15,140,118,51,38,11,2,67,94,76,53,17,6,18,81,66,48,13,5,15,46,38,25,12,1,8,152,120,93,26,1,32
S01010700,503,343,255,71,17,160,114,44,29,11,4,70,82,56,43,8,5,26,83,63,50,11,2,20,70,54,40,10,4,16,154,126,93,31,2,28
S01010701,841,577,478,74,25,264,179,75,58,11,6,104,223,164,134,22,8,59,128,100,81,12,7,28,99,74,65,7,2,25,212,164,140,22,2,48
S01010702,875,537,404,111,22,338,205,72,45,23,4,133,212,147,105,33,9,65,116,81,64,11,6,35,78,66,51,14,1,12,264,171,139,30,2,93
S01010703,708,469,341,112,16,239,136,54,33,16,5,82,186,138,105,28,5,48,120,86,60,24,2,34,59,48,43,5,0,11,207,143,100,39,4,64
S01010704,537,310,267,33,10,227,202,60,48,7,5,142,151,113,96,13,4,38,45,38,33,4,1,7,40,35,35,0,0,5,99,64,55,9,0,35
S01010705,897,587,470,78,39,310,232,96,62,21,13,136,214,154,127,15,12,60,141,100,88,5,7,41,79,69,57,8,4,10,231,168,136,29,3,63
S01010706,553,347,279,37,31,206,157,59,42,10,7,98,171,126,99,13,14,45,63,47,41,3,3,16,59,46,40,5,1,13,103,69,57,6,6,34
S01010707,593,390,281,100,9,203,141,56,33,22,1,85,103,75,57,17,1,28,94,72,53,17,2,22,64,51,40,11,0,13,191,136,98,33,5,55
S01010708,464,305,241,50,14,159,115,40,34,3,3,75,132,101,82,11,8,31,65,52,36,15,1,13,38,30,23,6,1,8,114,82,66,15,1,32
S01010709,591,420,351,51,18,171,119,46,35,10,1,73,133,102,79,17,6,31,125,105,94,7,4,20,71,59,49,8,2,12,143,108,94,9,5,35
S01010710,610,391,319,26,46,219,220,106,88,5,13,114,187,136,102,11,23,51,83,60,49,4,7,23,40,31,27,3,1,9,80,58,53,3,2,22
S01010711,618,394,334,51,9,224,111,27,20,6,1,84,125,89,75,11,3,36,87,73,63,9,1,14,60,45,37,5,3,15,235,160,139,20,1,75
S01010712,556,385,331,27,27,171,190,101,82,7,12,89,176,133,119,6,8,43,72,58,50,5,3,14,43,34,31,2,1,9,75,59,49,7,3,16
S01010713,633,453,394,29,30,180,201,100,84,8,8,101,177,141,123,4,14,36,105,87,74,7,6,18,41,33,31,2,0,8,109,92,82,8,2,17
S01010714,613,344,292,26,26,269,255,85,68,7,10,170,159,118,102,4,12,41,47,33,26,5,2,14,51,36,34,2,0,15,101,72,62,8,2,29
S01010715,588,373,309,35,29,215,215,87,71,8,8,128,162,119,101,8,10,43,75,57,46,7,4,18,44,39,28,5,6,5,92,71,63,7,1,21
S01010716,782,493,405,48,40,289,214,70,57,3,10,144,192,143,113,15,15,49,91,70,62,3,5,21,61,53,46,4,3,8,224,157,127,23,7,67
S01010717,539,325,282,34,9,214,118,39,36,3,0,79,127,86,73,10,3,41,82,61,55,6,0,21,51,38,31,5,2,13,161,101,87,10,4,60
S01010718,755,530,428,72,30,225,146,65,49,11,5,81,201,152,116,23,13,49,125,96,77,14,5,29,87,73,62,7,4,14,196,144,124,17,3,52
S01010719,564,332,264,55,13,232,141,44,32,7,5,97,122,86,69,15,2,36,72,49,45,4,0,23,44,33,23,8,2,11,185,120,95,21,4,65
S01010720,629,338,261,65,12,291,131,34,25,8,1,97,114,65,54,9,2,49,73,55,44,9,2,18,67,46,37,8,1,21,244,138,101,31,6,106
S01010721,546,335,242,79,14,211,80,29,18,11,0,51,101,69,52,11,6,32,81,63,48,11,4,18,58,42,27,15,0,16,226,132,97,31,4,94
S01010722,710,438,342,68,28,272,175,58,40,12,6,117,165,107,77,19,11,58,82,60,52,4,4,22,59,48,39,7,2,11,229,165,134,26,5,64
S01010723,710,504,368,118,18,206,108,46,27,17,2,62,160,117,75,35,7,43,111,87,70,13,4,24,45,37,26,11,0,8,286,217,170,42,5,69
S01010724,706,490,382,92,16,216,155,59,44,12,3,96,162,113,88,21,4,49,106,86,70,12,4,20,61,54,38,15,1,7,222,178,142,32,4,44
S01010725,600,409,276,121,12,191,110,45,26,18,1,65,123,87,57,26,4,36,99,74,51,21,2,25,60,45,30,13,2,15,208,158,112,43,3,50
S01010726,794,460,358,75,27,334,186,57,41,13,3,129,166,107,79,18,10,59,117,79,61,15,3,38,76,62,47,9,6,14,249,155,130,20,5,94
S01010727,528,326,237,71,18,202,93,32,20,10,2,61,102,65,44,14,7,37,75,58,37,18,3,17,42,34,25,9,0,8,216,137,111,20,6,79
S01010728,418,263,213,42,8,155,65,15,12,3,0,50,84,60,51,5,4,24,63,45,30,12,3,18,34,24,22,2,0,10,172,119,98,20,1,53
S01010729,590,413,317,87,9,177,120,58,40,17,1,62,122,93,70,22,1,29,117,95,74,18,3,22,49,41,36,5,0,8,182,126,97,25,4,56
S01010730,698,469,342,112,15,229,127,44,22,19,3,83,156,118,77,37,4,38,115,91,72,16,3,24,60,44,34,9,1,16,240,172,137,31,4,68
S01010731,752,488,351,94,43,264,161,65,41,12,12,96,166,112,83,18,11,54,103,77,57,13,7,26,68,57,40,13,4,11,254,177,130,38,9,77
S01010732,651,395,324,31,40,256,258,113,91,8,14,145,213,153,124,10,19,60,56,37,35,1,1,19,47,38,33,2,3,9,77,54,41,10,3,23
S01010733,437,267,215,18,34,170,183,74,54,7,13,109,132,94,75,3,16,38,42,32,23,5,4,10,41,34,33,1,0,7,39,33,30,2,1,6
S01010734,723,436,347,37,52,287,256,98,77,8,13,158,233,166,130,11,25,67,89,63,52,4,7,26,50,37,30,4,3,13,95,72,58,10,4,23
S01010735,455,296,234,19,43,159,159,86,60,5,21,73,136,87,72,3,12,49,56,39,31,3,5,17,31,29,26,2,1,2,73,55,45,6,4,18
S01010736,419,260,221,29,10,159,97,26,17,6,3,71,112,72,61,6,5,40,65,53,46,7,0,12,57,49,47,2,0,8,88,60,50,8,2,28
S01010737,889,512,426,48,38,377,295,97,78,14,5,198,229,160,126,14,20,69,120,84,75,7,2,36,64,58,50,3,5,6,181,113,97,10,6,68
S01010738,458,281,246,19,16,177,170,64,58,3,3,106,123,94,78,8,8,29,60,47,42,4,1,13,45,37,33,1,3,8,60,39,35,3,1,21
S01010739,695,457,370,45,42,238,226,92,77,8,7,134,196,143,111,14,18,53,84,66,49,6,11,18,66,58,51,6,1,8,123,98,82,11,5,25
S01010740,387,220,175,12,33,167,153,53,45,1,7,100,133,95,69,8,18,38,40,32,26,2,4,8,15,8,7,0,1,7,46,32,28,1,3,14
S01010741,513,279,220,42,17,234,150,43,37,5,1,107,148,92,67,17,8,56,77,57,44,10,3,20,40,29,23,5,1,11,98,58,49,5,4,40
S01010742,571,368,326,11,31,203,195,79,63,3,13,116,177,141,123,5,13,36,90,66,62,2,2,24,43,37,35,0,2,6,66,45,43,1,1,21
S01010743,531,318,268,13,37,213,177,74,66,2,6,103,204,135,102,7,26,69,77,54,47,3,4,23,32,25,25,0,0,7,41,30,28,1,1,11
S01010744,901,558,458,60,40,343,256,95,78,10,7,161,256,188,157,17,14,68,143,101,77,16,8,42,78,60,48,7,5,18,168,114,98,10,6,54
S01010745,529,315,249,36,30,214,178,67,49,10,8,111,145,98,77,10,11,47,62,50,41,4,5,12,56,42,35,5,2,14,88,58,47,7,4,30
S01010746,842,551,402,113,36,291,202,87,57,18,12,115,216,148,106,26,16,68,131,93,69,20,4,38,85,63,53,8,2,22,208,160,117,41,2,48
S01010747,660,414,336,44,34,246,215,85,65,8,12,130,182,131,106,12,13,51,98,70,54,9,7,28,46,37,28,8,1,9,119,91,83,7,1,28
S01010748,526,311,226,70,15,215,127,47,29,15,3,80,132,89,59,22,8,43,68,49,38,9,2,19,57,42,38,3,1,15,142,84,62,21,1,58
S01010749,504,318,237,58,23,186,136,61,34,19,8,75,121,86,64,15,7,35,71,49,40,6,3,22,45,37,27,7,3,8,131,85,72,11,2,46
S01010750,542,304,201,81,22,238,156,46,28,15,3,110,121,73,44,22,7,48,59,46,32,10,4,13,47,35,24,7,4,12,159,104,73,27,4,55
S01010751,583,328,237,45,46,255,201,51,33,8,10,150,166,127,93,10,24,39,91,67,52,9,6,24,43,32,25,2,5,11,82,51,34,16,1,31
S01010752,586,376,298,37,41,210,159,62,52,5,5,97,170,123,91,12,20,47,80,63,51,4,8,17,76,60,44,10,6,16,101,68,60,6,2,33
S01010753,799,510,370,81,59,289,193,78,53,11,14,115,250,172,110,30,32,78,122,95,73,14,8,27,78,53,44,7,2,25,156,112,90,19,3,44
S01010754,572,313,245,47,21,259,183,48,37,6,5,135,129,86,65,10,11,43,74,50,45,5,0,24,54,41,29,8,4,13,132,88,69,18,1,44
S01010755,542,322,266,40,16,220,195,59,48,9,2,136,131,94,75,11,8,37,79,63,57,4,2,16,46,38,35,2,1,8,91,68,51,14,3,23
S01010756,544,346,272,60,14,198,123,38,25,12,1,85,152,106,82,18,6,46,87,68,60,6,2,19,42,35,27,6,2,7,140,99,78,18,3,41
S01010757,659,378,270,88,20,281,176,66,38,25,3,110,158,104,72,23,9,54,97,67,49,14,4,30,57,39,31,7,1,18,171,102,80,19,3,69
S01010758,604,317,232,67,18,287,165,44,33,7,4,121,139,93,60,25,8,46,93,63,49,11,3,30,39,26,17,8,1,13,168,91,73,16,2,77
S01010759,494,307,249,43,15,187,136,53,41,9,3,83,111,83,64,10,9,28,95,61,55,5,1,34,37,30,28,2,0,7,115,80,61,17,2,35
S01010760,540,251,184,41,26,289,146,24,17,5,2,122,111,61,39,11,11,50,69,43,35,4,4,26,49,30,21,5,4,19,165,93,72,16,5,72
S01010761,443,296,214,61,21,147,100,50,31,16,3,50,97,75,52,13,10,22,63,42,30,8,4,21,44,33,27,4,2,11,139,96,74,20,2,43
S01010762,500,292,204,74,14,208,121,43,24,16,3,78,111,61,47,12,2,50,83,60,41,13,6,23,44,36,22,12,2,8,141,92,70,21,1,49
S01010763,549,334,229,82,23,215,173,67,37,22,8,106,123,87,65,16,6,36,86,65,48,13,4,21,43,30,20,9,1,13,124,85,59,22,4,39
S01010764,497,278,182,87,9,219,136,49,32,17,0,87,117,85,55,27,3,32,64,47,28,15,4,17,37,26,19,6,1,11,143,71,48,22,1,72
S01010765,855,482,348,108,26,373,299,111,70,32,9,188,198,136,109,20,7,62,112,76,55,18,3,36,53,42,32,9,1,11,193,117,82,29,6,76
S01010766,653,345,252,64,29,308,181,59,39,15,5,122,174,102,74,19,9,72,83,60,44,10,6,23,47,37,30,4,3,10,168,87,65,16,6,81
S01010767,582,324,248,39,37,258,168,54,41,4,9,114,184,114,81,13,20,70,72,56,42,9,5,16,54,43,39,3,1,11,104,57,45,10,2,47
S01010768,490,261,203,33,25,229,183,52,36,10,6,131,129,86,64,12,10,43,55,40,32,3,5,15,43,34,29,1,4,9,80,49,42,7,0,31
S01010769,424,238,161,65,12,186,98,29,14,13,2,69,96,63,41,17,5,33,57,42,27,12,3,15,49,35,24,11,0,14,124,69,55,12,2,55
S01010770,720,460,352,79,29,260,207,70,48,14,8,137,206,153,114,26,13,53,103,81,65,12,4,22,48,38,33,5,0,10,156,118,92,22,4,38
S01010771,749,379,254,89,36,370,262,82,51,15,16,180,178,113,72,31,10,65,104,64,43,16,5,40,59,42,31,9,2,17,146,78,57,18,3,68
S01010772,697,379,247,90,42,318,270,92,50,30,12,178,146,99,66,22,11,47,80,58,33,13,12,22,58,48,39,7,2,10,143,82,59,18,5,61
S01010773,651,406,304,79,23,245,190,78,51,22,5,112,174,127,100,17,10,47,80,57,49,7,1,23,72,54,39,11,4,18,135,90,65,22,3,45
S01010774,590,348,247,72,29,242,192,63,30,24,9,129,134,91,71,12,8,43,78,61,46,13,2,17,48,36,30,3,3,12,138,97,70,20,7,41
S01010775,526,391,304,76,11,135,135,68,45,23,0,67,135,115,88,21,6,20,94,80,65,12,3,14,61,54,48,4,2,7,101,74,58,16,0,27
S01010776,456,287,225,36,26,169,173,58,40,10,8,115,103,87,67,11,9,16,71,58,47,5,6,13,35,33,25,5,3,2,74,51,46,5,0,23
S01010777,449,262,206,22,34,187,183,61,45,6,10,122,118,90,63,8,19,28,50,39,34,2,3,11,28,23,22,0,1,5,70,49,42,6,1,21
S01010778,371,227,175,18,34,144,152,62,41,5,16,90,124,92,72,7,13,32,37,28,26,0,2,9,19,14,11,2,1,5,39,31,25,4,2,8
S01010779,612,359,278,26,55,253,230,74,51,6,17,156,166,125,97,6,22,41,81,61,50,5,6,20,44,38,30,2,6,6,91,61,50,7,4,30
S01010780,479,282,241,18,23,197,192,81,67,5,9,111,108,81,69,3,9,27,58,45,41,2,2,13,33,30,27,3,0,3,88,45,37,5,3,43
S01010781,646,433,349,63,21,213,166,71,48,17,6,95,151,108,91,10,7,43,98,81,68,9,4,17,62,47,39,6,2,15,169,126,103,21,2,43
S01010782,513,277,198,49,30,236,187,58,35,12,11,129,120,78,59,7,12,42,91,55,36,15,4,36,48,40,33,5,2,8,67,46,35,10,1,21
S01010783,464,269,221,22,26,195,179,62,47,10,5,117,149,115,94,8,13,34,51,27,24,1,2,24,46,38,33,1,4,8,39,27,23,2,2,12
S01010784,582,370,299,21,50,212,238,96,72,6,18,142,187,153,124,6,23,34,70,54,42,5,7,16,40,32,29,1,2,8,47,35,32,3,0,12
S01010785,580,379,321,40,18,201,168,75,57,12,6,93,146,105,88,12,5,41,82,63,58,4,1,19,50,41,36,3,2,9,134,95,82,9,4,39
S01010786,534,360,313,34,13,174,169,61,49,8,4,108,144,116,98,11,7,28,68,55,50,5,0,13,57,52,49,2,1,5,96,76,67,8,1,20
S01010787,733,475,342,110,23,258,232,89,50,29,10,143,177,135,111,18,6,42,85,70,49,19,2,15,79,65,45,18,2,14,160,116,87,26,3,44
S01010788,506,358,285,63,10,148,146,70,52,17,1,76,130,100,75,21,4,30,80,64,55,8,1,16,49,44,37,6,1,5,101,80,66,11,3,21
S01010789,590,382,265,88,29,208,187,75,45,23,7,112,147,112,72,27,13,35,84,65,51,11,3,19,61,50,35,13,2,11,111,80,62,14,4,31
S01010790,570,352,253,86,13,218,190,66,41,22,3,124,137,95,68,21,6,42,78,60,44,14,2,18,67,56,48,7,1,11,98,75,52,22,1,23
S01010791,720,424,300,98,26,296,191,65,35,25,5,126,142,94,60,25,9,48,101,66,40,20,6,35,85,71,58,11,2,14,201,128,107,17,4,73
S01010792,490,319,272,20,27,171,183,82,67,6,9,101,136,96,78,5,13,40,53,41,35,2,4,12,43,38,38,0,0,5,75,62,54,7,1,13
S01010793,530,361,269,74,18,169,139,58,39,19,0,81,130,100,77,15,8,30,62,46,29,14,3,16,71,63,49,12,2,8,128,94,75,14,5,34
S01010794,435,301,237,48,16,134,87,42,23,15,4,45,114,82,59,14,9,32,58,41,32,7,2,17,63,53,51,2,0,10,113,83,72,10,1,30
S01010795,821,496,385,63,48,325,255,84,54,19,11,171,192,138,100,16,22,54,99,72,55,10,7,27,96,78,71,5,2,18,179,124,105,13,6,55
S01010796,680,478,334,118,26,202,152,71,36,34,1,81,161,121,82,27,12,40,97,72,53,15,4,25,82,72,56,12,4,10,188,142,107,30,5,46
S01010797,633,447,366,69,12,186,130,52,31,20,1,78,150,110,83,21,6,40,86,70,62,8,0,16,101,85,70,12,3,16,166,130,120,8,2,36
S01010798,579,351,260,71,20,228,151,65,32,30,3,86,124,90,62,21,7,34,78,51,40,8,3,27,65,41,34,2,5,24,161,104,92,10,2,57
S01010799,817,456,372,52,32,361,293,81,62,11,8,212,143,101,74,17,10,42,101,75,59,11,5,26,100,74,66,2,6,26,180,125,111,11,3,55
S01010800,608,386,331,27,28,222,213,85,67,7,11,128,191,143,125,10,8,48,75,61,52,5,4,14,71,60,55,0,5,11,58,37,32,5,0,21
S01010801,603,347,301,26,20,256,247,72,62,6,4,175,151,113,97,9,7,38,63,47,42,1,4,16,54,46,41,3,2,8,88,69,59,7,3,19
S01010802,475,319,261,34,24,156,108,43,32,7,4,65,116,87,73,5,9,29,73,63,55,2,6,10,80,63,54,7,2,17,98,63,47,13,3,35
S01010803,499,287,227,28,32,212,146,41,27,3,11,105,130,84,61,10,13,46,62,42,36,4,2,20,60,47,43,3,1,13,101,73,60,8,5,28
S01010804,497,295,253,32,10,202,118,30,23,7,0,88,140,82,69,7,6,58,65,51,42,8,1,14,61,52,49,1,2,9,113,80,70,9,1,33
S01010805,705,452,385,35,32,253,129,44,35,5,4,85,190,140,116,12,12,50,121,82,68,6,8,39,95,72,64,2,6,23,170,114,102,10,2,56
S01010806,741,447,358,36,53,294,242,81,61,6,14,161,199,140,105,14,21,59,96,73,64,5,4,23,84,60,50,2,8,24,120,93,78,9,6,27
S01010807,450,291,245,31,15,159,100,43,34,4,5,57,137,93,76,10,7,44,76,52,45,6,1,24,67,54,47,6,1,13,70,49,43,5,1,21
S01010808,422,269,241,19,9,153,77,33,26,5,2,44,105,68,60,5,3,37,81,61,55,4,2,20,54,38,36,2,0,16,105,69,64,3,2,36
S01010809,675,440,378,35,27,235,166,72,52,13,7,94,159,106,83,10,13,53,88,65,61,4,0,23,88,71,66,2,3,17,174,126,116,6,4,48
S01010810,429,214,155,44,15,215,129,30,18,10,2,99,96,52,40,8,4,44,67,41,31,8,2,26,50,36,26,7,3,14,87,55,40,11,4,32
S01010811,745,467,324,111,32,278,177,65,39,21,5,112,194,147,99,33,15,47,117,78,57,17,4,39,53,44,31,9,4,9,204,133,98,31,4,71
S01010812,434,268,164,72,32,166,112,39,21,15,3,73,128,97,59,23,15,31,55,40,27,6,7,15,24,18,11,6,1,6,115,74,46,22,6,41
S01010813,454,304,188,83,33,150,105,51,36,11,4,54,108,69,41,19,9,39,81,64,36,19,9,17,42,36,26,4,6,6,118,84,49,30,5,34
S01010814,536,346,201,124,21,190,114,51,25,22,4,63,130,91,54,30,7,39,73,56,32,17,7,17,44,33,22,10,1,11,175,115,68,45,2,60
S01010815,377,251,203,42,6,126,122,66,50,12,4,56,80,57,46,10,1,23,48,36,27,8,1,12,30,26,23,3,0,4,97,66,57,9,0,31
S01010816,523,262,191,63,8,261,94,11,10,1,0,83,58,26,20,5,1,32,83,48,38,7,3,35,43,21,13,6,2,22,245,156,110,44,2,89
S01010817,712,431,310,102,19,281,95,24,17,7,0,71,100,48,33,10,5,52,102,56,40,12,4,46,65,43,28,12,3,22,350,260,192,61,7,90
S01010818,826,493,371,96,26,333,128,40,27,11,2,88,112,54,32,11,11,58,104,71,54,15,2,33,85,57,45,11,1,28,397,271,213,48,10,126
S01010819,676,381,301,59,21,295,190,45,39,5,1,145,124,65,47,12,6,59,97,73,61,5,7,24,65,49,42,5,2,16,200,149,112,32,5,51
S01010820,431,271,198,63,10,160,58,23,9,12,2,35,65,39,31,6,2,26,63,40,29,8,3,23,53,35,27,8,0,18,192,134,102,29,3,58
S01010821,499,266,205,56,5,233,62,20,11,7,2,42,71,36,31,4,1,35,80,43,35,7,1,37,39,19,17,2,0,20,247,148,111,36,1,99
S01010822,641,369,263,89,17,272,138,32,22,8,2,106,93,38,26,9,3,55,85,56,38,17,1,29,70,52,42,8,2,18,255,191,135,47,9,64
S01010823,368,248,207,29,12,120,92,27,22,3,2,65,106,80,61,13,6,26,47,36,27,9,0,11,55,51,45,3,3,4,68,54,52,1,1,14
S01010824,535,424,358,45,21,111,58,24,15,6,3,34,125,97,76,13,8,28,90,68,59,6,3,22,96,87,74,8,5,9,166,148,134,12,2,18
S01010825,259,197,171,22,4,62,37,14,9,5,0,23,53,41,35,5,1,12,46,39,33,3,3,7,37,31,28,3,0,6,86,72,66,6,0,14
S01010826,620,374,294,57,23,246,107,44,31,10,3,63,114,60,43,9,8,54,101,68,58,7,3,33,69,53,45,6,2,16,229,149,117,25,7,80
S01010827,491,357,318,25,14,134,92,38,30,8,0,54,104,79,65,9,5,25,94,79,73,4,2,15,67,61,55,1,5,6,134,100,95,3,2,34
S01010828,961,741,621,78,42,220,101,48,41,4,3,53,212,153,120,16,17,59,167,132,112,11,9,35,152,130,108,16,6,22,329,278,240,31,7,51
S01010829,809,476,387,69,20,333,168,34,22,12,0,134,168,109,85,17,7,59,103,66,52,8,6,37,100,74,63,8,3,26,270,193,165,24,4,77
S01010830,476,327,266,32,29,149,95,26,19,3,4,69,101,74,61,4,9,27,84,63,50,8,5,21,71,56,43,6,7,15,125,108,93,11,4,17
S01010831,436,365,319,34,12,71,49,22,14,6,2,27,98,77,64,11,2,21,85,77,64,8,5,8,74,68,65,3,0,6,130,121,112,6,3,9
S01010832,613,469,402,27,40,144,118,66,51,7,8,52,170,121,102,5,14,49,110,94,84,6,4,16,99,90,73,5,12,9,116,98,92,4,2,18
S01010833,739,514,439,67,8,225,98,36,31,5,0,62,123,75,64,11,0,48,109,74,63,8,3,35,111,84,68,14,2,27,298,245,213,29,3,53
S01010834,794,460,397,48,15,334,125,39,33,4,2,86,130,69,53,10,6,61,132,86,79,4,3,46,102,66,58,7,1,36,305,200,174,23,3,105
S01010835,576,328,278,38,12,248,79,21,16,5,0,58,100,43,33,5,5,57,110,71,60,6,5,39,76,53,47,6,0,23,211,140,122,16,2,71
S01010836,696,425,340,52,33,271,133,36,25,10,1,97,104,69,51,11,7,35,109,77,58,10,9,32,75,53,48,3,2,22,275,190,158,18,14,85
S01010837,560,313,261,27,25,247,174,50,41,7,2,124,130,79,61,8,10,51,83,57,48,1,8,26,65,45,37,4,4,20,108,82,74,7,1,26
S01010838,664,455,393,25,37,209,165,58,52,4,2,107,165,117,93,9,15,48,109,90,74,4,12,19,105,89,80,3,6,16,120,101,94,5,2,19
S01010839,593,340,286,26,28,253,132,23,17,2,4,109,130,80,65,7,8,50,98,74,62,6,6,24,58,46,38,2,6,12,175,117,104,9,4,58
S01010840,448,243,209,20,14,205,124,28,20,5,3,96,74,44,36,4,4,30,55,39,33,2,4,16,50,37,33,4,0,13,145,95,87,5,3,50
S01010841,657,418,348,32,38,239,132,31,26,1,4,101,139,88,63,8,17,51,81,55,45,5,5,26,100,78,69,3,6,22,205,166,145,15,6,39
S01010842,808,357,295,26,36,451,349,49,30,4,15,300,159,95,81,8,6,64,83,55,46,3,6,28,80,57,50,4,3,23,137,101,88,7,6,36
S01010843,582,302,252,22,28,280,188,33,26,5,2,155,122,73,59,5,9,49,86,66,53,3,10,20,78,57,50,3,4,21,108,73,64,6,3,35
S01010844,571,341,312,20,9,230,105,29,22,5,2,76,94,51,46,3,2,43,110,77,73,2,2,33,78,56,51,3,2,22,184,128,120,7,1,56
S01010845,528,313,269,22,22,215,157,44,34,5,5,113,105,63,55,4,4,42,72,57,50,4,3,15,74,54,47,3,4,20,120,95,83,6,6,25
S01010846,620,424,358,23,43,196,174,78,59,11,8,96,182,137,108,7,22,45,106,84,78,1,5,22,78,59,55,2,2,19,80,66,58,2,6,14
S01010847,518,388,350,19,19,130,89,36,31,0,5,53,101,78,68,8,2,23,94,75,67,0,8,19,97,79,71,5,3,18,137,120,113,6,1,17
S01010848,519,319,254,17,48,200,195,73,62,5,6,122,158,117,89,5,23,41,59,46,34,1,11,13,48,39,33,2,4,9,59,44,36,4,4,15
S01010849,732,418,340,30,48,314,268,96,74,7,15,172,235,149,119,11,19,86,87,65,55,3,7,22,83,65,54,6,5,18,59,43,38,3,2,16
S01010850,711,346,282,14,50,365,366,123,103,5,15,243,174,114,87,4,23,60,66,39,29,3,7,27,56,44,39,1,4,12,49,26,24,1,1,23
S01010851,608,383,322,10,51,225,245,108,89,3,16,137,182,132,105,4,23,50,68,52,46,2,4,16,62,47,42,1,4,15,51,44,40,0,4,7
S01010852,612,369,307,28,34,243,258,104,85,5,14,154,171,131,109,10,12,40,62,43,37,4,2,19,59,46,38,3,5,13,62,45,38,6,1,17
S01010853,726,458,390,30,38,268,282,115,97,9,9,167,184,134,109,8,17,50,95,70,58,5,7,25,87,70,63,4,3,17,78,69,63,4,2,9
S01010854,701,428,358,23,47,273,253,105,89,4,12,148,234,159,125,9,25,75,57,43,37,2,4,14,85,67,57,4,6,18,72,54,50,4,0,18
S01010855,449,270,227,16,27,179,191,79,65,3,11,112,111,79,65,5,9,32,43,32,28,4,0,11,57,48,42,2,4,9,47,32,27,2,3,15
S01010856,755,381,310,27,44,374,314,86,68,7,11,228,200,127,99,11,17,73,88,60,46,4,10,28,68,46,45,1,0,22,85,62,52,4,6,23
S01010857,644,461,404,21,36,183,149,64,53,6,5,85,171,125,104,7,14,46,126,93,80,3,10,33,95,90,82,2,6,5,103,89,85,3,1,14
S01010858,592,342,287,18,37,250,236,73,59,5,9,163,151,107,87,7,13,44,81,66,55,3,8,15,55,47,41,0,6,8,69,49,45,3,1,20
S01010859,586,319,270,17,32,267,281,96,81,8,7,185,165,108,80,8,20,57,43,34,34,0,0,9,54,41,38,0,3,13,43,40,37,1,2,3
S01010860,528,312,269,10,33,216,197,78,62,2,14,119,157,102,84,6,12,55,52,42,35,1,6,10,63,45,43,1,1,18,59,45,45,0,0,14
S01010861,533,284,232,12,40,249,218,58,48,3,7,160,146,97,72,1,24,49,55,40,32,3,5,15,62,51,43,5,3,11,52,38,37,0,1,14
S01010862,439,234,173,4,57,205,172,52,40,1,11,120,139,87,52,1,34,52,53,39,30,1,8,14,37,29,25,0,4,8,38,27,26,1,0,11
S01010863,677,369,315,32,22,308,195,54,41,8,5,141,93,52,39,7,6,41,104,76,71,4,1,28,72,48,42,2,4,24,213,139,122,11,6,74
S01010864,487,303,266,24,13,184,74,23,20,2,1,51,77,42,35,4,3,35,76,53,48,1,4,23,61,48,40,6,2,13,199,137,123,11,3,62
S01010865,643,310,264,37,9,333,132,13,8,5,0,119,86,43,33,8,2,43,87,50,45,2,3,37,70,47,42,3,2,23,268,157,136,19,2,111
S01010866,670,281,237,35,9,389,222,25,18,7,0,197,92,40,31,7,2,52,92,50,43,3,4,42,64,48,42,5,1,16,200,118,103,13,2,82
S01010867,591,313,249,51,13,278,147,28,23,5,0,119,77,44,33,8,3,33,86,56,40,10,6,30,75,56,47,7,2,19,206,129,106,21,2,77
S01010868,743,353,310,29,14,390,219,22,18,4,0,197,101,55,49,1,5,46,101,78,73,1,4,23,78,54,46,6,2,24,244,144,124,17,3,100
S01010869,632,399,331,45,23,233,108,29,21,5,3,79,95,55,41,10,4,40,102,71,55,9,7,31,88,69,58,7,4,19,239,175,156,14,5,64
S01010870,667,412,344,41,27,255,153,42,29,8,5,111,124,83,71,2,10,41,90,62,47,11,4,28,76,61,54,3,4,15,224,164,143,17,4,60
S01010871,759,462,378,49,35,297,164,37,22,10,5,127,144,84,68,8,8,60,110,82,65,7,10,28,97,83,67,7,9,14,244,176,156,17,3,68
S01010872,624,377,325,29,23,247,164,41,32,6,3,123,133,94,80,9,5,39,105,72,64,4,4,33,77,60,52,4,4,17,145,110,97,6,7,35
S01010873,497,195,166,9,20,302,250,35,29,2,4,215,97,57,45,3,9,40,50,28,25,0,3,22,47,36,30,2,4,11,53,39,37,2,0,14
S01010874,632,433,363,41,29,199,98,29,21,5,3,69,115,77,65,5,7,38,121,88,71,9,8,33,107,88,73,8,7,19,191,151,133,14,4,40
S01010875,426,295,248,25,22,131,96,28,21,3,4,68,83,64,51,5,8,19,64,51,40,3,8,13,75,61,54,6,1,14,108,91,82,8,1,17
S01010876,608,367,317,11,39,241,140,28,25,2,1,112,173,118,94,3,21,55,82,55,45,2,8,27,86,66,61,2,3,20,127,100,92,2,6,27
S01010877,792,465,394,31,40,327,176,42,34,2,6,134,154,92,76,3,13,62,132,94,75,11,8,38,130,92,81,3,8,38,200,145,128,12,5,55
S01010878,1048,471,396,30,45,577,413,93,74,7,12,320,278,137,111,6,20,141,110,75,67,3,5,35,126,89,80,5,4,37,121,77,64,9,4,44
S01010879,705,476,408,40,28,229,206,80,64,11,5,126,160,115,94,10,11,45,120,95,84,7,4,25,105,95,84,5,6,10,114,91,82,7,2,23
S01010880,444,255,208,10,37,189,177,62,52,2,8,115,118,82,64,2,16,36,52,38,31,2,5,14,46,36,28,2,6,10,51,37,33,2,2,14
S01010881,542,298,253,16,29,244,216,55,46,3,6,161,101,69,58,2,9,32,84,60,50,5,5,24,55,45,37,2,6,10,86,69,62,4,3,17
S01010882,457,331,286,12,33,126,115,54,49,1,4,61,122,94,77,2,15,28,80,67,59,1,7,13,64,55,51,1,3,9,76,61,50,7,4,15
S01010883,736,506,444,22,40,230,202,76,63,4,9,126,161,121,97,11,13,40,145,111,99,1,11,34,92,80,73,4,3,12,136,118,112,2,4,18
S01010884,582,285,222,15,48,297,277,79,58,9,12,198,139,83,64,1,18,56,61,41,35,0,6,20,48,41,27,4,10,7,57,41,38,1,2,16
S01010885,778,398,318,17,63,380,313,83,64,6,13,230,192,119,80,3,36,73,90,53,44,2,7,37,89,68,60,2,6,21,94,75,70,4,1,19
S01010886,399,247,190,19,38,152,114,36,24,2,10,78,120,78,56,5,17,42,66,47,36,3,8,19,55,45,36,6,3,10,44,41,38,3,0,3
S01010887,707,305,231,20,54,402,333,69,50,7,12,264,176,105,77,5,23,71,68,37,31,2,4,31,66,47,36,1,10,19,64,47,37,5,5,17
S01010888,682,390,324,20,46,292,265,90,71,7,12,175,172,113,90,5,18,59,63,46,41,1,4,17,79,58,48,4,6,21,103,83,74,3,6,20
S01010889,472,253,200,14,39,219,208,57,44,4,9,151,117,82,63,1,18,35,43,32,25,4,3,11,54,41,31,4,6,13,50,41,37,1,3,9
S01010890,713,263,215,14,34,450,420,73,59,4,10,347,136,81,65,5,11,55,43,31,21,2,8,12,54,39,37,0,2,15,60,39,33,3,3,21
S01010891,390,143,99,9,35,247,204,33,21,3,9,171,76,34,25,0,9,42,35,22,11,0,11,13,38,28,20,3,5,10,37,26,22,3,1,11
S01010892,758,363,297,16,50,395,359,79,55,5,19,280,151,105,86,2,17,46,76,49,43,2,4,27,89,72,62,1,9,17,83,58,51,6,1,25
S01010893,465,193,160,9,24,272,215,39,32,2,5,176,107,60,51,3,6,47,59,34,27,2,5,25,40,32,28,1,3,8,44,28,22,1,5,16
S01010894,579,325,275,17,33,254,207,40,27,4,9,167,126,80,63,3,14,46,80,59,50,2,7,21,68,60,56,2,2,8,98,86,79,6,1,12
S01010895,358,161,124,10,27,197,162,34,22,3,9,128,89,53,37,2,14,36,45,28,24,1,3,17,27,21,19,2,0,6,35,25,22,2,1,10
S01010896,568,284,224,16,44,284,224,69,50,6,13,155,170,102,75,6,21,68,72,48,45,2,1,24,58,39,29,2,8,19,44,26,25,0,1,18
S01010897,670,367,294,15,58,303,295,112,87,5,20,183,193,126,97,4,25,67,76,52,42,2,8,24,59,43,38,1,4,16,47,34,30,3,1,13
S01010898,505,284,221,23,40,221,207,74,57,9,8,133,147,103,77,9,17,44,58,39,28,2,9,19,50,39,33,1,5,11,43,29,26,2,1,14
S01010899,478,344,293,17,34,134,141,63,52,4,7,78,143,114,95,4,15,29,79,64,54,4,6,15,60,51,44,2,5,9,55,52,48,3,1,3
S01010900,508,308,248,12,48,200,180,69,52,3,14,111,161,114,89,4,21,47,63,48,38,3,7,15,61,42,37,2,3,19,43,35,32,0,3,8
S01010901,351,183,143,8,32,168,167,58,45,4,9,109,107,73,54,1,18,34,34,21,17,1,3,13,20,14,10,2,2,6,23,17,17,0,0,6
S01010902,825,463,389,22,52,362,368,111,89,5,17,257,184,139,116,4,19,45,97,68,60,2,6,29,83,71,59,5,7,12,93,74,65,6,3,19
S01010903,667,313,250,15,48,354,320,84,67,7,10,236,158,106,78,5,23,52,71,40,38,0,2,31,67,46,39,1,6,21,51,37,28,2,7,14
S01010904,446,250,195,12,43,196,187,56,46,1,9,131,141,96,72,3,21,45,50,40,31,4,5,10,34,26,20,1,5,8,34,32,26,3,3,2
S01010905,502,319,282,17,20,183,137,40,30,7,3,97,127,83,69,5,9,44,81,61,56,3,2,20,60,51,48,1,2,9,97,84,79,1,4,13
S01010906,746,496,420,24,52,250,270,124,99,9,16,146,212,152,124,7,21,60,93,72,60,3,9,21,82,67,61,2,4,15,89,81,76,3,2,8
S01010907,394,332,299,18,15,62,58,28,27,0,1,30,90,75,64,5,6,15,60,52,45,3,4,8,69,64,59,4,1,5,117,113,104,6,3,4
S01010908,512,301,259,19,23,211,185,64,53,4,7,121,106,72,66,0,6,34,71,54,44,5,5,17,65,48,42,2,4,17,85,63,54,8,1,22
S01010909,616,374,324,25,25,242,188,57,44,6,7,131,120,75,61,7,7,45,98,69,64,2,3,29,81,65,59,4,2,16,129,108,96,6,6,21
S01010910,405,227,170,9,48,178,154,46,33,3,10,108,119,76,52,2,22,43,44,35,29,2,4,9,51,43,34,0,9,8,37,27,22,2,3,10
S01010911,495,201,166,8,27,294,265,47,36,4,7,218,95,56,48,2,6,39,47,36,30,2,4,11,24,16,12,0,4,8,64,46,40,0,6,18
S01010912,593,226,179,17,30,367,322,61,48,5,8,261,100,61,44,4,13,39,47,24,20,1,3,23,59,37,30,5,2,22,65,43,37,2,4,22
S01010913,537,344,296,33,15,193,139,49,41,7,1,90,137,95,76,9,10,42,83,65,54,10,1,18,75,56,51,2,3,19,103,79,74,5,0,24
S01010914,539,404,351,26,27,135,143,78,62,13,3,65,155,119,103,4,12,36,93,79,69,4,6,14,77,64,59,2,3,13,71,64,58,3,3,7
S01010915,592,416,368,23,25,176,167,82,69,7,6,85,179,121,102,7,12,58,75,64,58,2,4,11,90,80,73,4,3,10,81,69,66,3,0,12
S01010916,486,226,167,12,47,260,212,67,40,7,20,145,123,73,56,2,15,50,58,27,22,1,4,31,54,32,23,1,8,22,39,27,26,1,0,12
S01010917,620,343,293,17,33,277,244,65,50,5,10,179,145,102,85,4,13,43,73,51,43,4,4,22,67,57,51,1,5,10,91,68,64,3,1,23
S01010918,612,306,260,17,29,306,276,75,59,8,8,201,152,96,79,5,12,56,63,45,37,3,5,18,53,39,35,1,3,14,68,51,50,0,1,17
S01010919,658,361,307,18,36,297,280,87,73,6,8,193,171,112,85,8,19,59,81,64,56,1,7,17,61,49,45,2,2,12,65,49,48,1,0,16
S01010920,452,253,174,23,56,199,201,72,45,7,20,129,128,86,57,3,26,42,42,32,26,2,4,10,31,22,12,6,4,9,50,41,34,5,2,9
S01010921,521,296,238,11,47,225,242,92,74,3,15,150,147,98,68,5,25,49,45,31,27,0,4,14,48,39,36,0,3,9,39,36,33,3,0,3
S01010922,721,350,285,16,49,371,359,110,90,5,15,249,184,113,85,6,22,71,74,55,49,2,4,19,59,43,36,1,6,16,45,29,25,2,2,16
S01010923,729,394,323,22,49,335,322,88,67,8,13,234,204,147,114,7,26,57,78,63,52,4,7,15,62,48,44,2,2,14,63,48,46,1,1,15
S01010924,512,291,256,14,21,221,252,86,71,6,9,166,136,106,96,2,8,30,46,37,32,1,4,9,33,29,28,1,0,4,45,33,29,4,0,12
S01010925,678,366,292,20,54,312,304,88,68,7,13,216,193,132,102,5,25,61,61,49,42,3,4,12,63,53,43,2,8,10,57,44,37,3,4,13
S01010926,649,364,292,21,51,285,300,106,79,12,15,194,170,115,92,3,20,55,75,53,44,3,6,22,55,48,42,2,4,7,49,42,35,1,6,7
S01010927,461,252,220,12,20,209,235,78,65,2,11,157,118,83,69,6,8,35,37,31,30,1,0,6,35,24,23,0,1,11,36,36,33,3,0,0
S01010928,561,302,236,25,41,259,224,79,58,8,13,145,175,107,74,11,22,68,56,41,38,0,3,15,68,51,45,3,3,17,38,24,21,3,0,14
S01010929,516,271,213,14,44,245,240,90,75,4,11,150,165,105,81,2,22,60,41,26,19,0,7,15,36,26,22,4,0,10,34,24,16,4,4,10
S01010930,712,549,410,115,24,163,85,51,30,16,5,34,115,94,70,19,5,21,96,73,55,16,2,23,64,54,37,15,2,10,352,277,218,49,10,75
S01010931,372,234,156,66,12,138,82,30,18,10,2,52,76,48,35,8,5,28,55,39,21,14,4,16,35,25,17,8,0,10,124,92,65,26,1,32
S01010932,468,286,234,33,19,182,164,54,39,10,5,110,129,95,78,7,10,34,51,34,28,4,2,17,30,25,18,6,1,5,94,78,71,6,1,16
S01010933,576,413,335,65,13,163,99,37,23,12,2,62,123,89,65,19,5,34,84,62,51,8,3,22,53,44,34,9,1,9,217,181,162,17,2,36
S01010934,835,574,479,73,22,261,123,33,23,8,2,90,168,119,93,14,12,49,143,121,102,13,6,22,79,62,55,6,1,17,322,239,206,32,1,83
S01010935,575,277,218,43,16,298,130,25,21,4,0,105,131,79,55,12,12,52,89,48,42,6,0,41,35,19,17,0,2,16,190,106,83,21,2,84
S01010936,627,375,310,44,21,252,181,47,34,8,5,134,133,86,70,8,8,47,95,75,67,5,3,20,60,49,39,7,3,11,158,118,100,16,2,40
S01010937,627,435,372,42,21,192,138,60,48,6,6,78,180,133,111,11,11,47,117,85,77,7,1,32,60,50,41,8,1,10,132,107,95,10,2,25
S01010938,636,390,309,21,60,246,249,98,76,5,17,151,205,154,114,10,30,51,64,51,39,4,8,13,42,31,29,1,1,11,76,56,51,1,4,20
S01010939,421,291,237,30,24,130,69,28,20,8,0,41,120,82,60,9,13,38,89,66,58,6,2,23,40,34,27,3,4,6,103,81,72,4,5,22
S01010940,587,388,340,32,16,199,69,17,15,1,1,52,152,100,81,12,7,52,123,94,86,5,3,29,60,41,35,5,1,19,183,136,123,9,4,47
S01010941,716,477,401,54,22,239,101,38,32,5,1,63,166,109,86,18,5,57,133,97,80,10,7,36,83,62,56,4,2,21,233,171,147,17,7,62
S01010942,563,345,305,31,9,218,91,31,21,10,0,60,123,80,67,8,5,43,118,85,80,3,2,33,56,41,37,4,0,15,175,108,100,6,2,67
S01010943,486,344,284,20,40,142,129,57,43,3,11,72,154,120,95,5,20,34,74,60,47,7,6,14,51,39,36,2,1,12,78,68,63,3,2,10
S01010944,525,298,254,14,30,227,211,62,52,3,7,149,108,73,58,3,12,35,102,83,71,4,8,19,34,27,25,2,0,7,70,53,48,2,3,17
S01010945,441,313,263,27,23,128,175,96,77,9,10,79,117,99,81,11,7,18,51,43,37,1,5,8,37,28,26,2,0,9,61,47,42,4,1,14
S01010946,682,443,367,40,36,239,244,94,75,10,9,150,212,160,124,17,19,52,99,86,73,7,6,13,54,44,42,2,0,10,73,59,53,4,2,14
S01010947,440,272,224,24,24,168,154,64,51,5,8,90,135,98,76,11,11,37,55,40,36,2,2,15,33,22,19,2,1,11,63,48,42,4,2,15
S01010948,553,355,295,31,29,198,181,66,54,6,6,115,165,122,101,9,12,43,81,66,51,7,8,15,59,46,40,4,2,13,67,55,49,5,1,12
S01010949,832,527,453,58,16,305,179,56,42,13,1,123,187,122,105,12,5,65,170,126,117,8,1,44,82,63,53,9,1,19,214,160,136,16,8,54
S01010950,695,417,343,39,35,278,176,58,49,4,5,118,190,132,105,10,17,58,120,90,77,8,5,30,65,54,42,5,7,11,144,83,70,12,1,61
S01010951,507,345,302,22,21,162,128,58,53,3,2,70,166,121,104,8,9,45,84,63,54,4,5,21,41,33,30,2,1,8,88,70,61,5,4,18
S01010952,410,316,273,28,15,94,76,44,34,9,1,32,128,89,76,9,4,39,81,72,64,5,3,9,37,36,35,0,1,1,88,75,64,5,6,13
S01010953,467,330,294,23,13,137,107,48,43,2,3,59,131,95,83,6,6,36,93,76,70,5,1,17,48,43,36,6,1,5,88,68,62,4,2,20
S01010954,528,404,355,39,10,124,87,46,36,9,1,41,190,152,133,15,4,38,105,90,78,9,3,15,48,41,36,3,2,7,98,75,72,3,0,23
S01010955,720,507,416,63,28,213,94,45,34,7,4,49,198,138,118,6,14,60,124,100,83,12,5,24,72,61,55,5,1,11,232,163,126,33,4,69
S01010956,575,403,281,102,20,172,122,61,39,17,5,61,111,80,54,18,8,31,67,48,34,13,1,19,51,41,31,8,2,10,224,173,123,46,4,51
S01010957,473,310,271,33,6,163,91,30,27,3,0,61,117,81,69,10,2,36,73,62,57,4,1,11,51,40,37,3,0,11,141,97,81,13,3,44
S01010958,424,244,195,38,11,180,128,35,28,5,2,93,84,61,46,9,6,23,65,46,38,8,0,19,31,20,18,2,0,11,116,82,65,14,3,34
S01010959,486,324,261,40,23,162,104,31,28,0,3,73,106,74,53,12,9,32,64,51,44,3,4,13,46,37,31,5,1,9,166,131,105,20,6,35
S01010960,876,593,462,66,65,283,296,122,93,14,15,174,247,196,147,21,28,51,114,97,78,10,9,17,52,45,34,6,5,7,167,133,110,15,8,34
S01010961,472,294,247,27,20,178,168,59,48,6,5,109,136,100,82,8,10,36,56,44,39,3,2,12,36,25,22,2,1,11,76,66,56,8,2,10
S01010962,508,276,232,32,12,232,220,90,73,15,2,130,104,61,54,4,3,43,47,35,30,1,4,12,37,31,28,2,1,6,100,59,47,10,2,41
S01010963,766,547,453,63,31,219,208,83,62,15,6,125,233,177,147,17,13,56,112,99,86,8,5,13,51,44,32,8,4,7,162,144,126,15,3,18
S01010964,444,268,231,26,11,176,157,56,48,6,2,101,126,96,80,15,1,30,63,48,42,1,5,15,35,26,24,2,0,9,63,42,37,2,3,21
S01010965,419,275,229,14,32,144,169,72,57,4,11,97,126,98,79,5,14,28,53,45,41,1,3,8,25,22,18,3,1,3,46,38,34,1,3,8
S01010966,582,369,296,37,36,213,229,89,70,10,9,140,172,130,97,15,18,42,71,55,46,2,7,16,45,38,36,2,0,7,65,57,47,8,2,8
S01010967,552,343,283,30,30,209,199,73,61,6,6,126,158,122,94,11,17,36,63,50,43,4,3,13,57,45,39,3,3,12,75,53,46,6,1,22
S01010968,603,363,305,36,22,240,158,47,36,7,4,111,195,137,112,14,11,58,87,66,55,8,3,21,59,40,36,3,1,19,104,73,66,4,3,31
S01010969,545,291,230,45,16,254,156,47,31,11,5,109,135,89,68,13,8,46,69,43,35,7,1,26,42,25,21,4,0,17,143,87,75,10,2,56
S01010970,790,511,416,64,31,279,242,91,77,9,5,151,211,159,125,19,15,52,107,83,62,15,6,24,71,62,55,4,3,9,159,116,97,17,2,43
S01010971,825,600,491,72,37,225,149,73,53,16,4,76,235,172,128,27,17,63,148,122,107,8,7,26,88,76,71,1,4,12,205,157,132,20,5,48
S01010972,643,418,349,27,42,225,217,91,77,8,6,126,212,155,116,15,24,57,92,72,65,2,5,20,65,57,49,2,6,8,57,43,42,0,1,14
S01010973,419,259,223,25,11,160,115,39,31,7,1,76,141,101,90,6,5,40,70,54,52,2,0,16,32,23,21,2,0,9,61,42,29,8,5,19
S01010974,593,369,312,31,26,224,286,126,104,9,13,160,139,103,89,7,7,36,72,62,54,4,4,10,41,33,26,6,1,8,55,45,39,5,1,10
S01010975,380,231,182,21,28,149,164,67,56,8,3,97,99,73,55,3,15,26,55,42,30,4,8,13,27,23,18,3,2,4,35,26,23,3,0,9
S01010976,477,282,247,21,14,195,157,46,39,4,3,111,129,89,73,10,6,40,70,51,48,2,1,19,29,25,23,2,0,4,92,71,64,3,4,21
S01010977,604,392,344,27,21,212,201,74,59,10,5,127,170,123,102,11,10,47,84,72,63,3,6,12,56,42,40,2,0,14,93,81,80,1,0,12
S01010978,599,372,306,31,35,227,225,77,61,6,10,148,173,133,106,8,19,40,81,66,60,4,2,15,45,38,30,5,3,7,75,58,49,8,1,17
S01010979,651,434,359,35,40,217,198,83,65,8,10,115,224,176,147,13,16,48,82,63,49,8,6,19,59,49,45,2,2,10,88,63,53,4,6,25
S01010980,601,371,306,38,27,230,198,72,60,6,6,126,161,105,88,9,8,56,93,70,55,6,9,23,45,41,29,11,1,4,104,83,74,6,3,21
S01010981,612,338,281,32,25,274,229,80,60,7,13,149,152,90,74,10,6,62,75,55,46,6,3,20,50,37,32,2,3,13,106,76,69,7,0,30
S01010982,1049,600,443,127,30,449,206,63,49,9,5,143,225,127,92,27,8,98,143,88,62,18,8,55,85,63,48,10,5,22,390,259,192,63,4,131
S01010983,665,408,342,47,19,257,204,75,65,9,1,129,188,132,100,19,13,56,88,67,57,7,3,21,41,30,25,3,2,11,144,104,95,9,0,40
S01010984,578,284,237,33,14,294,163,55,46,7,2,108,152,72,53,12,7,80,90,57,49,5,3,33,58,33,31,1,1,25,115,67,58,8,1,48
S01010985,503,326,275,27,24,177,155,52,42,4,6,103,131,96,75,10,11,35,88,73,68,4,1,15,51,43,36,5,2,8,78,62,54,4,4,16
S01010986,397,311,267,37,7,86,46,19,15,3,1,27,104,85,72,10,3,19,93,79,71,7,1,14,47,42,33,8,1,5,107,86,76,9,1,21
S01010987,453,362,295,54,13,91,54,26,17,8,1,28,110,83,59,19,5,27,87,77,67,7,3,10,57,48,38,7,3,9,145,128,114,13,1,17
S01010988,450,362,315,33,14,88,62,34,26,4,4,28,119,99,84,13,2,20,101,82,74,3,5,19,47,38,36,2,0,9,121,109,95,11,3,12
S01010989,692,636,563,62,11,56,36,19,15,4,0,17,175,162,139,20,3,13,155,147,128,15,4,8,80,75,65,9,1,5,246,233,216,14,3,13
S01010990,636,403,338,40,25,233,218,76,59,13,4,142,179,141,117,16,8,38,103,80,70,6,4,23,45,36,32,3,1,9,91,70,60,2,8,21
S01010991,435,311,257,34,20,124,108,50,35,9,6,58,124,96,80,9,7,28,63,53,42,6,5,10,46,38,35,2,1,8,94,74,65,8,1,20
S01010992,402,328,276,42,10,74,39,21,11,9,1,18,96,80,64,10,6,16,48,32,25,6,1,16,48,40,34,5,1,8,171,155,142,12,1,16
S01010993,508,352,304,32,16,156,130,45,37,6,2,85,130,105,88,10,7,25,78,61,56,2,3,17,52,44,36,7,1,8,118,97,87,7,3,21
S01010994,896,552,456,82,14,344,150,28,24,3,1,122,155,91,73,11,7,64,124,75,61,13,1,49,79,58,49,6,3,21,388,300,249,49,2,88
S01010995,608,423,367,40,16,185,99,46,37,8,1,53,164,118,101,13,4,46,121,93,79,9,5,28,71,51,49,1,1,20,153,115,101,9,5,38
S01010996,514,332,266,55,11,182,115,33,24,9,0,82,87,50,35,11,4,37,91,67,53,11,3,24,38,31,27,3,1,7,183,151,127,21,3,32
S01010997,561,303,245,46,12,258,107,29,17,12,0,78,127,63,45,13,5,64,83,49,39,6,4,34,43,33,28,3,2,10,201,129,116,12,1,72
S01010998,495,304,218,73,13,191,66,10,6,3,1,56,69,47,32,10,5,22,78,54,36,13,5,24,33,26,22,4,0,7,249,167,122,43,2,82
S01010999,746,402,337,47,18,344,165,33,22,6,5,132,120,60,47,8,5,60,99,63,51,9,3,36,55,36,29,6,1,19,307,210,188,18,4,97
S01011000,680,464,358,82,24,216,172,74,46,21,7,98,147,104,80,13,11,43,105,69,55,12,2,36,72,65,50,11,4,7,184,152,127,25,0,32
S01011001,534,337,286,31,20,197,210,79,68,7,4,131,162,130,113,10,7,32,56,42,37,1,4,14,43,35,31,3,1,8,63,51,37,10,4,12
S01011002,594,358,305,28,25,236,226,77,63,9,5,149,180,134,117,4,13,46,81,64,58,1,5,17,35,30,26,3,1,5,72,53,41,11,1,19
S01011003,553,353,289,32,32,200,194,67,52,10,5,127,194,148,124,9,15,46,66,57,43,7,7,9,39,31,26,3,2,8,60,50,44,3,3,10
S01011004,486,363,302,39,22,123,110,49,36,9,4,61,143,109,93,10,6,34,68,61,51,2,8,7,47,40,28,10,2,7,118,104,94,8,2,14
S01011005,556,322,270,25,27,234,203,59,48,3,8,144,137,93,76,10,7,44,72,56,45,5,6,16,56,44,38,1,5,12,88,70,63,6,1,18
S01011006,804,578,499,57,22,226,219,79,62,11,6,140,238,195,160,26,9,43,108,96,87,5,4,12,64,54,49,4,1,10,175,154,141,11,2,21
S01011007,542,331,281,24,26,211,238,95,77,7,11,143,156,120,98,12,10,36,69,57,51,1,5,12,30,21,20,1,0,9,49,38,35,3,0,11
S01011008,653,402,333,29,40,251,252,95,73,12,10,157,203,147,120,8,19,56,83,66,59,4,3,17,43,38,34,0,4,5,72,56,47,5,4,16
S01011009,416,305,265,16,24,111,146,77,68,3,6,69,142,121,105,2,14,21,48,39,35,2,2,9,38,32,28,3,1,6,42,36,29,6,1,6
S01011010,510,300,248,16,36,210,179,49,39,3,7,130,133,96,76,2,18,37,59,48,39,2,7,11,31,23,19,2,2,8,108,84,75,7,2,24
S01011011,663,368,300,15,53,295,267,78,61,6,11,189,196,143,111,1,31,53,65,45,37,4,4,20,53,37,32,1,4,16,82,65,59,3,3,17
S01011012,540,328,256,17,55,212,200,77,66,3,8,123,173,124,90,4,30,49,68,53,42,0,11,15,28,23,19,1,3,5,71,51,39,9,3,20
S01011013,668,396,347,22,27,272,252,74,65,4,5,178,211,157,133,9,15,54,75,60,52,5,3,15,52,46,45,0,1,6,78,59,52,4,3,19
S01011014,691,490,422,37,31,201,183,87,72,8,7,96,204,153,128,11,14,51,109,89,78,5,6,20,77,64,58,5,1,13,118,97,86,8,3,21
S01011015,380,263,213,28,22,117,121,53,43,6,4,68,111,86,70,8,8,25,60,50,39,7,4,10,39,33,26,3,4,6,49,41,35,4,2,8
S01011016,632,527,420,75,32,105,72,38,30,6,2,34,154,126,92,27,7,28,116,99,75,14,10,17,86,82,67,9,6,4,204,182,156,19,7,22
S01011017,692,459,337,102,20,233,106,48,28,17,3,58,143,96,64,22,10,47,96,65,48,14,3,31,65,46,32,13,1,19,282,204,165,36,3,78
S01011018,709,450,362,62,26,259,234,80,65,9,6,154,185,143,115,19,9,42,81,60,43,10,7,21,56,46,38,5,3,10,153,121,101,19,1,32
S01011019,794,568,430,103,35,226,160,81,57,18,6,79,177,136,102,17,17,41,100,82,60,18,4,18,77,56,46,9,1,21,280,213,165,41,7,67
S01011020,378,267,216,41,10,111,65,25,17,7,1,40,68,46,36,5,5,22,60,50,40,6,4,10,45,36,29,7,0,9,140,110,94,16,0,30
S01011021,719,438,359,36,43,281,274,100,76,10,14,174,215,159,131,10,18,56,89,72,58,6,8,17,56,43,38,5,0,13,85,64,56,5,3,21
S01011022,451,296,244,26,26,155,189,93,76,9,8,96,151,112,94,7,11,39,51,39,31,5,3,12,16,13,10,1,2,3,44,39,33,4,2,5
S01011023,665,438,365,44,29,227,238,108,82,18,8,130,206,149,124,11,14,57,78,66,54,12,0,12,54,44,39,3,2,10,89,71,66,0,5,18
S01011024,586,367,299,24,44,219,194,63,52,2,9,131,221,154,125,9,20,67,63,54,43,5,6,9,52,47,35,5,7,5,56,49,44,3,2,7
S01011025,556,401,333,19,49,155,203,113,93,4,16,90,187,152,126,3,23,35,75,60,51,2,7,15,40,33,26,4,3,7,51,43,37,6,0,8
S01011026,456,299,242,23,34,157,182,86,66,7,13,96,148,113,88,10,15,35,72,51,44,5,2,21,25,21,19,0,2,4,29,28,25,1,2,1
S01011027,706,445,357,31,57,261,283,123,92,13,18,160,218,156,122,7,27,62,97,73,63,1,9,24,35,29,23,3,3,6,73,64,57,7,0,9
S01011028,739,426,347,29,50,313,281,96,75,7,14,185,255,182,143,11,28,73,75,47,41,4,2,28,60,45,39,3,3,15,68,56,49,4,3,12
S01011029,509,322,275,22,25,187,168,70,55,5,10,98,173,114,96,6,12,59,65,51,50,0,1,14,41,38,32,6,0,3,62,49,42,5,2,13
S01011030,798,572,496,56,20,226,201,98,83,13,2,103,263,192,158,24,10,71,138,111,98,10,3,27,71,62,59,2,1,9,125,109,98,7,4,16
S01011031,576,343,291,20,32,233,231,90,76,5,9,141,182,137,115,7,15,45,67,47,43,2,2,20,36,31,25,2,4,5,60,38,32,4,2,22
S01011032,652,410,322,37,51,242,241,101,73,16,12,140,200,147,113,6,28,53,93,70,56,6,8,23,53,41,37,4,0,12,65,51,43,5,3,14
S01011033,524,376,331,30,15,148,144,59,52,3,4,85,151,114,96,11,7,37,75,66,57,6,3,9,48,45,41,4,0,3,106,92,85,6,1,14
S01011034,563,319,269,31,19,244,240,57,44,4,9,183,117,87,69,12,6,30,72,57,49,6,2,15,38,33,30,2,1,5,96,85,77,7,1,11
S01011035,517,348,279,32,37,169,168,69,47,10,12,99,155,116,94,7,15,39,56,50,40,4,6,6,47,36,34,0,2,11,91,77,64,11,2,14
S01011036,541,362,306,35,21,179,150,60,46,7,7,90,134,101,78,14,9,33,98,72,67,4,1,26,43,35,31,3,1,8,116,94,84,7,3,22
S01011037,742,470,371,44,55,272,238,94,64,10,20,144,237,162,125,13,24,75,87,67,56,7,4,20,72,56,49,2,5,16,108,91,77,12,2,17
S01011038,663,408,321,30,57,255,261,109,91,6,12,152,221,157,112,15,30,64,87,72,60,4,8,15,53,46,35,5,6,7,41,24,23,0,1,17
S01011039,676,434,358,42,34,242,218,80,62,9,9,138,187,141,120,12,9,46,89,66,54,7,5,23,57,48,38,4,6,9,125,99,84,10,5,26
S01011040,562,354,288,23,43,208,195,79,63,3,13,116,190,131,96,11,24,59,83,67,58,5,4,16,47,43,40,1,2,4,47,34,31,3,0,13
S01011041,629,314,254,24,36,315,239,62,44,8,10,177,207,130,102,9,19,77,61,42,36,1,5,19,41,29,27,1,1,12,81,51,45,5,1,30
S01011042,642,460,385,47,28,182,143,67,49,11,7,76,181,133,111,9,13,48,94,75,61,10,4,19,64,59,53,5,1,5,160,126,111,12,3,34
S01011043,561,346,278,27,41,215,204,82,60,7,15,122,161,121,96,7,18,40,61,44,37,4,3,17,51,36,30,4,2,15,84,63,55,5,3,21
S01011044,568,353,269,40,44,215,185,68,53,9,6,117,201,148,107,14,27,53,67,47,36,5,6,20,40,32,28,2,2,8,75,58,45,10,3,17
S01011045,644,426,275,113,38,218,165,75,36,27,12,90,158,115,75,27,13,43,86,58,42,14,2,28,64,54,39,10,5,10,171,124,83,35,6,47
S01011046,717,482,328,133,21,235,197,96,53,38,5,101,179,138,109,23,6,41,98,78,58,17,3,20,63,45,30,11,4,18,180,125,78,44,3,55
S01011047,789,489,382,84,23,300,202,91,73,17,1,111,195,132,103,21,8,63,125,86,64,14,8,39,73,55,43,10,2,18,194,125,99,22,4,69
S01011048,805,505,402,74,29,300,285,104,75,23,6,181,190,146,124,10,12,44,121,93,78,11,4,28,59,53,43,7,3,6,150,109,82,23,4,41
S01011049,581,367,323,30,14,214,227,91,79,9,3,136,151,123,109,8,6,28,63,52,47,2,3,11,43,36,32,4,0,7,97,65,56,7,2,32
S01011050,651,438,342,75,21,213,167,69,48,19,2,98,142,108,85,17,6,34,85,60,52,3,5,25,71,63,51,7,5,8,186,138,106,29,3,48
S01011051,780,502,399,83,20,278,242,93,68,19,6,149,201,150,122,20,8,51,102,83,60,22,1,19,65,53,47,5,1,12,170,123,102,17,4,47
S01011052,712,392,322,54,16,320,247,67,50,13,4,180,166,114,97,10,7,52,78,62,51,11,0,16,55,41,31,8,2,14,166,108,93,12,3,58
S01011053,535,314,268,27,19,221,154,50,40,5,5,104,187,131,106,15,10,56,63,36,34,0,2,27,45,32,30,1,1,13,86,65,58,6,1,21
S01011054,442,291,234,45,12,151,140,57,46,9,2,83,102,79,64,11,4,23,44,37,28,7,2,7,36,29,26,3,0,7,120,89,70,15,4,31
S01011055,453,311,235,64,12,142,108,48,29,16,3,60,120,83,65,14,4,37,53,39,32,6,1,14,43,34,30,3,1,9,129,107,79,25,3,22
S01011056,555,387,255,125,7,168,140,68,27,38,3,72,158,127,81,42,4,31,63,47,39,8,0,16,40,34,26,8,0,6,154,111,82,29,0,43
S01011057,475,327,249,68,10,148,173,89,62,26,1,84,122,102,81,19,2,20,65,53,41,10,2,12,41,32,25,5,2,9,74,51,40,8,3,23
S01011058,523,367,253,100,14,156,128,67,37,28,2,61,124,83,51,27,5,41,72,58,43,13,2,14,56,49,38,9,2,7,143,110,84,23,3,33
S01011059,510,350,249,79,22,160,144,77,41,30,6,67,132,104,79,17,8,28,77,56,43,8,5,21,39,27,21,5,1,12,118,86,65,19,2,32
S01011060,780,410,340,55,15,370,267,61,51,8,2,206,195,128,108,13,7,67,115,88,77,10,1,27,53,43,38,4,1,10,150,90,66,20,4,60
S01011061,699,459,393,32,34,240,289,132,114,8,10,157,214,172,142,12,18,42,79,63,55,5,3,16,63,51,47,3,1,12,54,41,35,4,2,13
S01011062,755,507,429,62,16,248,262,108,88,17,3,154,217,162,131,22,9,55,118,107,97,9,1,11,55,49,44,4,1,6,103,81,69,10,2,22
S01011063,855,504,425,40,39,351,340,118,94,9,15,222,261,203,165,18,20,58,88,68,62,5,1,20,63,53,50,1,2,10,103,62,54,7,1,41
S01011064,860,544,456,67,21,316,310,119,99,16,4,191,222,183,146,25,12,39,120,93,76,13,4,27,59,46,42,4,0,13,149,103,93,9,1,46
S01011065,592,350,256,72,22,242,162,62,48,10,4,100,155,97,63,25,9,58,64,46,33,12,1,18,62,51,37,10,4,11,149,94,75,15,4,55
S01011066,427,246,177,57,12,181,111,36,21,14,1,75,122,83,60,17,6,39,52,37,28,9,0,15,38,31,25,6,0,7,104,59,43,11,5,45
S01011067,478,257,187,51,19,221,144,32,22,8,2,112,132,91,63,17,11,41,54,36,27,7,2,18,39,27,26,0,1,12,109,71,49,19,3,38
S01011068,421,255,189,53,13,166,124,38,30,7,1,86,142,105,78,23,4,37,51,36,30,2,4,15,35,27,19,7,1,8,69,49,32,14,3,20
S01011069,467,257,212,32,13,210,142,47,41,5,1,95,113,74,59,7,8,39,69,49,40,8,1,20,39,25,23,1,1,14,104,62,49,11,2,42
S01011070,510,321,272,39,10,189,159,55,38,12,5,104,130,99,85,11,3,31,70,59,52,6,1,11,46,38,34,3,1,8,105,70,63,7,0,35
S01011071,726,420,324,66,30,306,191,58,46,8,4,133,191,121,87,22,12,70,106,85,73,8,4,21,74,57,46,6,5,17,164,99,72,22,5,65
S01011072,801,548,435,84,29,253,226,95,66,25,4,131,214,165,131,25,9,49,130,107,85,14,8,23,76,68,60,6,2,8,155,113,93,14,6,42
S01011073,596,371,312,47,12,225,170,67,48,17,2,103,174,121,108,9,4,53,86,70,58,9,3,16,51,38,37,0,1,13,115,75,61,12,2,40
S01011074,509,336,282,39,15,173,157,55,46,7,2,102,150,116,91,16,9,34,65,50,44,5,1,15,54,50,42,7,1,4,83,65,59,4,2,18
S01011075,570,346,285,30,31,224,258,114,96,9,9,144,176,126,104,9,13,50,71,60,48,4,8,11,30,26,20,5,1,4,35,20,17,3,0,15
S01011076,605,360,299,32,29,245,219,74,50,12,12,145,171,131,110,11,10,40,87,67,62,3,2,20,44,42,38,1,3,2,84,46,39,5,2,38
S01011077,586,347,288,12,47,239,239,89,69,3,17,150,187,148,120,6,22,39,62,43,39,2,2,19,43,36,35,0,1,7,55,31,25,1,5,24
S01011078,941,557,457,83,17,384,258,83,62,18,3,175,267,210,174,26,10,57,140,89,80,7,2,51,86,67,58,9,0,19,190,108,83,23,2,82
S01011079,888,582,487,56,39,306,273,109,82,17,10,164,245,200,165,18,17,45,115,85,78,7,0,30,100,83,76,3,4,17,155,105,86,11,8,50
S01011080,838,509,433,38,38,329,315,108,88,9,11,207,218,177,147,11,19,41,94,75,67,6,2,19,72,58,51,3,4,14,139,91,80,9,2,48
S01011081,662,412,351,30,31,250,221,92,72,14,6,129,223,161,135,9,17,62,80,56,51,2,3,24,59,47,43,2,2,12,79,56,50,3,3,23
S01011082,474,237,202,11,24,237,224,55,48,1,6,169,137,102,84,4,14,35,39,34,30,2,2,5,18,15,14,1,0,3,56,31,26,3,2,25
S01011083,648,402,333,39,30,246,200,71,54,9,8,129,170,120,99,9,12,50,69,57,49,6,2,12,68,56,48,5,3,12,141,98,83,10,5,43
S01011084,654,393,300,73,20,261,151,48,33,13,2,103,149,107,82,16,9,42,92,63,51,11,1,29,70,60,42,14,4,10,192,115,92,19,4,77
S01011085,744,461,387,58,16,283,183,58,44,11,3,125,149,95,83,10,2,54,95,67,56,8,3,28,77,61,47,11,3,16,240,180,157,18,5,60
S01011086,546,321,272,41,8,225,142,42,33,8,1,100,128,90,79,8,3,38,94,75,63,9,3,19,56,45,32,12,1,11,126,69,65,4,0,57
S01011087,479,303,256,30,17,176,141,45,39,5,1,96,151,109,93,7,9,42,65,53,44,6,3,12,44,42,37,3,2,2,78,54,43,9,2,24
S01011088,803,479,400,60,19,324,171,48,38,10,0,123,186,130,105,16,9,56,113,81,69,8,4,32,71,49,41,7,1,22,262,171,147,19,5,91
S01011089,542,311,249,29,33,231,172,60,44,6,10,112,129,89,66,8,15,40,79,64,56,4,4,15,48,35,26,7,2,13,114,63,57,4,2,51
S01011090,612,385,297,78,10,227,168,73,46,25,2,95,130,93,71,21,1,37,78,63,54,8,1,15,68,52,42,8,2,16,168,104,84,16,4,64
S01011091,526,384,285,78,21,142,122,61,35,24,2,61,116,94,72,15,7,22,87,77,58,11,8,10,51,48,44,4,0,3,150,104,76,24,4,46
S01011092,320,215,168,18,29,105,81,39,28,7,4,42,107,74,53,5,16,33,45,33,30,0,3,12,41,32,27,2,3,9,46,37,30,4,3,9
S01011093,502,348,267,71,10,154,86,27,18,9,0,59,126,94,71,19,4,32,75,66,56,7,3,9,49,41,33,7,1,8,166,120,89,29,2,46
S01011094,447,290,210,69,11,157,97,25,12,12,1,72,99,71,55,13,3,28,57,41,28,11,2,16,39,36,32,4,0,3,155,117,83,29,5,38
S01011095,651,458,346,96,16,193,114,49,28,17,4,65,147,101,76,19,6,46,101,80,68,11,1,21,83,71,54,13,4,12,206,157,120,36,1,49
S01011096,479,332,268,51,13,147,108,30,20,6,4,78,100,73,57,10,6,27,81,70,59,9,2,11,58,52,44,7,1,6,132,107,88,19,0,25
S01011097,559,393,304,74,15,166,105,49,33,14,2,56,123,97,77,17,3,26,101,78,62,14,2,23,59,45,33,6,6,14,171,124,99,23,2,47
S01011098,635,425,366,36,23,210,137,43,36,6,1,94,174,138,117,7,14,36,96,75,63,10,2,21,71,58,52,3,3,13,157,111,98,10,3,46
S01011099,651,457,378,33,46,194,189,107,92,6,9,82,229,167,131,12,24,62,79,65,52,6,7,14,61,48,41,4,3,13,93,70,62,5,3,23
S01011100,392,223,186,23,14,169,140,44,35,4,5,96,98,72,58,10,4,26,47,38,34,3,1,9,36,25,20,3,2,11,71,44,39,3,2,27
S01011101,482,305,262,10,33,177,177,83,67,3,13,94,176,122,105,4,13,54,46,32,28,2,2,14,33,30,27,0,3,3,50,38,35,1,2,12
S01011102,534,342,285,16,41,192,183,58,47,2,9,125,176,129,98,7,24,47,57,50,48,0,2,7,44,38,35,2,1,6,74,67,57,5,5,7
S01011103,503,305,255,21,29,198,169,43,33,8,2,126,135,107,84,8,15,28,55,48,43,0,5,7,36,24,19,2,3,12,108,83,76,3,4,25
S01011104,628,297,246,36,15,331,214,40,29,6,5,174,118,56,46,4,6,62,77,50,39,8,3,27,58,41,38,3,0,17,161,110,94,15,1,51
S01011105,682,434,369,39,26,248,218,74,59,8,7,144,197,150,129,13,8,47,98,79,72,4,3,19,65,47,39,5,3,18,104,84,70,9,5,20
S01011106,644,498,425,26,47,146,78,44,39,1,4,34,232,179,147,6,26,53,151,125,111,5,9,26,81,64,51,8,5,17,102,86,77,6,3,16
S01011107,636,526,463,26,37,110,76,47,39,2,6,29,210,172,145,8,19,38,106,90,81,4,5,16,105,89,80,7,2,16,139,128,118,5,5,11
S01011108,447,322,273,26,23,125,110,44,32,6,6,66,162,127,106,7,14,35,56,50,46,2,2,6,53,45,38,6,1,8,66,56,51,5,0,10
S01011109,690,449,392,42,15,241,191,73,62,8,3,118,193,144,125,12,7,49,106,85,77,5,3,21,87,68,59,9,0,19,113,79,69,8,2,34
S01011110,568,397,352,18,27,171,164,74,59,5,10,90,168,128,114,6,8,40,98,86,79,3,4,12,58,41,37,1,3,17,80,68,63,3,2,12
S01011111,699,457,393,30,34,242,275,120,104,9,7,155,217,172,145,9,18,45,93,79,69,6,4,14,48,36,32,1,3,12,66,50,43,5,2,16
S01011112,648,534,468,46,20,114,94,48,39,5,4,46,173,144,126,11,7,29,116,106,99,2,5,10,97,87,72,12,3,10,168,149,132,16,1,19
S01011113,821,511,455,33,23,310,314,111,94,11,6,203,210,162,143,11,8,48,94,74,68,5,1,20,87,77,70,2,5,10,116,87,80,4,3,29
S01011114,615,426,366,42,18,189,149,62,50,9,3,87,178,131,103,17,11,47,104,84,75,8,1,20,66,55,52,2,1,11,118,94,86,6,2,24
S01011115,751,503,423,40,40,248,252,115,98,9,8,137,236,183,149,17,17,53,104,83,71,4,8,21,60,50,44,4,2,10,99,72,61,6,5,27
S01011116,544,357,313,22,22,187,161,63,57,3,3,98,154,105,91,5,9,49,84,74,62,6,6,10,59,48,43,4,1,11,86,67,60,4,3,19
S01011117,635,389,317,58,14,246,127,42,28,13,1,85,136,84,70,10,4,52,90,65,52,10,3,25,73,58,47,9,2,15,209,140,120,16,4,69
S01011118,724,437,363,52,22,287,142,41,24,12,5,101,132,91,76,7,8,41,84,56,48,4,4,28,73,51,43,7,1,22,293,198,172,22,4,95
S01011119,789,439,376,54,9,350,184,54,46,7,1,130,140,85,78,7,0,55,107,75,59,13,3,32,78,53,48,5,0,25,280,172,145,22,5,108
S01011120,608,311,263,40,8,297,117,29,17,11,1,88,100,57,48,7,2,43,78,44,43,0,1,34,77,44,41,3,0,33,236,137,114,19,4,99
S01011121,473,317,272,19,26,156,134,46,40,2,4,88,137,105,89,3,13,32,62,56,47,7,2,6,43,35,32,3,0,8,97,75,64,4,7,22
S01011122,541,356,304,33,19,185,164,59,51,8,0,105,137,99,85,7,7,38,58,52,39,6,7,6,60,52,50,1,1,8,122,94,79,11,4,28
S01011123,916,601,525,42,34,315,321,119,97,11,11,202,265,217,190,9,18,48,131,108,100,7,1,23,74,58,51,5,2,16,125,99,87,10,2,26
S01011124,505,363,320,27,16,142,128,53,50,3,0,75,128,96,82,10,4,32,99,81,68,9,4,18,57,52,45,3,4,5,93,81,75,2,4,12
S01011125,392,288,252,16,20,104,100,49,43,0,6,51,136,109,93,7,9,27,50,39,33,4,2,11,43,41,37,1,3,2,63,50,46,4,0,13
S01011126,379,269,232,18,19,110,102,34,25,5,4,68,114,93,78,6,9,21,66,58,53,3,2,8,33,30,26,2,2,3,64,54,50,2,2,10
S01011127,327,251,233,8,10,76,18,8,6,2,0,10,119,82,75,1,6,37,71,60,56,1,3,11,48,40,39,1,0,8,71,61,57,3,1,10
S01011128,600,390,332,31,27,210,171,64,50,4,10,107,166,115,99,8,8,51,108,87,79,6,2,21,58,46,40,5,1,12,97,78,64,8,6,19
S01011129,771,514,440,51,23,257,130,38,22,13,3,92,150,106,92,7,7,44,105,80,70,4,6,25,97,77,66,10,1,20,289,213,190,17,6,76
S01011130,498,294,253,22,19,204,165,44,34,5,5,121,131,95,78,8,9,36,70,55,53,1,1,15,51,39,33,4,2,12,81,61,55,4,2,20
S01011131,565,382,325,28,29,183,130,43,33,4,6,87,121,91,71,12,8,30,88,69,59,2,8,19,64,52,49,1,2,12,162,127,113,9,5,35
S01011132,745,490,412,55,23,255,123,27,21,4,2,96,169,119,91,19,9,50,115,94,82,9,3,21,110,92,80,7,5,18,228,158,138,16,4,70
S01011133,375,238,194,25,19,137,127,44,36,5,3,83,100,77,66,4,7,23,53,42,39,2,1,11,32,27,19,5,3,5,63,48,34,9,5,15
S01011134,665,417,351,50,16,248,190,49,39,8,2,141,160,120,100,13,7,40,92,79,67,9,3,13,87,77,68,8,1,10,136,92,77,12,3,44
S01011135,633,415,343,37,35,218,210,86,72,9,5,124,192,153,124,15,14,39,78,62,57,3,2,16,63,47,38,4,5,16,90,67,52,6,9,23
S01011136,563,351,300,29,22,212,151,48,39,6,3,103,130,91,78,5,8,39,98,83,71,5,7,15,42,34,29,4,1,8,142,95,83,9,3,47
S01011137,369,266,210,31,25,103,67,34,24,4,6,33,99,79,63,9,7,20,62,50,41,4,5,12,39,35,26,4,5,4,102,68,56,10,2,34
S01011138,482,365,308,28,29,117,126,59,46,7,6,67,157,130,114,8,8,27,75,66,52,5,9,9,70,64,56,4,4,6,54,46,40,4,2,8
S01011139,1117,1011,954,27,30,106,54,30,26,2,2,24,340,301,276,9,16,39,351,332,323,5,4,19,113,104,94,6,4,9,259,244,235,5,4,15
S01011140,428,303,256,22,25,125,111,49,38,7,4,62,124,96,73,9,14,28,66,55,50,2,3,11,56,52,47,1,4,4,71,51,48,3,0,20
S01011141,435,316,266,14,36,119,109,43,37,3,3,66,148,127,98,6,23,21,61,51,46,1,4,10,51,45,39,1,5,6,66,50,46,3,1,16
S01011142,932,476,376,65,35,456,134,44,26,11,7,90,248,88,66,11,11,160,185,81,67,8,6,104,99,75,61,10,4,24,266,188,156,25,7,78
S01011143,780,478,410,50,18,302,149,36,30,5,1,113,197,132,116,10,6,65,124,83,74,7,2,41,72,57,47,7,3,15,238,170,143,21,6,68
S01011144,597,386,327,43,16,211,146,47,38,5,4,99,141,89,75,9,5,52,74,61,49,8,4,13,66,54,47,7,0,12,170,135,118,14,3,35
S01011145,541,359,291,47,21,182,108,41,33,6,2,67,102,72,57,7,8,30,65,52,47,3,2,13,59,46,39,6,1,13,207,148,115,25,8,59
S01011146,586,379,308,38,33,207,133,48,36,6,6,85,161,121,100,8,13,40,82,53,43,5,5,29,77,53,43,6,4,24,133,104,86,13,5,29
S01011147,841,573,477,54,42,268,186,67,50,9,8,119,212,162,139,9,14,50,137,111,91,12,8,26,102,80,68,8,4,22,204,153,129,16,8,51
S01011148,652,446,323,104,19,206,142,55,34,16,5,87,143,105,73,24,8,38,87,67,53,12,2,20,57,45,29,14,2,12,223,174,134,38,2,49
S01011149,701,558,457,89,12,143,63,31,23,7,1,32,166,128,106,16,6,38,141,126,112,14,0,15,66,55,49,6,0,11,265,218,167,46,5,47
S01011150,319,263,238,9,16,56,19,10,7,0,3,9,100,77,68,3,6,23,45,37,34,1,2,8,54,50,49,1,0,4,101,89,80,4,5,12
S01011151,429,312,248,28,36,117,65,29,15,7,7,36,109,74,59,4,11,35,93,76,65,3,8,17,51,41,36,1,4,10,111,92,73,13,6,19
S01011152,589,353,242,91,20,236,88,19,15,1,3,69,103,70,56,9,5,33,74,53,39,12,2,21,64,45,32,10,3,19,260,166,100,59,7,94
S01011153,748,430,324,62,44,318,191,57,40,6,11,134,182,132,99,15,18,50,107,70,57,7,6,37,57,41,28,8,5,16,211,130,100,26,4,81
S01011154,495,282,210,38,34,213,186,54,41,4,9,132,107,81,54,10,17,26,72,55,43,9,3,17,33,25,18,4,3,8,97,67,54,11,2,30
S01011155,556,306,239,35,32,250,174,46,36,4,6,128,125,91,68,12,11,34,80,56,45,5,6,24,35,26,19,3,4,9,142,87,71,11,5,55
S01011156,488,324,280,27,17,164,88,30,20,6,4,58,134,90,77,9,4,44,72,54,47,5,2,18,76,64,59,2,3,12,118,86,77,5,4,32
S01011157,514,318,275,30,13,196,107,27,20,4,3,80,124,91,81,6,4,33,84,68,56,8,4,16,61,43,38,4,1,18,138,89,80,8,1,49
S01011158,446,242,189,39,14,204,83,18,11,5,2,65,72,47,34,7,6,25,50,29,24,2,3,21,39,27,22,2,3,12,202,121,98,23,0,81
S01011159,471,241,209,14,18,230,182,50,43,2,5,132,115,66,61,1,4,49,64,49,43,2,4,15,35,28,24,1,3,7,75,48,38,8,2,27
S01011160,746,517,436,44,37,229,179,78,59,12,7,101,195,139,118,7,14,56,134,108,97,4,7,26,90,77,65,9,3,13,148,115,97,12,6,33
S01011161,496,335,275,28,32,161,136,51,46,1,4,85,180,144,107,15,22,36,63,46,42,3,1,17,47,41,35,3,3,6,70,53,45,6,2,17
S01011162,366,221,185,16,20,145,76,22,15,1,6,54,128,77,70,3,4,51,45,35,27,1,7,10,29,24,22,1,1,5,88,63,51,10,2,25
S01011163,671,449,382,24,43,222,237,117,94,7,16,120,193,148,123,7,18,45,97,74,67,1,6,23,62,49,45,2,2,13,82,61,53,7,1,21
S01011164,590,368,312,31,25,222,115,32,22,6,4,83,179,111,99,7,5,68,85,59,49,5,5,26,69,55,45,4,6,14,142,111,97,9,5,31
S01011165,624,363,282,32,49,261,236,84,66,4,14,152,185,138,102,11,25,47,67,46,36,6,4,21,56,37,30,4,3,19,80,58,48,7,3,22
S01011166,434,245,202,33,10,189,100,25,18,6,1,75,84,50,42,6,2,34,59,46,39,5,2,13,43,26,23,3,0,17,148,98,80,13,5,50
S01011167,641,372,276,87,9,269,138,42,20,20,2,96,119,67,50,14,3,52,78,60,45,13,2,18,35,27,20,6,1,8,271,176,141,34,1,95
S01011168,707,458,297,135,26,249,142,68,37,29,2,74,175,121,83,29,9,54,105,64,40,19,5,41,71,52,37,14,1,19,214,153,100,44,9,61
S01011169,706,551,476,47,28,155,74,32,20,6,6,42,188,141,116,11,14,47,144,125,113,8,4,19,95,85,77,6,2,10,205,168,150,16,2,37
S01011170,756,471,358,76,37,285,153,50,35,7,8,103,161,107,81,16,10,54,107,80,60,12,8,27,89,66,43,18,5,23,246,168,139,23,6,78
S01011171,789,496,333,134,29,293,155,56,31,19,6,99,152,115,79,25,11,37,129,96,70,25,1,33,69,54,35,14,5,15,284,175,118,51,6,109
S01011172,647,379,238,118,23,268,127,51,28,21,2,76,119,80,53,20,7,39,99,67,42,17,8,32,64,48,35,13,0,16,238,133,80,47,6,105
S01011173,507,250,155,84,11,257,93,23,14,8,1,70,94,50,30,16,4,44,69,42,26,13,3,27,44,33,21,12,0,11,207,102,64,35,3,105
S01011174,408,200,128,62,10,208,97,26,13,12,1,71,66,39,27,10,2,27,55,36,23,12,1,19,39,29,18,8,3,10,151,70,47,20,3,81
S01011175,439,239,181,38,20,200,129,38,30,4,4,91,112,70,48,9,13,42,66,49,36,11,2,17,37,26,23,3,0,11,95,56,44,11,1,39
S01011176,496,236,159,68,9,260,103,31,21,9,1,72,94,46,32,12,2,48,84,54,35,15,4,30,46,35,24,10,1,11,169,70,47,22,1,99
S01011177,741,446,334,96,16,295,145,46,34,10,2,99,163,108,85,20,3,55,101,72,57,12,3,29,86,73,55,16,2,13,246,147,103,38,6,99
S01011178,394,251,193,28,30,143,109,42,29,7,6,67,108,75,53,7,15,33,56,44,33,6,5,12,44,37,32,4,1,7,77,53,46,4,3,24
S01011179,509,316,253,28,35,193,223,100,73,9,18,123,127,93,75,11,7,34,53,43,31,6,6,10,62,51,46,1,4,11,44,29,28,1,0,15
S01011180,540,282,203,19,60,258,258,92,74,4,14,166,150,108,70,5,33,42,55,37,30,2,5,18,33,20,12,2,6,13,44,25,17,6,2,19
S01011181,401,263,166,90,7,138,112,49,24,25,0,63,90,61,32,26,3,29,52,40,21,17,2,12,38,32,26,5,1,6,109,81,63,17,1,28
S01011182,349,232,165,56,11,117,105,45,22,21,2,60,69,49,35,13,1,20,57,40,34,4,2,17,37,33,24,5,4,4,81,65,50,13,2,16
S01011183,475,296,223,42,31,179,156,60,29,16,15,96,99,66,48,9,9,33,57,38,33,4,1,19,69,56,50,4,2,13,94,76,63,9,4,18
S01011184,650,451,382,46,23,199,102,43,31,10,2,59,140,96,75,11,10,44,112,83,68,9,6,29,87,78,70,7,1,9,209,151,138,9,4,58
S01011185,600,341,291,30,20,259,167,43,34,8,1,124,153,97,81,6,10,56,83,62,58,1,3,21,64,43,39,2,2,21,133,96,79,13,4,37
S01011186,790,417,351,37,29,373,312,71,57,10,4,241,173,120,94,13,13,53,93,66,56,6,4,27,82,64,59,1,4,18,130,96,85,7,4,34
S01011187,599,371,325,21,25,228,132,36,26,6,4,96,144,97,81,7,9,47,112,86,76,5,5,26,75,54,49,1,4,21,136,98,93,2,3,38
S01011188,785,464,390,33,41,321,254,89,71,9,9,165,232,159,127,13,19,73,95,62,59,1,2,33,97,74,64,5,5,23,107,80,69,5,6,27
S01011189,706,441,364,37,40,265,225,59,44,7,8,166,181,136,111,13,12,45,77,62,50,5,7,15,94,77,68,2,7,17,129,107,91,10,6,22
S01011190,525,293,227,37,29,232,193,58,39,13,6,135,156,102,76,11,15,54,57,36,27,6,3,21,54,45,40,3,2,9,65,52,45,4,3,13
S01011191,436,267,222,19,26,169,180,63,51,6,6,117,110,84,72,5,7,26,59,49,43,3,3,10,41,37,29,1,7,4,46,34,27,4,3,12
S01011192,554,378,317,19,42,176,177,94,84,2,8,83,170,129,101,8,20,41,77,54,48,2,4,23,56,47,35,6,6,9,74,54,49,1,4,20
S01011193,540,333,274,13,46,207,172,74,61,5,8,98,181,112,91,3,18,69,67,48,41,2,5,19,57,47,37,1,9,10,63,52,44,2,6,11
S01011194,553,352,255,20,77,201,177,92,56,8,28,85,177,114,77,4,33,63,80,54,48,1,5,26,65,50,39,3,8,15,54,42,35,4,3,12
S01011195,588,403,336,16,51,185,174,80,67,7,6,94,192,151,119,2,30,41,72,53,47,1,5,19,82,60,50,2,8,22,68,59,53,4,2,9
S01011196,704,416,329,29,58,288,257,97,79,4,14,160,207,142,104,11,27,65,79,61,48,4,9,18,69,53,42,5,6,16,92,63,56,5,2,29
S01011197,657,371,282,32,57,286,225,84,58,9,17,141,222,139,100,16,23,83,65,46,39,1,6,19,69,49,41,3,5,20,76,53,44,3,6,23
S01011198,486,305,233,31,41,181,163,71,53,6,12,92,160,105,74,10,21,55,52,38,32,4,2,14,56,50,41,5,4,6,55,41,33,6,2,14
S01011199,639,415,333,34,48,224,194,78,59,7,12,116,171,119,90,14,15,52,85,65,59,2,4,20,97,81,65,7,9,16,92,72,60,4,8,20
S01011200,620,389,326,30,33,231,206,77,62,9,6,129,156,114,87,13,14,42,79,61,53,4,4,18,89,67,59,3,5,22,90,70,65,1,4,20
S01011201,508,324,272,26,26,184,157,41,36,3,2,116,136,102,80,9,13,34,83,64,51,7,6,19,57,50,42,5,3,7,75,67,63,2,2,8
S01011202,689,429,350,28,51,260,250,81,61,9,11,169,170,124,97,5,22,46,86,68,55,4,9,18,88,75,62,7,6,13,95,81,75,3,3,14
S01011203,664,423,360,24,39,241,209,60,50,5,5,149,180,131,111,4,16,49,84,75,66,4,5,9,82,65,53,4,8,17,109,92,80,7,5,17
S01011204,474,312,269,27,16,162,92,27,21,3,3,65,116,88,70,12,6,28,75,55,50,3,2,20,56,46,41,2,3,10,135,96,87,7,2,39
S01011205,496,419,359,33,27,77,61,44,31,8,5,17,123,95,77,9,9,28,82,71,64,4,3,11,82,76,67,4,5,6,148,133,120,8,5,15
S01011206,567,441,357,41,43,126,102,51,33,13,5,51,137,108,80,11,17,29,93,82,63,8,11,11,80,64,58,1,5,16,155,136,123,8,5,19
S01011207,622,378,325,30,23,244,176,48,34,8,6,128,150,96,82,5,9,54,94,66,61,3,2,28,65,58,47,7,4,7,137,110,101,7,2,27
S01011208,728,556,479,46,31,172,137,63,49,11,3,74,175,135,112,13,10,40,121,102,87,7,8,19,120,107,95,7,5,13,175,149,136,8,5,26
S01011209,514,316,256,20,40,198,156,49,42,1,6,107,139,100,78,7,15,39,79,62,48,5,9,17,56,45,40,1,4,11,84,60,48,6,6,24
S01011210,602,390,300,68,22,212,103,43,27,14,2,60,141,82,62,14,6,59,92,65,49,10,6,27,74,57,43,10,4,17,192,143,119,20,4,49
S01011211,547,411,349,31,31,136,121,61,47,6,8,60,136,98,74,7,17,38,84,72,65,7,0,12,68,62,53,6,3,6,138,118,110,5,3,20
S01011212,419,251,205,21,25,168,178,67,56,7,4,111,118,83,63,6,14,35,51,46,37,3,6,5,40,32,30,2,0,8,32,23,19,3,1,9
S01011213,815,497,394,23,80,318,297,119,90,7,22,178,233,162,117,8,37,71,98,68,62,2,4,30,85,70,59,2,9,15,102,78,66,4,8,24
S01011214,729,375,289,24,62,354,295,96,70,4,22,199,195,111,82,7,22,84,82,53,43,2,8,29,81,62,53,4,5,19,76,53,41,7,5,23
S01011215,459,260,187,14,59,199,175,54,36,4,14,121,145,102,68,2,32,43,53,35,25,2,8,18,49,38,30,5,3,11,37,31,28,1,2,6
S01011216,376,235,168,16,51,141,124,43,26,3,14,81,134,102,71,6,25,32,37,30,24,3,3,7,49,37,26,3,8,12,32,23,21,1,1,9
S01011217,643,384,271,26,87,259,234,87,58,7,22,147,188,132,80,4,48,56,79,60,48,5,7,19,60,46,38,4,4,14,82,59,47,6,6,23
S01011218,504,281,198,16,67,223,208,63,39,3,21,145,160,112,72,3,37,48,50,40,31,5,4,10,47,36,31,1,4,11,39,30,25,4,1,9
S01011219,644,376,289,28,59,268,266,97,67,7,23,169,214,155,116,12,27,59,61,44,38,4,2,17,57,41,35,3,3,16,46,39,33,2,4,7
S01011220,737,421,336,29,56,316,293,89,65,8,16,204,194,136,107,6,23,58,81,61,52,2,7,20,86,65,51,6,8,21,83,70,61,7,2,13
S01011221,767,485,399,31,55,282,272,100,79,9,12,172,209,155,126,8,21,54,111,85,73,3,9,26,87,76,63,3,10,11,88,69,58,8,3,19
S01011222,555,318,257,19,42,237,229,78,62,7,9,151,138,98,76,3,19,40,62,45,37,3,5,17,58,50,41,2,7,8,68,47,41,4,2,21
S01011223,646,407,331,36,40,239,210,62,42,10,10,148,187,147,118,9,20,40,87,70,60,6,4,17,61,53,49,3,1,8,101,75,62,8,5,26
S01011224,598,308,240,28,40,290,278,86,65,10,11,192,133,87,66,5,16,46,65,46,36,4,6,19,53,39,34,3,2,14,69,50,39,6,5,19
S01011225,564,317,235,21,61,247,227,80,54,11,15,147,148,98,72,4,22,50,59,40,33,0,7,19,56,44,34,3,7,12,74,55,42,3,10,19
S01011226,858,452,367,46,39,406,282,68,50,12,6,214,181,111,82,13,16,70,131,95,79,8,8,36,91,67,58,3,6,24,173,111,98,10,3,62
S01011227,603,366,282,39,45,237,187,72,47,12,13,115,123,78,58,6,14,45,79,60,46,4,10,19,63,43,33,5,5,20,151,113,98,12,3,38
S01011228,674,357,289,20,48,317,242,56,47,3,6,186,172,117,88,6,23,55,85,56,48,4,4,29,72,60,50,3,7,12,103,68,56,4,8,35
S01011229,445,212,149,18,45,233,190,44,29,1,14,146,106,61,36,4,21,45,44,28,23,1,4,16,42,33,24,5,4,9,63,46,37,7,2,17
S01011230,825,365,235,26,104,460,430,115,73,6,36,315,206,119,77,4,38,87,70,46,31,5,10,24,63,50,34,7,9,13,56,35,20,4,11,21
S01011231,503,243,196,13,34,260,240,57,45,2,10,183,120,80,58,6,16,40,47,34,28,1,5,13,49,36,33,1,2,13,47,36,32,3,1,11
S01011232,821,515,389,60,66,306,268,89,58,13,18,179,188,124,87,13,24,64,86,60,42,7,11,26,118,108,89,11,8,10,161,134,113,16,5,27
S01011233,311,144,107,12,25,167,101,19,13,3,3,82,89,45,31,1,13,44,45,25,22,1,2,20,31,25,17,2,6,6,45,30,24,5,1,15
S01011234,788,450,339,25,86,338,278,101,71,9,21,177,233,143,97,4,42,90,89,62,55,2,5,27,92,69,52,7,10,23,96,75,64,3,8,21
S01011235,311,151,107,14,30,160,138,37,20,3,14,101,71,45,31,5,9,26,36,25,18,3,4,11,28,19,15,1,3,9,38,25,23,2,0,13
S01011236,476,275,219,19,37,201,180,51,38,5,8,129,129,86,65,7,14,43,53,40,30,0,10,13,34,32,28,2,2,2,80,66,58,5,3,14
S01011237,596,347,257,20,70,249,212,54,41,6,7,158,174,125,76,5,44,49,70,53,38,5,10,17,69,57,53,1,3,12,71,58,49,3,6,13
S01011238,516,298,195,21,82,218,206,66,34,6,26,140,148,106,66,7,33,42,49,36,22,4,10,13,50,39,30,1,8,11,63,51,43,3,5,12
S01011239,628,324,228,28,68,304,271,67,41,6,20,204,156,112,78,7,27,44,71,56,42,4,10,15,61,49,39,5,5,12,69,40,28,6,6,29
S01011240,633,333,224,26,83,300,255,69,34,6,29,186,147,100,58,6,36,47,74,51,38,4,9,23,62,45,34,6,5,17,95,68,60,4,4,27
S01011241,914,473,349,59,65,441,345,82,48,16,18,263,196,127,94,11,22,69,111,65,56,5,4,46,94,74,54,8,12,20,168,125,97,19,9,43
S01011242,681,334,265,33,36,347,235,50,34,7,9,185,149,80,58,8,14,69,94,64,54,4,6,30,82,64,51,9,4,18,121,76,68,5,3,45
S01011243,757,391,259,24,108,366,307,90,51,5,34,217,197,129,76,6,47,68,74,52,41,4,7,22,80,63,48,1,14,17,99,57,43,8,6,42
S01011244,576,337,231,15,91,239,209,64,39,3,22,145,149,103,65,1,37,46,76,53,39,3,11,23,69,58,42,5,11,11,73,59,46,3,10,14
S01011245,720,386,275,30,81,334,296,87,59,7,21,209,193,121,77,8,36,72,69,49,38,3,8,20,80,68,53,5,10,12,82,61,48,7,6,21
S01011246,747,471,351,65,55,276,193,56,36,14,6,137,157,107,76,15,16,50,95,76,50,10,16,19,101,82,67,8,7,19,201,150,122,18,10,51
S01011247,721,365,307,36,22,356,201,44,34,8,2,157,148,81,59,10,12,67,89,56,51,1,4,33,84,56,50,4,2,28,199,128,113,13,2,71
S01011248,630,404,359,28,17,226,184,60,50,5,5,124,152,111,93,10,8,41,91,69,66,3,0,22,76,57,56,1,0,19,127,107,94,9,4,20
S01011249,617,404,346,24,34,213,138,43,29,6,8,95,141,99,76,6,17,42,107,84,75,4,5,23,94,69,64,3,2,25,137,109,102,5,2,28
S01011250,800,520,387,35,98,280,261,110,72,9,29,151,244,172,123,12,37,72,105,82,62,3,17,23,97,80,68,5,7,17,93,76,62,6,8,17
S01011251,700,429,335,32,62,271,241,89,72,5,12,152,200,140,106,7,27,60,109,79,63,8,8,30,79,63,47,8,8,16,71,58,47,4,7,13
S01011252,632,382,294,13,75,250,239,93,74,1,18,146,199,134,91,6,37,65,65,50,43,2,5,15,82,70,55,4,11,12,47,35,31,0,4,12
S01011253,692,386,307,18,61,306,288,94,74,5,15,194,207,150,111,6,33,57,67,46,39,0,7,21,73,52,42,6,4,21,57,44,41,1,2,13
S01011254,791,566,495,33,38,225,183,66,46,12,8,117,181,140,122,5,13,41,142,116,107,4,5,26,107,97,86,6,5,10,178,147,134,6,7,31
S01011255,576,451,392,31,28,125,76,33,24,3,6,43,121,98,74,14,10,23,102,85,77,3,5,17,98,81,72,3,6,17,179,154,145,8,1,25
S01011256,336,263,225,25,13,73,45,18,12,4,2,27,98,77,64,8,5,21,54,46,38,5,3,8,56,49,43,3,3,7,83,73,68,5,0,10
S01011257,372,175,139,23,13,197,96,17,12,4,1,79,65,34,28,4,2,31,53,31,26,4,1,22,41,24,18,2,4,17,117,69,55,9,5,48
S01011258,480,287,235,32,20,193,103,25,16,7,2,78,94,59,45,6,8,35,82,59,56,1,2,23,56,43,36,3,4,13,145,101,82,15,4,44
S01011259,664,365,275,40,50,299,250,65,47,6,12,185,118,89,62,12,15,29,93,64,51,5,8,29,82,68,52,5,11,14,121,79,63,12,4,42
S01011260,633,337,272,32,33,296,167,37,24,8,5,130,128,87,62,8,17,41,96,52,42,5,5,44,89,65,56,4,5,24,153,96,88,7,1,57
S01011261,614,357,247,21,89,257,246,100,62,3,35,146,172,118,80,5,33,54,64,45,30,8,7,19,64,48,35,2,11,16,68,46,40,3,3,22
S01011262,403,232,187,18,27,171,127,44,27,6,11,83,93,61,47,6,8,32,66,44,38,2,4,22,61,46,40,3,3,15,56,37,35,1,1,19
S01011263,918,577,492,32,53,341,282,72,63,2,7,210,233,172,127,15,30,61,114,88,79,5,4,26,120,110,99,5,6,10,169,135,124,5,6,34
S01011264,510,331,248,19,64,179,177,78,57,6,15,99,166,117,79,5,33,49,57,47,36,1,10,10,51,42,36,1,5,9,59,47,40,6,1,12
S01011265,799,496,337,39,120,303,286,113,71,12,30,173,257,180,119,10,51,77,90,70,51,5,14,20,95,76,51,10,15,19,71,57,45,2,10,14
S01011266,745,417,356,23,38,328,291,82,65,10,7,209,192,141,120,4,17,51,94,63,54,4,5,31,77,59,52,1,6,18,91,72,65,4,3,19
S01011267,500,270,232,14,24,230,135,25,20,2,3,110,102,73,60,3,10,29,71,36,31,2,3,35,66,50,42,5,3,16,126,86,79,2,5,40
S01011268,333,182,143,17,22,151,122,35,23,8,4,87,55,37,27,3,7,18,45,35,30,2,3,10,28,20,16,0,4,8,83,55,47,4,4,28
S01011269,441,218,173,14,31,223,187,45,29,5,11,142,92,59,48,4,7,33,71,51,40,3,8,20,31,21,17,1,3,10,60,42,39,1,2,18
S01011270,569,344,258,27,59,225,198,59,38,9,12,139,160,118,85,7,26,42,78,59,49,2,8,19,68,56,43,3,10,12,65,52,43,6,3,13
S01011271,714,347,284,13,50,367,299,75,57,5,13,224,165,91,69,2,20,74,87,59,55,2,2,28,73,60,49,1,10,13,90,62,54,3,5,28
S01011272,628,362,271,18,73,266,263,86,57,3,26,177,159,114,77,7,30,45,65,55,45,3,7,10,67,53,46,3,4,14,74,54,46,2,6,20
S01011273,648,395,300,19,76,253,221,75,49,6,20,146,209,146,104,8,34,63,79,56,51,1,4,23,88,76,58,2,16,12,51,42,38,2,2,9
S01011274,676,418,324,28,66,258,221,73,48,8,17,148,212,146,114,6,26,66,84,68,59,3,6,16,84,68,55,5,8,16,75,63,48,6,9,12
S01011275,514,288,219,13,56,226,168,55,42,3,10,113,168,107,76,5,26,61,76,51,42,3,6,25,55,42,33,1,8,13,47,33,26,1,6,14
S01011276,769,461,347,24,90,308,296,113,74,7,32,183,231,163,124,7,32,68,88,70,56,5,9,18,89,71,55,2,14,18,65,44,38,3,3,21
S01011277,579,397,336,37,24,182,119,49,36,10,3,70,153,109,92,10,7,44,93,65,56,4,5,28,72,61,55,4,2,11,142,113,97,9,7,29
S01011278,417,326,291,18,17,91,85,38,28,5,5,47,103,91,82,2,7,12,76,67,58,6,3,9,64,58,56,2,0,6,89,72,67,3,2,17
S01011279,561,344,304,18,22,217,155,48,44,3,1,107,120,74,61,4,9,46,98,73,65,5,3,25,74,61,54,3,4,13,114,88,80,3,5,26
S01011280,517,302,256,29,17,215,79,21,15,4,2,58,124,83,59,16,8,41,83,54,48,5,1,29,61,45,37,3,5,16,170,99,97,1,1,71
S01011281,519,377,314,32,31,142,87,32,25,7,0,55,102,71,52,8,11,31,91,75,64,3,8,16,95,84,68,8,8,11,144,115,105,6,4,29
S01011282,695,529,453,43,33,166,130,54,41,10,3,76,164,132,104,12,16,32,113,91,80,4,7,22,109,95,82,11,2,14,179,157,146,6,5,22
S01011283,549,450,385,41,24,99,72,37,28,9,0,35,125,97,76,14,7,28,79,67,53,4,10,12,97,83,74,6,3,14,176,166,154,8,4,10
S01011284,410,360,314,34,12,50,32,15,13,2,0,17,66,55,47,5,3,11,78,71,62,4,5,7,83,74,61,11,2,9,151,145,131,12,2,6
S01011285,549,367,280,27,60,182,176,71,49,6,16,105,151,118,85,7,26,33,85,65,52,5,8,20,63,54,40,4,10,9,74,59,54,5,0,15
S01011286,551,344,265,26,53,207,189,74,52,9,13,115,171,123,87,10,26,48,67,47,41,1,5,20,56,45,37,3,5,11,68,55,48,3,4,13
S01011287,633,396,308,22,66,237,208,71,51,6,14,137,199,144,100,9,35,55,88,73,63,6,4,15,62,45,38,0,7,17,76,63,56,1,6,13
S01011288,595,368,299,24,45,227,203,77,52,12,13,126,179,128,105,5,18,51,68,48,42,2,4,20,85,66,58,3,5,19,60,49,42,2,5,11
S01011289,753,434,347,31,56,319,302,100,75,9,16,202,201,140,107,10,23,61,97,70,58,2,10,27,80,62,54,6,2,18,73,62,53,4,5,11
S01011290,998,514,390,54,70,484,407,122,88,11,23,285,218,145,100,18,27,73,133,76,64,7,5,57,104,79,64,6,9,25,136,92,74,12,6,44
S01011291,673,383,310,19,54,290,260,71,55,3,13,189,158,115,91,7,17,43,83,61,55,2,4,22,73,55,44,2,9,18,99,81,65,5,11,18
S01011292,572,323,222,20,81,249,259,100,73,6,21,159,160,103,59,4,40,57,64,47,37,1,9,17,44,38,23,4,11,6,45,35,30,5,0,10
S01011293,591,348,280,15,53,243,273,104,82,7,15,169,151,112,84,5,23,39,55,41,39,0,2,14,58,47,37,1,9,11,54,44,38,2,4,10
S01011294,748,347,248,29,70,401,352,74,43,8,23,278,145,92,62,4,26,53,73,55,40,6,9,18,71,56,46,3,7,15,107,70,57,8,5,37
S01011295,821,470,387,49,34,351,157,48,28,9,11,109,164,99,86,7,6,65,130,91,70,12,9,39,95,63,53,5,5,32,275,169,150,16,3,106
S01011296,492,264,190,31,43,228,185,56,36,8,12,129,106,72,47,6,19,34,60,42,27,7,8,18,52,39,32,5,2,13,89,55,48,5,2,34
S01011297,650,421,328,35,58,229,235,91,68,7,16,144,197,153,112,15,26,44,94,74,62,4,8,20,66,55,47,5,3,11,58,48,39,4,5,10
S01011298,480,301,213,17,71,179,183,78,54,5,19,105,155,108,70,4,34,47,36,24,18,2,4,12,57,46,38,1,7,11,49,45,33,5,7,4
S01011299,415,276,177,92,7,139,120,65,27,35,3,55,70,46,29,17,0,24,68,47,35,10,2,21,42,36,27,9,0,6,115,82,59,21,2,33
S01011300,767,431,332,28,71,336,328,108,82,5,21,220,196,137,104,7,26,59,87,66,45,7,14,21,77,58,47,4,7,19,79,62,54,5,3,17
S01011301,594,352,288,41,23,242,141,43,33,5,5,98,121,74,56,10,8,47,95,58,45,7,6,37,82,67,59,5,3,15,155,110,95,14,1,45
S01011302,765,358,272,23,63,407,360,85,58,9,18,275,165,107,83,4,20,58,90,57,44,4,9,33,63,52,42,2,8,11,87,57,45,4,8,30
S01011303,847,547,462,63,22,300,196,63,49,13,1,133,196,137,106,20,11,59,128,93,82,6,5,35,108,87,80,4,3,21,219,167,145,20,2,52
S01011304,540,323,261,21,41,217,229,96,71,7,18,133,121,83,68,3,12,38,69,53,44,3,6,16,54,41,36,3,2,13,67,50,42,5,3,17
S01011305,641,431,325,41,65,210,178,70,48,7,15,108,174,118,72,15,31,56,94,75,62,8,5,19,86,69,54,4,11,17,109,99,89,7,3,10
S01011306,474,251,191,10,50,223,162,54,39,2,13,108,141,82,48,3,31,59,60,42,39,1,2,18,42,26,24,1,1,16,69,47,41,3,3,22
S01011307,382,236,155,69,12,146,96,43,18,23,2,53,92,54,33,16,5,38,47,32,19,12,1,15,45,38,29,7,2,7,102,69,56,11,2,33
S01011308,374,237,145,77,15,137,77,27,11,14,2,50,71,48,23,16,9,23,48,28,19,7,2,20,32,23,11,12,0,9,146,111,81,28,2,35
S01011309,618,327,247,68,12,291,111,30,22,7,1,81,98,44,30,12,2,54,76,42,27,13,2,34,73,50,37,9,4,23,260,161,131,27,3,99
S01011310,591,330,242,58,30,261,139,41,19,15,7,98,108,64,47,11,6,44,85,58,43,12,3,27,65,51,41,5,5,14,194,116,92,15,9,78
S01011311,606,349,249,87,13,257,96,35,24,9,2,61,90,52,37,12,3,38,87,59,48,10,1,28,85,53,38,14,1,32,248,150,102,42,6,98
S01011312,955,511,363,117,31,444,141,38,19,15,4,103,129,77,56,13,8,52,143,83,62,15,6,60,99,66,51,13,2,33,443,247,175,61,11,196
S01011313,614,353,266,62,25,261,117,21,14,5,2,96,117,74,55,12,7,43,104,76,56,13,7,28,73,51,38,8,5,22,203,131,103,24,4,72
S01011314,876,554,436,80,38,322,158,44,31,5,8,114,165,105,80,19,6,60,148,109,88,15,6,39,96,66,53,7,6,30,309,230,184,34,12,79
S01011315,320,192,145,25,22,128,103,31,23,4,4,72,70,50,34,3,13,20,40,30,23,5,2,10,44,32,26,5,1,12,63,49,39,8,2,14
S01011316,574,330,255,35,40,244,181,55,40,7,8,126,135,92,63,10,19,43,78,57,50,3,4,21,66,46,41,2,3,20,114,80,61,13,6,34
S01011317,744,292,198,67,27,452,211,26,13,10,3,185,130,61,36,17,8,69,99,47,32,12,3,52,79,40,30,4,6,39,225,118,87,24,7,107
S01011318,871,380,289,71,20,491,240,47,31,13,3,193,160,73,47,17,9,87,117,57,46,10,1,60,78,50,39,10,1,28,276,153,126,21,6,123
S01011319,758,338,270,49,19,420,181,21,13,6,2,160,112,52,41,6,5,60,113,67,54,5,8,46,87,56,46,8,2,31,265,142,116,24,2,123
S01011320,466,230,190,23,17,236,145,26,22,3,1,119,91,52,36,9,7,39,81,50,45,3,2,31,58,46,41,2,3,12,91,56,46,6,4,35
S01011321,487,348,294,32,22,139,108,34,28,5,1,74,107,89,66,14,9,18,89,69,57,4,8,20,62,58,54,2,2,4,121,98,89,7,2,23
S01011322,494,319,268,28,23,175,100,26,21,4,1,74,116,82,64,8,10,34,73,51,42,5,4,22,79,60,50,5,5,19,126,100,91,6,3,26
S01011323,737,467,366,46,55,270,205,77,55,7,15,128,184,131,100,11,20,53,105,84,68,7,9,21,92,73,59,7,7,19,151,102,84,14,4,49
S01011324,363,210,162,25,23,153,87,22,15,2,5,65,60,41,32,5,4,19,63,41,29,4,8,22,38,29,23,3,3,9,115,77,63,11,3,38
S01011325,652,342,254,40,48,310,237,63,44,5,14,174,125,84,54,13,17,41,93,61,51,6,4,32,92,65,52,7,6,27,105,69,53,9,7,36
S01011326,686,323,233,43,47,363,246,62,39,12,11,184,153,86,57,12,17,67,81,47,34,7,6,34,67,46,34,3,9,21,139,82,69,9,4,57
S01011327,624,268,192,46,30,356,240,52,32,12,8,188,121,66,45,10,11,55,74,44,27,11,6,30,64,37,31,5,1,27,125,69,57,8,4,56
S01011328,595,293,204,73,16,302,185,49,30,14,5,136,129,67,47,15,5,62,76,52,36,13,3,24,63,40,27,11,2,23,142,85,64,20,1,57
S01011329,796,369,294,47,28,427,180,36,25,9,2,144,169,81,55,13,13,88,121,65,54,5,6,56,96,54,46,7,1,42,230,133,114,13,6,97
S01011330,616,331,273,40,18,285,110,31,22,6,3,79,110,65,44,13,8,45,102,57,52,5,0,45,81,54,46,5,3,27,213,124,109,11,4,89
S01011331,636,278,238,29,11,358,135,20,12,7,1,115,107,40,31,7,2,67,92,41,33,3,5,51,76,48,38,8,2,28,226,129,124,4,1,97
S01011332,791,397,311,65,21,394,154,33,23,9,1,121,118,60,42,13,5,58,127,76,59,9,8,51,120,75,61,11,3,45,272,153,126,23,4,119
S01011333,672,277,214,53,10,395,152,21,14,6,1,131,108,41,27,10,4,67,91,40,31,5,4,51,73,40,33,6,1,33,248,135,109,26,0,113
S01011334,591,412,271,117,24,179,145,59,24,30,5,86,102,73,44,23,6,29,97,75,48,22,5,22,56,48,31,12,5,8,191,157,124,30,3,34
S01011335,826,410,319,69,22,416,167,50,31,12,7,117,119,55,41,9,5,64,128,71,54,12,5,57,94,50,38,10,2,44,318,184,155,26,3,134
S01011336,482,287,235,28,24,195,150,42,31,5,6,108,108,71,51,8,12,37,50,36,33,2,1,14,61,54,49,2,3,7,113,84,71,11,2,29
S01011337,588,336,247,69,20,252,78,20,14,5,1,58,88,49,29,15,5,39,70,47,35,8,4,23,81,48,38,8,2,33,271,172,131,33,8,99
S01011338,510,347,271,24,52,163,152,74,60,1,13,78,135,98,63,8,27,37,67,52,45,3,4,15,53,40,32,5,3,13,103,83,71,7,5,20
S01011339,454,262,215,15,32,192,145,49,36,7,6,96,146,103,83,4,16,43,63,45,38,2,5,18,34,26,24,0,2,8,66,39,34,2,3,27
S01011340,553,317,246,28,43,236,233,93,62,12,19,140,130,82,64,4,14,48,81,58,48,5,5,23,61,52,48,2,2,9,48,32,24,5,3,16
S01011341,595,385,311,21,53,210,156,48,31,3,14,108,158,116,91,5,20,42,103,77,62,5,10,26,69,50,40,3,7,19,109,94,87,5,2,15
S01011342,583,359,302,31,26,224,145,36,25,7,4,109,147,98,79,6,13,49,95,74,63,8,3,21,71,56,49,2,5,15,125,95,86,8,1,30
S01011343,698,397,303,25,69,301,304,97,70,2,25,207,188,133,100,6,27,55,72,56,45,6,5,16,66,60,51,5,4,6,68,51,37,6,8,17
S01011344,696,407,299,24,84,289,304,115,81,6,28,189,208,145,99,9,37,63,77,60,48,3,9,17,57,44,36,3,5,13,50,43,35,3,5,7
S01011345,598,383,291,18,74,215,230,104,80,4,20,126,187,130,87,7,36,57,68,58,46,2,10,10,57,48,36,5,7,9,56,43,42,0,1,13
S01011346,569,333,261,31,41,236,262,93,77,7,9,169,132,106,79,13,14,26,67,52,37,6,9,15,48,36,29,2,5,12,60,46,39,3,4,14
S01011347,886,498,385,48,65,388,305,95,76,11,8,210,217,145,109,10,26,72,111,82,67,2,13,29,105,81,58,11,12,24,148,95,75,14,6,53
S01011348,738,445,344,30,71,293,275,107,68,10,29,168,174,111,84,8,19,63,109,82,62,5,15,27,70,57,49,4,4,13,110,88,81,3,4,22
S01011349,741,585,501,54,30,156,130,77,59,10,8,53,177,139,113,16,10,38,139,114,101,8,5,25,101,84,72,8,4,17,194,171,156,12,3,23
S01011350,571,333,261,57,15,238,116,31,20,10,1,85,130,77,57,13,7,53,101,64,56,6,2,37,66,44,35,7,2,22,158,117,93,21,3,41
S01011351,576,316,247,18,51,260,233,83,59,6,18,150,155,111,87,7,17,44,55,35,31,1,3,20,71,48,39,1,8,23,62,39,31,3,5,23
S01011352,552,345,267,34,44,207,195,56,38,3,15,139,116,91,63,8,20,25,72,56,47,5,4,16,66,57,50,3,4,9,103,85,69,15,1,18
S01011353,556,324,265,32,27,232,226,86,70,6,10,140,132,89,74,10,5,43,56,40,30,3,7,16,53,44,37,3,4,9,89,65,54,10,1,24
S01011354,608,363,294,45,24,245,141,50,37,8,5,91,141,86,69,12,5,55,87,62,51,6,5,25,67,50,44,5,1,17,172,115,93,14,8,57
S01011355,805,470,398,42,30,335,247,68,56,3,9,179,202,135,112,13,10,67,111,80,69,9,2,31,95,76,64,5,7,19,150,111,97,12,2,39
S01011356,791,548,373,152,23,243,197,82,39,41,2,115,156,116,65,39,12,40,101,77,55,20,2,24,90,74,53,17,4,16,247,199,161,35,3,48
S01011357,711,408,345,41,22,303,244,66,52,11,3,178,163,116,100,12,4,47,108,79,65,7,7,29,69,52,44,4,4,17,127,95,84,7,4,32
S01011358,434,353,318,15,20,81,53,33,23,2,8,20,107,76,67,6,3,31,93,78,69,3,6,15,53,48,46,0,2,5,128,118,113,4,1,10
S01011359,646,340,266,32,42,306,289,82,61,7,14,207,121,88,65,5,18,33,76,51,39,7,5,25,64,47,39,5,3,17,96,72,62,8,2,24
S01011360,573,394,302,16,76,179,188,95,66,4,25,93,186,136,97,4,35,50,54,44,37,3,4,10,67,53,46,4,3,14,78,66,56,1,9,12
S01011361,464,281,178,15,88,183,190,71,43,3,25,119,139,104,61,4,39,35,37,27,14,2,11,10,41,31,20,4,7,10,57,48,40,2,6,9
S01011362,428,334,271,54,9,94,80,41,19,22,0,39,95,74,62,9,3,21,70,57,47,10,0,13,56,52,45,5,2,4,127,110,98,8,4,17
S01011363,764,400,316,43,41,364,285,69,56,3,10,216,183,115,83,13,19,68,98,72,57,11,4,26,64,47,36,6,5,17,134,97,84,10,3,37
S01011364,521,349,304,22,23,172,152,56,48,4,4,96,131,101,79,9,13,30,71,60,54,3,3,11,65,51,48,1,2,14,102,81,75,5,1,21
S01011365,449,364,320,23,21,85,80,43,33,3,7,37,106,88,69,11,8,18,75,70,63,4,3,5,61,52,47,3,2,9,127,111,108,2,1,16
S01011366,454,205,178,12,15,249,228,40,36,2,2,188,98,70,57,5,8,28,36,26,21,2,3,10,33,28,26,0,2,5,59,41,38,3,0,18
S01011367,688,406,341,23,42,282,254,79,64,4,11,175,200,145,119,8,18,55,79,66,57,5,4,13,76,61,49,5,7,15,79,55,52,1,2,24
S01011368,628,544,480,48,16,84,64,36,27,9,0,28,153,135,114,17,4,18,105,86,69,10,7,19,93,85,81,4,0,8,213,202,189,8,5,11
S01011369,677,407,326,31,50,270,223,65,48,8,9,158,205,141,113,8,20,64,84,72,56,4,12,12,62,46,40,2,4,16,103,83,69,9,5,20
S01011370,631,494,444,22,28,137,126,52,43,3,6,74,135,105,88,8,9,30,107,97,89,2,6,10,84,77,70,3,4,7,179,163,154,6,3,16
S01011371,763,493,373,27,93,270,265,95,72,6,17,170,212,165,117,4,44,47,87,66,52,3,11,21,91,73,62,4,7,18,108,94,70,10,14,14
S01011372,574,334,244,13,77,240,245,79,59,4,16,166,165,127,81,1,45,38,59,47,40,1,6,12,53,45,35,5,5,8,52,36,29,2,5,16
S01011373,554,321,232,21,68,233,181,68,46,6,16,113,182,115,74,7,34,67,61,44,31,4,9,17,60,41,31,3,7,19,70,53,50,1,2,17
S01011374,537,423,371,21,31,114,94,48,42,5,1,46,130,106,95,4,7,24,127,108,91,7,10,19,78,61,52,3,6,17,108,100,91,2,7,8
S01011375,535,357,287,24,46,178,122,40,33,2,5,82,146,110,79,8,23,36,93,69,54,5,10,24,52,40,31,3,6,12,122,98,90,6,2,24
S01011376,431,229,188,17,24,202,182,42,32,4,6,140,110,78,61,7,10,32,49,41,37,1,3,8,40,31,26,1,4,9,50,37,32,4,1,13
S01011377,506,338,275,42,21,168,74,20,15,5,0,54,93,69,52,11,6,24,81,52,43,4,5,29,64,51,45,3,3,13,194,146,120,19,7,48
S01011378,676,381,318,37,26,295,223,51,37,9,5,172,137,91,71,11,9,46,106,79,69,6,4,27,68,49,43,3,3,19,142,111,98,8,5,31
S01011379,740,549,471,56,22,191,109,45,29,11,5,64,143,105,86,14,5,38,151,108,94,7,7,43,108,94,79,11,4,14,229,197,183,13,1,32
S01011380,583,372,315,26,31,211,158,53,39,9,5,105,131,82,68,5,9,49,87,66,59,2,5,21,81,67,57,4,6,14,126,104,92,6,6,22
S01011381,528,333,276,34,23,195,158,58,40,13,5,100,102,73,57,7,9,29,80,60,52,2,6,20,67,48,44,3,1,19,121,94,83,9,2,27
S01011382,437,302,239,31,32,135,140,60,42,8,10,80,111,84,61,12,11,27,63,53,46,3,4,10,54,45,38,2,5,9,69,60,52,6,2,9
S01011383,568,284,225,7,52,284,286,86,64,0,22,200,136,90,70,4,16,46,56,43,37,2,4,13,49,39,31,0,8,10,41,26,23,1,2,15
S01011384,522,295,187,19,89,227,254,101,61,4,36,153,158,114,68,6,40,44,43,31,21,5,5,12,32,21,15,2,4,11,35,28,22,2,4,7
S01011385,770,426,332,25,69,344,353,127,97,3,27,226,224,162,122,7,33,62,66,45,36,6,3,21,62,46,34,6,6,16,65,46,43,3,0,19
S01011386,468,271,195,13,63,197,246,101,64,4,33,145,136,104,75,6,23,32,30,25,19,0,6,5,27,20,18,1,1,7,29,21,19,2,0,8
S01011387,657,374,290,14,70,283,283,84,59,3,22,199,169,122,89,4,29,47,81,64,51,2,11,17,44,35,28,3,4,9,80,69,63,2,4,11
S01011388,816,641,563,42,36,175,124,52,42,4,6,72,230,180,153,13,14,50,135,108,96,6,6,27,107,94,82,8,4,13,220,207,190,11,6,13
S01011389,667,430,326,29,75,237,236,83,58,9,16,153,153,119,83,7,29,34,77,64,51,3,10,13,88,80,56,7,17,8,113,84,78,3,3,29
S01011390,666,381,312,17,52,285,298,94,74,7,13,204,147,111,87,2,22,36,76,63,54,3,6,13,71,56,46,1,9,15,74,57,51,4,2,17
S01011391,509,321,265,19,37,188,206,84,71,4,9,122,156,116,95,6,15,40,52,43,34,5,4,9,49,42,34,1,7,7,46,36,31,3,2,10
S01011392,542,348,260,22,66,194,233,110,82,7,21,123,168,124,85,6,33,44,51,43,34,4,5,8,48,36,29,2,5,12,42,35,30,3,2,7
S01011393,713,408,312,44,52,305,306,92,65,13,14,214,171,123,88,16,19,48,88,70,52,6,12,18,60,51,45,4,2,9,88,72,62,5,5,16
S01011394,419,333,297,23,13,86,63,22,15,6,1,41,95,78,64,5,9,17,86,72,66,5,1,14,57,53,48,3,2,4,118,108,104,4,0,10
S01011395,646,363,292,33,38,283,266,70,52,7,11,196,133,104,75,12,17,29,69,53,47,3,3,16,77,59,54,3,2,18,101,77,64,8,5,24
S01011396,663,352,289,27,36,311,264,50,40,4,6,214,135,98,75,8,15,37,86,71,56,7,8,15,59,45,39,3,3,14,119,88,79,5,4,31
S01011397,689,359,288,20,51,330,295,59,43,6,10,236,159,119,86,5,28,40,71,60,52,3,5,11,73,51,43,2,6,22,91,70,64,4,2,21
S01011398,591,350,261,19,70,241,247,85,57,6,22,162,169,124,84,6,34,45,64,53,48,0,5,11,44,37,26,2,9,7,67,51,46,5,0,16
S01011399,423,255,204,14,37,168,176,66,44,4,18,110,113,82,67,3,12,31,60,46,40,1,5,14,32,22,19,2,1,10,42,39,34,4,1,3
S01011400,581,387,334,28,25,194,155,50,35,5,10,105,126,90,76,4,10,36,64,49,42,5,2,15,74,63,60,2,1,11,162,135,121,12,2,27
S01011401,552,305,263,23,19,247,206,46,40,3,3,160,116,81,62,9,10,35,68,52,44,3,5,16,56,44,40,3,1,12,106,82,77,5,0,24
S01011402,840,405,330,33,42,435,345,71,51,11,9,274,150,91,73,7,11,59,106,75,66,3,6,31,71,59,45,3,11,12,168,109,95,9,5,59
S01011403,424,302,266,15,21,122,123,60,48,2,10,63,119,89,79,5,5,30,66,53,46,3,4,13,47,40,37,2,1,7,69,60,56,3,1,9
S01011404,797,440,359,27,54,357,299,83,62,6,15,216,189,128,98,8,22,61,111,82,69,8,5,29,67,51,47,1,3,16,131,96,83,4,9,35
S01011405,525,307,244,31,32,218,142,41,27,6,8,101,133,96,76,6,14,37,60,39,35,2,2,21,63,49,41,5,3,14,127,82,65,12,5,45
S01011406,551,337,275,27,35,214,207,78,58,9,11,129,132,97,80,3,14,35,67,52,43,5,4,15,57,45,41,4,0,12,88,65,53,6,6,23
S01011407,936,566,471,49,46,370,294,100,82,9,9,194,251,173,142,17,14,78,132,103,89,6,8,29,97,75,58,7,10,22,162,115,100,10,5,47
S01011408,691,414,342,24,48,277,270,101,83,7,11,169,194,138,111,8,19,56,88,68,53,1,14,20,64,51,44,5,2,13,75,56,51,3,2,19
S01011409,631,408,317,28,63,223,212,88,62,8,18,124,190,138,106,2,30,52,81,63,48,4,11,18,67,54,44,8,2,13,81,65,57,6,2,16
S01011410,540,329,283,17,29,211,211,67,53,1,13,144,149,109,97,5,7,40,63,55,44,5,6,8,50,45,39,4,2,5,67,53,50,2,1,14
S01011411,555,351,281,27,43,204,208,79,65,5,9,129,152,120,89,8,23,32,78,66,50,8,8,12,45,35,28,5,2,10,72,51,49,1,1,21
S01011412,751,459,385,54,20,292,174,52,35,11,6,122,153,110,88,17,5,43,130,96,84,11,1,34,83,68,57,8,3,15,211,133,121,7,5,78
S01011413,459,352,309,24,19,107,81,36,28,5,3,45,114,93,80,4,9,21,103,82,76,4,2,21,65,58,51,4,3,7,96,83,74,7,2,13
S01011414,668,400,322,29,49,268,219,67,46,6,15,152,178,131,105,6,20,47,104,76,61,3,12,28,67,54,49,5,0,13,100,72,61,9,2,28
S01011415,728,484,413,32,39,244,229,83,59,10,14,146,184,141,123,6,12,43,108,87,75,8,4,21,77,65,53,5,7,12,130,108,103,3,2,22
S01011416,530,371,323,33,15,159,96,39,27,9,3,57,115,82,68,9,5,33,140,114,106,5,3,26,64,54,47,5,2,10,115,82,75,5,2,33
S01011417,686,382,315,38,29,304,268,78,57,13,8,190,154,112,94,5,13,42,95,74,63,6,5,21,69,46,41,3,2,23,100,72,60,11,1,28
S01011418,463,257,218,11,28,206,214,73,63,4,6,141,122,86,64,6,16,36,47,37,35,0,2,10,39,34,29,1,4,5,41,27,27,0,0,14
S01011419,471,283,236,20,27,188,183,61,48,4,9,122,133,95,76,7,12,38,59,48,45,0,3,11,42,38,36,1,1,4,54,41,31,8,2,13
S01011420,405,224,167,16,41,181,167,57,39,7,11,110,115,80,55,4,21,35,53,40,35,2,3,13,26,15,10,0,5,11,44,32,28,3,1,12
S01011421,445,346,299,19,28,99,62,32,23,2,7,30,127,92,73,5,14,35,73,60,55,4,1,13,70,64,57,4,3,6,113,98,91,4,3,15
S01011422,540,315,250,19,46,225,274,106,84,3,19,168,121,96,72,8,16,25,47,33,23,3,7,14,40,33,29,1,3,7,58,47,42,4,1,11
S01011423,416,220,162,10,48,196,198,69,41,4,24,129,102,63,46,3,14,39,28,18,15,1,2,10,37,33,26,2,5,4,51,37,34,0,3,14
S01011424,466,286,246,18,22,180,205,80,62,7,11,125,122,85,73,4,8,37,54,45,41,2,2,9,34,32,30,2,0,2,51,44,40,3,1,7
S01011425,691,414,299,40,75,277,241,87,55,15,17,154,189,130,94,10,26,59,82,59,44,3,12,23,51,40,27,1,12,11,128,98,79,11,8,30
S01011426,805,558,459,81,18,247,204,64,41,19,4,140,161,121,93,20,8,40,117,93,76,14,3,24,89,77,65,11,1,12,234,203,184,17,2,31
S01011427,562,335,261,33,41,227,205,68,54,6,8,137,151,109,75,11,23,42,67,55,46,4,5,12,49,40,30,8,2,9,90,63,56,4,3,27
S01011428,433,255,218,19,18,178,178,57,43,6,8,121,85,64,55,4,5,21,62,51,45,4,2,11,48,36,33,2,1,12,60,47,42,3,2,13
S01011429,1048,494,398,76,20,554,292,77,57,17,3,215,295,137,108,18,11,158,151,81,69,9,3,70,119,67,55,11,1,52,191,132,109,21,2,59
S01011430,762,519,433,46,40,243,224,86,68,12,6,138,183,145,110,13,22,38,109,89,78,6,5,20,88,74,66,5,3,14,158,125,111,10,4,33
S01011431,911,519,433,40,46,392,411,139,115,9,15,272,233,179,147,13,19,54,94,70,60,6,4,24,67,57,48,5,4,10,106,74,63,7,4,32
S01011432,872,545,453,30,62,327,370,142,115,8,19,228,240,191,158,6,27,49,98,83,68,7,8,15,79,65,56,1,8,14,85,64,56,8,0,21
S01011433,666,429,329,21,79,237,290,139,100,8,31,151,213,160,121,7,32,53,66,52,45,1,6,14,47,40,31,2,7,7,50,38,32,3,3,12
S01011434,484,299,249,24,26,185,174,64,49,7,8,110,121,99,83,7,9,22,63,51,45,2,4,12,47,40,35,3,2,7,79,45,37,5,3,34
S01011435,765,541,463,39,39,224,197,75,65,4,6,122,189,150,119,13,18,39,91,78,63,7,8,13,88,75,64,7,4,13,200,163,152,8,3,37
S01011436,604,383,290,28,65,221,230,87,58,8,21,143,187,145,106,9,30,42,61,52,41,5,6,9,52,42,34,3,5,10,74,57,51,3,3,17
S01011437,610,354,285,26,43,256,263,93,65,4,24,170,168,123,93,15,15,45,72,57,56,1,0,15,44,38,33,2,3,6,63,43,38,4,1,20
S01011438,427,271,201,8,62,156,188,86,65,2,19,102,137,108,75,4,29,29,43,35,30,0,5,8,35,27,19,1,7,8,24,15,12,1,2,9
S01011439,739,457,356,44,57,282,333,154,111,12,31,179,203,154,123,15,16,49,60,42,34,4,4,18,47,38,26,7,5,9,96,69,62,6,1,27
S01011440,485,287,244,16,27,198,230,86,74,4,8,144,135,109,91,6,12,26,43,32,28,0,4,11,34,27,22,4,1,7,43,33,29,2,2,10
S01011441,640,419,332,24,63,221,268,118,82,12,24,150,189,148,114,4,30,41,72,62,52,5,5,10,49,41,36,3,2,8,62,50,48,0,2,12
S01011442,567,312,256,24,32,255,248,84,69,8,7,164,161,113,87,8,18,48,62,41,33,4,4,21,45,35,33,1,1,10,51,39,34,3,2,12
S01011443,513,284,233,21,30,229,239,87,65,9,13,152,137,92,79,5,8,45,49,37,33,1,3,12,44,35,30,4,1,9,44,33,26,2,5,11
S01011444,611,344,268,21,55,267,277,90,67,8,15,187,175,126,97,4,25,49,68,56,43,5,8,12,47,37,29,4,4,10,44,35,32,0,3,9
S01011445,431,282,229,24,29,149,149,51,35,7,9,98,108,80,61,9,10,28,49,40,34,2,4,9,49,41,37,1,3,8,76,70,62,5,3,6
S01011446,425,273,201,54,18,152,145,59,31,19,9,86,109,82,59,16,7,27,76,63,53,8,2,13,29,19,16,3,0,10,66,50,42,8,0,16
S01011447,682,433,348,39,46,249,232,89,67,10,12,143,216,156,121,14,21,60,93,76,63,6,7,17,73,57,51,2,4,16,68,55,46,7,2,13
S01011448,760,513,426,50,37,247,218,84,61,13,10,134,189,149,121,17,11,40,128,97,80,9,8,31,77,67,61,2,4,10,148,116,103,9,4,32
S01011449,451,256,206,19,31,195,205,68,51,7,10,137,106,78,60,4,14,28,45,37,33,2,2,8,37,33,27,2,4,4,58,40,35,4,1,18
S01011450,493,338,273,43,22,155,125,40,33,4,3,85,122,92,64,13,15,30,69,61,46,12,3,8,38,31,26,5,0,7,139,114,104,9,1,25
S01011451,548,418,300,87,31,130,84,45,29,16,0,39,124,93,64,17,12,31,104,78,61,8,9,26,75,65,42,17,6,10,161,137,104,29,4,24
S01011452,778,549,464,54,31,229,181,86,67,15,4,95,205,152,118,19,15,53,144,112,99,7,6,32,81,65,58,2,5,16,167,134,122,11,1,33
S01011453,585,347,294,26,27,238,205,71,54,9,8,134,148,97,85,5,7,51,90,65,55,4,6,25,44,33,28,2,3,11,98,81,72,6,3,17
S01011454,634,384,320,23,41,250,233,80,66,6,8,153,178,140,115,7,18,38,66,53,39,4,10,13,73,54,48,2,4,19,84,57,52,4,1,27
S01011455,623,356,279,23,54,267,260,97,59,11,27,163,170,120,94,6,20,50,82,62,57,1,4,20,49,34,30,2,2,15,62,43,39,3,1,19
S01011456,690,388,306,37,45,302,294,109,85,15,9,185,174,121,90,9,22,53,86,59,47,6,6,27,54,40,34,2,4,14,82,59,50,5,4,23
S01011457,731,470,386,25,59,261,299,128,98,9,21,171,197,151,126,5,20,46,92,78,66,3,9,14,61,49,42,2,5,12,82,64,54,6,4,18
S01011458,873,690,605,53,32,183,165,79,66,9,4,86,203,162,134,13,15,41,191,170,152,16,2,21,126,110,99,5,6,16,188,169,154,10,5,19
S01011459,787,601,512,49,40,186,157,64,49,7,8,93,202,158,131,10,17,44,150,131,112,13,6,19,96,89,77,8,4,7,182,159,143,11,5,23
S01011460,554,388,312,29,47,166,171,72,50,9,13,99,134,105,77,8,20,29,98,77,66,3,8,21,57,52,42,6,4,5,94,82,77,3,2,12
S01011461,580,391,319,23,49,189,210,103,83,11,9,107,171,131,96,7,28,40,74,56,49,4,3,18,65,54,49,1,4,11,60,47,42,0,5,13
S01011462,760,504,423,42,39,256,228,82,59,13,10,146,162,112,94,7,11,50,126,103,88,5,10,23,92,77,70,5,2,15,152,130,112,12,6,22
S01011463,556,358,301,39,18,198,178,55,42,9,4,123,140,98,83,9,6,42,91,75,61,9,5,16,69,62,54,6,2,7,78,68,61,6,1,10
S01011464,436,359,311,33,15,77,56,33,25,6,2,23,102,80,63,13,4,22,74,57,47,3,7,17,60,54,51,3,0,6,144,135,125,8,2,9
S01011465,406,233,179,19,35,173,178,67,47,6,14,111,104,67,53,6,8,37,36,29,21,2,6,7,38,34,29,2,3,4,50,36,29,3,4,14
S01011466,494,272,222,16,34,222,211,53,43,1,9,158,112,83,68,5,10,29,61,48,41,4,3,13,53,42,33,3,6,11,57,46,37,3,6,11
S01011467,418,291,244,17,30,127,121,52,38,6,8,69,104,76,60,3,13,28,66,51,45,4,2,15,51,43,37,2,4,8,76,69,64,2,3,7
S01011468,623,541,472,47,22,82,83,53,36,14,3,30,162,137,119,11,7,25,101,85,72,7,6,16,93,87,84,3,0,6,184,179,161,12,6,5
S01011469,639,428,331,24,73,211,211,105,74,7,24,106,189,136,96,5,35,53,82,62,53,2,7,20,61,42,35,3,4,19,96,83,73,7,3,13
S01011470,928,536,455,44,37,392,334,111,83,16,12,223,205,129,112,9,8,76,143,108,95,7,6,35,97,68,57,5,6,29,149,120,108,7,5,29
S01011471,776,419,360,33,26,357,270,58,49,7,2,212,147,103,88,7,8,44,131,87,75,7,5,44,68,58,48,5,5,10,160,113,100,7,6,47
S01011472,768,416,318,24,74,352,290,93,64,5,24,197,196,135,90,13,32,61,107,62,53,1,8,45,69,54,44,3,7,15,106,72,67,2,3,34
S01011473,613,261,210,11,40,352,327,83,64,5,14,244,126,77,59,3,15,49,60,38,33,0,5,22,50,30,28,0,2,20,50,33,26,3,4,17
S01011474,690,341,269,15,57,349,301,65,46,5,14,236,151,110,90,2,18,41,71,52,39,0,13,19,59,39,31,1,7,20,108,75,63,7,5,33
S01011475,520,238,185,9,44,282,247,62,37,7,18,185,117,73,58,0,15,44,42,33,27,1,5,9,44,31,27,0,4,13,70,39,36,1,2,31
S01011476,413,284,259,16,9,129,73,29,28,1,0,44,76,52,47,4,1,24,82,71,65,4,2,11,53,41,35,2,4,12,129,91,84,5,2,38
S01011477,710,437,382,42,13,273,136,50,38,10,2,86,137,72,59,9,4,65,140,100,91,4,5,40,86,58,55,3,0,28,211,157,139,16,2,54
S01011478,861,594,503,67,24,267,136,38,25,11,2,98,142,99,81,11,7,43,157,117,97,14,6,40,104,82,72,9,1,22,322,258,228,22,8,64
S01011479,693,425,362,43,20,268,157,46,38,6,2,111,118,66,53,6,7,52,121,87,74,8,5,34,76,59,53,5,1,17,221,167,144,18,5,54
S01011480,856,547,471,68,8,309,161,46,34,12,0,115,115,68,56,10,2,47,130,93,80,13,0,37,104,70,57,11,2,34,346,270,244,22,4,76
S01011481,637,475,405,42,28,162,172,84,71,7,6,88,146,116,88,16,12,30,100,83,70,7,6,17,76,62,56,6,0,14,143,130,120,6,4,13
S01011482,747,417,344,24,49,330,278,69,53,6,10,209,177,128,100,6,22,49,99,76,62,4,10,23,75,61,53,3,5,14,118,83,76,5,2,35
S01011483,438,309,260,31,18,129,84,30,22,6,2,54,77,57,46,4,7,20,82,65,55,10,0,17,51,40,35,2,3,11,144,117,102,9,6,27
S01011484,710,407,333,21,53,303,310,120,96,5,19,190,193,128,99,5,24,65,82,66,53,6,7,16,57,39,36,2,1,18,68,54,49,3,2,14
S01011485,754,420,329,14,77,334,352,131,100,3,28,221,191,124,91,5,28,67,88,67,53,2,12,21,59,46,37,1,8,13,64,52,48,3,1,12
S01011486,437,211,170,11,30,226,208,57,45,2,10,151,104,67,52,5,10,37,56,44,33,4,7,12,32,18,15,0,3,14,37,25,25,0,0,12
S01011487,877,547,452,36,59,330,335,114,87,9,18,221,268,211,166,18,27,57,93,73,67,1,5,20,79,63,57,1,5,16,102,86,75,7,4,16
S01011488,519,288,223,16,49,231,238,85,61,3,21,153,151,104,80,3,21,47,60,43,35,3,5,17,27,20,15,4,1,7,43,36,32,3,1,7
S01011489,543,464,385,40,39,79,81,53,38,8,7,28,165,136,111,11,14,29,107,91,77,7,7,16,82,79,66,7,6,3,108,105,93,7,5,3
S01011490,864,526,446,34,46,338,351,106,86,11,9,245,190,151,120,9,22,39,108,91,81,3,7,17,86,67,61,2,4,19,129,111,98,9,4,18
S01011491,415,259,201,9,49,156,187,73,50,3,20,114,100,78,57,2,19,22,39,32,28,0,4,7,40,34,31,2,1,6,49,42,35,2,5,7
S01011492,597,389,311,24,54,208,191,77,54,6,17,114,158,119,96,2,21,39,69,49,47,0,2,20,63,52,37,7,8,11,116,92,77,9,6,24
S01011493,398,344,302,27,15,54,46,31,26,3,2,15,85,70,58,8,4,15,89,77,67,4,6,12,53,48,41,6,1,5,125,118,110,6,2,7
S01011494,617,370,319,20,31,247,266,99,80,6,13,167,153,108,91,7,10,45,76,60,53,3,4,16,51,41,37,2,2,10,71,62,58,2,2,9
S01011495,664,389,315,16,58,275,266,92,71,5,16,174,179,133,105,7,21,46,85,62,50,2,10,23,60,46,43,1,2,14,74,56,46,1,9,18
S01011496,494,298,246,13,39,196,215,93,77,6,10,122,137,90,74,0,16,47,51,38,29,1,8,13,38,32,28,2,2,6,53,45,38,4,3,8
S01011497,492,387,328,30,29,105,93,48,36,8,4,45,156,124,100,9,15,32,88,74,66,6,2,14,63,60,52,2,6,3,92,81,74,5,2,11
S01011498,539,446,386,36,24,93,90,58,46,9,3,32,161,137,113,13,11,24,108,93,82,6,5,15,69,64,55,5,4,5,111,94,90,3,1,17
S01011499,676,488,416,38,34,188,200,80,63,10,7,120,186,157,127,14,16,29,89,75,65,7,3,14,80,71,64,3,4,9,121,105,97,4,4,16
S01011500,424,284,240,20,24,140,141,61,43,7,11,80,119,88,75,4,9,31,73,59,53,5,1,14,38,32,28,2,2,6,53,44,41,2,1,9
S01011501,537,329,245,22,62,208,265,114,81,7,26,151,140,106,76,2,28,34,68,59,49,6,4,9,33,25,19,2,4,8,31,25,20,5,0,6
S01011502,610,402,328,25,49,208,257,118,92,7,19,139,166,133,107,11,15,33,73,57,47,3,7,16,61,55,49,0,6,6,53,39,33,4,2,14
S01011503,508,316,257,27,32,192,187,67,57,3,7,120,156,117,93,6,18,39,62,50,42,6,2,12,45,37,30,5,2,8,58,45,35,7,3,13
S01011504,483,286,229,27,30,197,186,61,45,10,6,125,128,99,75,7,17,29,65,45,37,4,4,20,41,30,24,4,2,11,63,51,48,2,1,12
S01011505,552,352,281,19,52,200,185,81,60,5,16,104,170,110,80,8,22,60,77,67,61,2,4,10,59,46,37,2,7,13,61,48,43,2,3,13
S01011506,432,238,204,17,17,194,173,51,42,5,4,122,97,66,51,5,10,31,54,36,34,0,2,18,42,33,26,6,1,9,66,52,51,1,0,14
S01011507,514,306,259,20,27,208,215,83,70,5,8,132,134,97,76,8,13,37,59,44,40,2,2,15,40,33,32,1,0,7,66,49,41,4,4,17
S01011508,788,589,498,32,59,199,214,105,72,10,23,109,220,182,143,11,28,38,111,93,86,6,1,18,100,85,79,1,5,15,143,124,118,4,2,19
S01011509,521,351,294,27,30,170,162,71,57,4,10,91,163,116,94,8,14,47,66,52,46,4,2,14,60,55,50,4,1,5,70,57,47,7,3,13
S01011510,840,528,411,23,94,312,311,120,92,5,23,191,261,198,138,9,51,63,116,90,70,4,16,26,68,51,44,3,4,17,84,69,67,2,0,15
S01011511,435,269,200,13,56,166,202,83,60,2,21,119,129,101,71,6,24,28,37,29,24,1,4,8,32,24,17,4,3,8,35,32,28,0,4,3
S01011512,693,395,292,19,84,298,279,102,73,4,25,177,238,165,118,5,42,73,64,45,35,1,9,19,67,48,41,1,6,19,45,35,25,8,2,10
S01011513,609,370,292,13,65,239,278,120,83,9,28,158,162,109,86,1,22,53,58,42,36,0,6,16,58,53,49,1,3,5,53,46,38,2,6,7
S01011514,732,459,370,28,61,273,335,160,122,12,26,175,204,155,122,5,28,49,60,41,35,2,4,19,67,54,46,5,3,13,66,49,45,4,0,17
S01011515,451,340,287,25,28,111,120,58,50,2,6,62,132,109,90,8,11,23,64,53,40,5,8,11,60,54,49,3,2,6,75,66,58,7,1,9
S01011516,718,560,481,51,28,158,135,72,54,12,6,63,179,141,117,15,9,38,124,104,89,10,5,20,113,99,90,6,3,14,167,144,131,8,5,23
S01011517,453,282,241,21,20,171,185,77,57,10,10,108,131,92,81,8,3,39,51,42,36,2,4,9,46,36,35,0,1,10,40,35,32,1,2,5
S01011518,552,276,217,25,34,276,291,91,62,12,17,200,127,85,70,5,10,42,48,33,27,5,1,15,45,34,30,1,3,11,41,33,28,2,3,8
S01011519,642,399,332,15,52,243,290,125,105,5,15,165,173,131,102,5,24,42,69,55,44,4,7,14,54,45,42,1,2,9,56,43,39,0,4,13
S01011520,470,260,206,12,42,210,249,89,62,5,22,160,113,86,68,3,15,27,36,30,27,0,3,6,32,24,21,2,1,8,40,31,28,2,1,9
S01011521,753,461,365,23,73,292,274,105,75,3,27,169,214,149,117,5,27,65,91,71,62,2,7,20,72,56,46,3,7,16,102,80,65,10,5,22
S01011522,744,456,378,25,53,288,281,93,77,6,10,188,196,153,118,7,28,43,91,69,58,2,9,22,82,70,62,4,4,12,94,71,63,6,2,23
S01011523,611,419,339,29,51,192,261,131,96,13,22,130,160,129,110,6,13,31,67,53,44,6,3,14,61,52,37,2,13,9,62,54,52,2,0,8
S01011524,762,561,483,46,32,201,212,101,77,16,8,111,218,172,150,10,12,46,126,106,96,5,5,20,91,84,79,4,1,7,115,98,81,11,6,17
S01011525,783,497,447,41,9,286,284,105,90,14,1,179,194,139,122,13,4,55,94,77,72,4,1,17,75,67,61,3,3,8,136,109,102,7,0,27
S01011526,814,532,457,32,43,282,258,102,81,8,13,156,252,187,160,9,18,65,110,85,77,3,5,25,75,61,55,3,3,14,119,97,84,9,4,22
S01011527,610,367,302,37,28,243,198,74,60,7,7,124,153,103,79,14,10,50,90,70,62,5,3,20,49,39,32,0,7,10,120,81,69,11,1,39
S01011528,830,470,390,26,54,360,342,113,90,7,16,229,212,143,115,7,21,69,86,66,54,5,7,20,84,69,64,4,1,15,106,79,67,3,9,27
S01011529,422,242,183,15,44,180,189,65,47,2,16,124,120,87,67,4,16,33,35,24,21,1,2,11,39,36,27,3,6,3,39,30,21,5,4,9
S01011530,810,493,410,26,57,317,342,120,101,7,12,222,220,177,133,11,33,43,78,60,51,3,6,18,81,63,58,2,3,18,89,73,67,3,3,16
S01011531,910,603,505,68,30,307,263,81,58,18,5,182,197,138,98,28,12,59,137,107,95,6,6,30,95,81,69,7,5,14,218,196,185,9,2,22
S01011532,475,372,300,53,19,103,86,48,33,12,3,38,114,88,67,13,8,26,79,65,53,11,1,14,68,57,48,7,2,11,128,114,99,10,5,14
S01011533,570,289,218,21,50,281,282,84,59,8,17,198,118,78,59,0,19,40,59,41,30,5,6,18,48,39,30,4,5,9,63,47,40,4,3,16
S01011534,596,364,307,30,27,232,224,76,53,9,14,148,146,105,83,12,10,41,80,62,59,2,1,18,54,45,43,2,0,9,92,76,69,5,2,16
S01011535,765,362,262,25,75,403,382,109,72,3,34,273,196,124,83,7,34,72,74,51,43,6,2,23,44,32,25,3,4,12,69,46,39,6,1,23
S01011536,573,425,351,47,27,148,119,51,39,7,5,68,112,85,69,11,5,27,92,75,61,7,7,17,68,63,52,8,3,5,182,151,130,14,7,31
S01011537,445,359,317,21,21,86,71,34,28,1,5,37,95,79,65,6,8,16,80,71,66,5,0,9,62,56,47,5,4,6,137,119,111,4,4,18
S01011538,559,385,337,31,17,174,110,40,35,5,0,70,105,76,60,7,9,29,97,71,63,6,2,26,60,46,43,3,0,14,187,152,136,10,6,35
S01011539,619,363,287,24,52,256,285,113,88,8,17,172,151,109,76,7,26,42,60,46,39,3,4,14,55,40,37,0,3,15,68,55,47,6,2,13
S01011540,849,551,470,47,34,298,339,135,109,14,12,204,244,192,159,15,18,52,103,87,81,5,1,16,76,64,55,7,2,12,87,73,66,6,1,14
S01011541,716,466,371,36,59,250,302,146,113,16,17,156,225,169,130,11,28,56,68,52,41,5,6,16,64,52,43,1,8,12,57,47,44,3,0,10
S01011542,735,464,387,27,50,271,332,150,123,12,15,182,199,149,113,11,25,50,88,76,68,1,7,12,61,45,44,1,0,16,55,44,39,2,3,11
S01011543,611,392,308,20,64,219,276,133,105,5,23,143,201,154,108,11,35,47,64,49,45,2,2,15,35,26,22,2,2,9,35,30,28,0,2,5
S01011544,550,316,263,20,33,234,280,120,93,13,14,160,148,106,87,5,14,42,43,31,28,1,2,12,32,22,19,0,3,10,47,37,36,1,0,10
S01011545,488,287,249,15,23,201,238,91,76,7,8,147,119,91,76,6,9,28,51,41,37,0,4,10,36,29,28,1,0,7,44,35,32,1,2,9
S01011546,550,459,376,61,22,91,82,57,40,14,3,25,135,113,85,18,10,22,116,95,78,14,3,21,64,60,52,5,3,4,153,134,121,10,3,19
S01011547,434,358,301,34,23,76,58,32,27,4,1,26,123,107,81,13,13,16,68,56,47,6,3,12,56,46,41,2,3,10,129,117,105,9,3,12
S01011548,614,366,308,31,27,248,232,79,62,12,5,153,144,108,91,8,9,36,83,64,52,4,8,19,70,51,45,3,3,19,85,64,58,4,2,21
S01011549,678,442,370,36,36,236,214,85,69,8,8,129,138,106,78,9,19,32,103,76,68,4,4,27,71,54,43,7,4,17,152,121,112,8,1,31
S01011550,607,402,338,44,20,205,113,40,27,10,3,73,119,76,62,7,7,43,131,93,82,7,4,38,66,54,46,5,3,12,178,139,121,15,3,39
S01011551,450,278,231,29,18,172,142,56,42,8,6,86,111,72,62,6,4,39,63,45,35,6,4,18,45,37,35,2,0,8,89,68,57,7,4,21
S01011552,602,422,355,38,29,180,145,60,51,3,6,85,158,118,91,15,12,40,115,89,77,6,6,26,67,59,47,7,5,8,117,96,89,7,0,21
S01011553,618,506,407,68,31,112,81,51,32,14,5,30,114,84,53,22,9,30,123,98,81,12,5,25,80,68,56,6,6,12,220,205,185,14,6,15
S01011554,733,423,357,31,35,310,333,107,95,6,6,226,198,150,123,10,17,48,69,53,44,4,5,16,51,47,40,3,4,4,82,66,55,8,3,16
S01011555,458,303,254,15,34,155,179,71,56,4,11,108,145,119,95,7,17,26,69,58,54,2,2,11,31,28,22,2,4,3,34,27,27,0,0,7
S01011556,402,246,187,25,34,156,170,74,54,7,13,96,112,75,55,9,11,37,46,36,30,2,4,10,30,23,16,1,6,7,44,38,32,6,0,6
S01011557,594,383,326,24,33,211,261,103,83,8,12,158,167,140,115,9,16,27,69,58,53,2,3,11,56,48,42,4,2,8,41,34,33,1,0,7
S01011558,457,305,249,24,32,152,182,91,75,8,8,91,146,112,88,8,16,34,55,44,37,3,4,11,41,35,33,2,0,6,33,23,16,3,4,10
S01011559,494,303,236,16,51,191,229,93,71,7,15,136,146,114,83,4,27,32,46,40,37,1,2,6,32,24,20,1,3,8,41,32,25,3,4,9
S01011560,618,381,328,16,37,237,299,122,99,9,14,177,156,124,104,4,16,32,60,50,47,1,2,10,48,41,41,0,0,7,55,44,37,2,5,11
S01011561,646,390,313,13,64,256,284,103,79,5,19,181,170,138,110,5,23,32,68,51,41,1,9,17,65,54,44,0,10,11,59,44,39,2,3,15
S01011562,485,307,244,20,43,178,192,83,59,4,20,109,152,112,90,9,13,40,64,46,37,4,5,18,32,25,22,1,2,7,45,41,36,2,3,4
S01011563,585,353,283,25,45,232,256,95,66,9,20,161,159,115,88,10,17,44,60,53,49,2,2,7,50,40,34,2,4,10,60,50,46,2,2,10
S01011564,771,532,446,38,48,239,272,116,100,7,9,156,217,173,122,23,28,44,109,93,85,2,6,16,83,73,67,2,4,10,90,77,72,4,1,13
S01011565,743,523,441,29,53,220,305,158,117,15,26,147,185,140,119,6,15,45,91,78,72,2,4,13,85,80,72,4,4,5,77,67,61,2,4,10
S01011566,695,453,357,27,69,242,274,130,94,9,27,144,206,145,117,6,22,61,78,62,50,2,10,16,73,62,51,6,5,11,64,54,45,4,5,10
S01011567,831,452,371,34,47,379,411,138,111,12,15,273,195,141,112,13,16,54,84,65,51,6,8,19,60,44,36,3,5,16,81,64,61,0,3,17
S01011568,652,445,370,33,42,207,229,92,67,12,13,137,174,138,117,4,17,36,91,77,64,7,6,14,55,46,41,3,2,9,103,92,81,7,4,11
S01011569,804,488,419,28,41,316,287,86,72,7,7,201,198,143,122,9,12,55,114,86,72,4,10,28,91,81,70,4,7,10,114,92,83,4,5,22
S01011570,606,332,291,18,23,274,275,83,67,8,8,192,156,118,102,5,11,38,68,44,40,2,2,24,50,45,42,2,1,5,57,42,40,1,1,15
S01011571,572,324,267,18,39,248,262,88,73,4,11,174,137,102,82,5,15,35,44,33,26,4,3,11,56,46,38,3,5,10,73,55,48,2,5,18
S01011572,486,307,247,26,34,179,180,61,46,7,8,119,120,93,75,6,12,27,64,52,44,4,4,12,45,41,32,4,5,4,77,60,50,5,5,17
S01011573,842,594,500,57,37,248,241,84,63,11,10,157,225,175,141,21,13,50,128,112,94,12,6,16,95,83,74,6,3,12,153,140,128,7,5,13
S01011574,606,432,363,40,29,174,194,77,58,8,11,117,172,150,117,23,10,22,94,79,72,3,4,15,69,57,51,3,3,12,77,69,65,3,1,8
S01011575,408,256,201,17,38,152,153,58,41,5,12,95,108,77,56,4,17,31,45,37,29,3,5,8,45,31,27,2,2,14,57,53,48,3,2,4
S01011576,737,331,248,15,68,406,390,104,76,8,20,286,188,112,80,6,26,76,50,38,31,0,7,12,56,38,31,1,6,18,53,39,30,0,9,14
S01011577,572,393,321,30,42,179,163,67,47,6,14,96,147,108,90,9,9,39,84,66,51,4,11,18,63,57,50,3,4,6,115,95,83,8,4,20
S01011578,676,445,360,20,65,231,206,85,68,5,12,121,219,164,121,6,37,55,99,78,61,6,11,21,64,49,47,0,2,15,88,69,63,3,3,19
S01011579,906,592,481,79,32,314,159,42,31,10,1,117,185,122,91,23,8,63,165,122,106,7,9,43,104,78,64,10,4,26,293,228,189,29,10,65
S01011580,557,366,301,31,34,191,154,54,33,10,11,100,169,117,90,11,16,52,72,60,54,3,3,12,62,48,42,3,3,14,100,87,82,4,1,13
S01011581,693,330,264,24,42,363,366,89,67,7,15,277,140,97,76,5,16,43,66,47,36,3,8,19,52,41,35,3,3,11,69,56,50,6,0,13
S01011582,957,639,546,68,25,318,209,68,52,15,1,141,147,113,93,13,7,34,161,117,96,14,7,44,111,85,76,7,2,26,329,256,229,19,8,73
S01011583,559,374,317,19,38,185,165,66,46,8,12,99,157,113,94,3,16,44,71,57,50,4,3,14,60,49,45,1,3,11,106,89,82,3,4,17
S01011584,591,361,314,11,36,230,258,103,83,4,16,155,151,114,99,2,13,37,77,58,53,2,3,19,53,47,43,1,3,6,52,39,36,2,1,13
S01011585,585,350,300,24,26,235,212,70,55,8,7,142,167,123,105,12,6,44,83,57,48,2,7,26,53,43,38,1,4,10,70,57,54,1,2,13
S01011586,482,299,246,11,42,183,205,80,60,4,16,125,120,88,70,2,16,32,58,47,41,2,4,11,58,52,47,1,4,6,41,32,28,2,2,9
S01011587,451,277,237,11,29,174,169,71,53,7,11,98,137,98,84,3,11,39,52,37,34,0,3,15,48,36,34,1,1,12,45,35,32,0,3,10
S01011588,609,372,299,31,42,237,232,92,64,14,14,140,190,132,110,6,16,58,74,56,44,4,8,18,53,42,35,5,2,11,60,50,46,2,2,10
S01011589,707,419,364,26,29,288,263,79,67,4,8,184,183,142,120,14,8,41,94,76,67,3,6,18,76,54,51,2,1,22,91,68,59,3,6,23
S01011590,552,339,279,17,43,213,213,76,64,2,10,137,154,123,87,10,26,31,69,50,44,2,4,19,53,45,42,2,1,8,63,45,42,1,2,18
S01011591,501,301,227,20,54,200,212,86,60,10,16,126,143,107,78,5,24,36,70,54,44,3,7,16,37,24,20,1,3,13,39,30,25,1,4,9
S01011592,563,329,261,19,49,234,273,105,75,7,23,168,128,96,75,3,18,32,58,40,35,3,2,18,54,46,42,3,1,8,50,42,34,3,5,8
S01011593,601,367,312,28,27,234,211,69,58,5,6,142,148,107,90,7,10,41,74,60,49,7,4,14,58,44,39,3,2,14,110,87,76,6,5,23
S01011594,385,227,192,20,15,158,141,38,30,7,1,103,101,75,59,9,7,26,48,39,34,2,3,9,30,27,25,0,2,3,65,48,44,2,2,17
S01011595,513,373,302,44,27,140,99,46,35,8,3,53,96,68,49,9,10,28,95,82,70,6,6,13,50,47,34,10,3,3,173,130,114,11,5,43
S01011596,865,568,479,36,53,297,241,83,63,8,12,158,170,117,97,5,15,53,124,98,83,4,11,26,98,82,69,7,6,16,232,188,167,12,9,44
S01011597,537,349,301,23,25,188,168,58,46,8,4,110,117,81,63,6,12,36,82,72,66,2,4,10,62,56,50,3,3,6,108,82,76,4,2,26
S01011598,682,400,244,21,135,282,296,126,71,7,48,170,201,134,82,6,46,67,53,37,17,1,19,16,68,56,40,1,15,12,64,47,34,6,7,17
S01011599,662,408,342,20,46,254,256,96,76,4,16,160,175,134,109,9,16,41,65,49,37,3,9,16,73,59,54,1,4,14,93,70,66,3,1,23
S01011600,644,369,311,23,35,275,252,84,65,9,10,168,146,101,79,8,14,45,88,74,69,1,4,14,69,51,45,2,4,18,89,59,53,3,3,30
S01011601,656,522,454,41,27,134,132,71,57,7,7,61,185,155,128,16,11,30,106,89,79,4,6,17,93,84,78,5,1,9,140,123,112,9,2,17
S01011602,495,310,242,21,47,185,210,86,60,6,20,124,122,95,71,9,15,27,52,36,29,1,6,16,37,31,25,3,3,6,74,62,57,2,3,12
S01011603,673,332,265,21,46,341,330,93,73,6,14,237,147,98,72,6,20,49,85,59,47,6,6,26,58,39,32,1,6,19,53,43,41,2,0,10
S01011604,528,317,247,17,53,211,206,81,61,7,13,125,152,102,75,2,25,50,66,54,47,4,3,12,58,49,38,3,8,9,46,31,26,1,4,15
S01011605,715,425,333,41,51,290,312,110,81,13,16,202,161,122,90,12,20,39,98,75,62,4,9,23,66,50,40,4,6,16,78,68,60,8,0,10
S01011606,730,620,558,44,18,110,98,55,38,13,4,43,207,177,156,16,5,30,131,118,106,6,6,13,103,89,85,2,2,14,191,181,173,7,1,10
S01011607,477,366,308,29,29,111,105,60,49,8,3,45,120,94,78,8,8,26,92,74,62,7,5,18,73,67,60,2,5,6,87,71,59,4,8,16
S01011608,741,600,507,61,32,141,142,80,63,14,3,62,212,177,136,26,15,35,126,108,95,6,7,18,116,107,92,10,5,9,145,128,121,5,2,17
S01011609,762,445,331,26,88,317,365,134,89,6,39,231,208,158,118,8,32,50,59,42,34,1,7,17,66,54,42,6,6,12,64,57,48,5,4,7
S01011610,653,406,319,21,66,247,281,110,81,4,25,171,175,133,99,10,24,42,66,58,51,1,6,8,59,53,43,3,7,6,72,52,45,3,4,20
S01011611,587,386,328,29,29,201,169,61,43,11,7,108,167,120,102,8,10,47,83,66,52,6,8,17,59,49,45,1,3,10,109,90,86,3,1,19
S01011612,453,408,350,43,15,45,33,21,14,4,3,12,92,76,54,16,6,16,99,94,80,10,4,5,72,66,57,7,2,6,157,151,145,6,0,6
S01011613,798,512,426,62,24,286,181,68,47,17,4,113,179,122,93,19,10,57,148,108,101,6,1,40,101,78,67,7,4,23,189,136,118,13,5,53
S01011614,379,260,217,22,21,119,119,38,32,4,2,81,89,72,54,9,9,17,60,55,44,4,7,5,45,38,36,1,1,7,66,57,51,4,2,9
S01011615,559,336,265,27,44,223,211,73,55,6,12,138,158,116,91,5,20,42,58,44,32,6,6,14,78,63,54,4,5,15,54,40,33,6,1,14
S01011616,343,182,135,14,33,161,168,52,35,3,14,116,75,53,35,4,14,22,41,31,25,3,3,10,25,20,17,1,2,5,34,26,23,3,0,8
S01011617,711,419,341,27,51,292,359,139,107,11,21,220,180,147,117,8,22,33,72,53,46,3,4,19,44,37,33,2,2,7,56,43,38,3,2,13
S01011618,491,291,247,14,30,200,214,86,71,6,9,128,144,105,86,5,14,39,53,43,37,1,5,10,33,25,23,0,2,8,47,32,30,2,0,15
S01011619,813,638,562,39,37,175,158,85,72,10,3,73,230,191,154,16,21,39,149,125,115,5,5,24,99,80,75,2,3,19,177,157,146,6,5,20
S01011620,806,690,603,63,24,116,98,67,49,15,3,31,219,185,160,17,8,34,132,114,103,9,2,18,134,120,102,11,7,14,223,204,189,11,4,19
S01011621,591,411,350,29,32,180,171,77,63,8,6,94,175,133,114,7,12,42,102,80,67,3,10,22,46,37,34,1,2,9,97,84,72,10,2,13
S01011622,482,392,308,55,29,90,77,42,25,13,4,35,132,111,83,17,11,21,83,74,60,6,8,9,53,50,40,6,4,3,137,115,100,13,2,22
S01011623,563,328,265,33,30,235,221,65,48,6,11,156,161,120,100,9,11,41,64,51,38,10,3,13,50,40,31,6,3,10,67,52,48,2,2,15
S01011624,550,412,340,38,34,138,139,68,48,10,10,71,162,127,103,10,14,35,79,69,58,6,5,10,76,65,57,6,2,11,94,83,74,6,3,11
S01011625,443,299,250,17,32,144,157,78,66,3,9,79,117,82,61,7,14,35,60,53,47,3,3,7,48,43,37,0,6,5,61,43,39,4,0,18
S01011626,634,511,434,51,26,123,80,48,35,9,4,32,168,131,109,14,8,37,135,107,95,9,3,28,91,82,71,6,5,9,160,143,124,13,6,17
S01011627,532,441,395,35,11,91,82,46,35,10,1,36,132,110,92,10,8,22,90,77,70,5,2,13,101,89,85,4,0,12,127,119,113,6,0,8
S01011628,889,593,507,49,37,296,248,90,73,13,4,158,206,154,127,16,11,52,138,108,88,9,11,30,110,87,78,5,4,23,187,154,141,6,7,33
S01011629,490,292,234,18,40,198,223,87,65,5,17,136,132,97,76,6,15,35,43,35,29,1,5,8,51,43,38,3,2,8,41,30,26,3,1,11
S01011630,506,317,252,25,40,189,196,76,58,6,12,120,127,94,68,7,19,33,59,45,38,6,1,14,60,47,40,2,5,13,64,55,48,4,3,9
S01011631,455,270,213,13,44,185,190,89,74,6,9,101,139,94,70,3,21,45,45,33,27,2,4,12,36,23,17,0,6,13,45,31,25,2,4,14
S01011632,580,379,302,31,46,201,250,115,87,12,16,135,174,141,111,8,22,33,48,37,32,4,1,11,52,38,32,4,2,14,56,48,40,3,5,8
S01011633,592,333,262,19,52,259,242,72,63,4,5,170,181,131,88,11,32,50,61,48,38,1,9,13,45,39,32,3,4,6,63,43,41,0,2,20
S01011634,435,243,201,11,31,192,188,66,53,3,10,122,108,74,61,4,9,34,53,42,34,3,5,11,44,35,30,0,5,9,42,26,23,1,2,16
S01011635,523,318,263,19,36,205,194,60,43,5,12,134,150,106,84,8,14,44,66,55,48,3,4,11,52,44,40,1,3,8,61,53,48,2,3,8
S01011636,550,323,263,18,42,227,224,82,61,6,15,142,180,132,105,10,17,48,47,35,32,0,3,12,51,40,37,1,2,11,48,34,28,1,5,14
S01011637,560,345,268,24,53,215,228,97,72,7,18,131,131,91,65,5,21,40,73,51,42,4,5,22,64,52,45,3,4,12,64,54,44,5,5,10
S01011638,429,247,208,15,24,182,176,50,40,5,5,126,100,71,55,3,13,29,55,47,42,3,2,8,29,24,20,2,2,5,69,55,51,2,2,14
S01011639,455,266,221,6,39,189,192,68,49,4,15,124,130,92,77,1,14,38,51,37,34,0,3,14,37,32,26,0,6,5,45,37,35,1,1,8
S01011640,535,329,272,16,41,206,218,100,80,4,16,118,126,81,66,3,12,45,79,61,50,4,7,18,59,45,38,3,4,14,53,42,38,2,2,11
S01011641,406,255,224,25,6,151,104,27,19,6,2,77,89,63,54,7,2,26,59,41,38,2,1,18,50,42,39,2,1,8,104,82,74,8,0,22
S01011642,668,451,364,41,46,217,175,87,63,11,13,88,159,115,89,7,19,44,114,89,75,10,4,25,82,62,53,4,5,20,138,98,84,9,5,40
S01011643,464,326,265,43,18,138,131,49,40,6,3,82,101,79,61,11,7,22,73,63,55,5,3,10,44,32,26,3,3,12,115,103,83,18,2,12
S01011644,602,337,288,31,18,265,208,47,38,6,3,161,139,97,83,10,4,42,78,62,53,5,4,16,59,46,41,3,2,13,118,85,73,7,5,33
S01011645,452,240,207,22,11,212,173,37,28,6,3,136,103,77,68,5,4,26,55,37,33,3,1,18,48,40,33,4,3,8,73,49,45,4,0,24
S01011646,589,376,318,36,22,213,141,51,39,8,4,90,117,77,63,7,7,40,101,69,58,6,5,32,66,48,43,4,1,18,164,131,115,11,5,33
S01011647,701,528,467,32,29,173,118,55,45,4,6,63,166,119,99,14,6,47,133,105,86,6,13,28,94,83,75,6,2,11,190,166,162,2,2,24
S01011648,514,393,334,31,28,121,104,40,33,5,2,64,132,101,77,11,13,31,77,66,54,7,5,11,56,47,44,2,1,9,145,139,126,6,7,6
S01011649,395,255,222,15,18,140,126,41,33,2,6,85,88,64,53,5,6,24,54,44,41,2,1,10,46,38,34,4,0,8,81,68,61,2,5,13
S01011650,583,360,294,40,26,223,153,47,35,6,6,106,112,80,62,9,9,32,74,46,39,4,3,28,74,58,48,6,4,16,170,129,110,15,4,41
S01011651,772,478,409,33,36,294,277,96,73,11,12,181,170,125,102,7,16,45,110,75,70,4,1,35,83,71,62,5,4,12,132,111,102,6,3,21
S01011652,642,452,386,34,32,190,150,68,53,5,10,82,141,103,88,6,9,38,114,88,75,6,7,26,62,50,43,5,2,12,175,143,127,12,4,32
S01011653,719,441,346,28,67,278,292,121,90,13,18,171,184,143,102,8,33,41,106,77,70,1,6,29,65,48,42,4,2,17,72,52,42,2,8,20
S01011654,827,476,350,53,73,351,330,107,60,13,34,223,144,87,61,10,16,57,99,75,58,9,8,24,80,69,55,4,10,11,174,138,116,17,5,36
S01011655,718,421,318,24,79,297,327,118,77,11,30,209,196,153,111,6,36,43,85,66,56,3,7,19,44,34,29,2,3,10,66,50,45,2,3,16
S01011656,492,295,221,12,62,197,214,85,52,4,29,129,153,108,83,4,21,45,48,43,35,1,7,5,39,29,23,3,3,10,38,30,28,0,2,8
S01011657,426,259,188,16,55,167,161,56,33,5,18,105,121,94,63,5,26,27,48,36,31,1,4,12,46,31,23,3,5,15,50,42,38,2,2,8
S01011658,552,345,264,34,47,207,252,93,66,14,13,159,150,128,101,11,16,22,68,54,44,2,8,14,48,41,32,5,4,7,34,29,21,2,6,5
S01011659,660,375,294,27,54,285,281,93,75,5,13,188,170,125,94,7,24,45,71,55,43,5,7,16,56,40,34,2,4,16,82,62,48,8,6,20
S01011660,790,519,443,41,35,271,245,104,87,9,8,141,172,124,101,11,12,48,147,110,100,5,5,37,88,71,64,4,3,17,138,110,91,12,7,28
S01011661,434,267,210,27,30,167,199,83,65,8,10,116,106,83,61,12,10,23,52,38,33,3,2,14,33,27,23,1,3,6,44,36,28,3,5,8
S01011662,487,382,335,35,12,105,96,44,28,15,1,52,134,108,97,7,4,26,82,72,60,7,5,10,59,54,51,2,1,5,116,104,99,4,1,12
S01011663,753,508,379,26,103,245,275,124,91,5,28,151,221,168,114,11,43,53,76,59,44,2,13,17,68,57,45,3,9,11,113,100,85,5,10,13
S01011664,834,438,348,32,58,396,437,150,113,16,21,287,201,140,115,5,20,61,66,46,39,4,3,20,54,45,32,4,9,9,76,57,49,3,5,19
S01011665,718,399,336,20,43,319,301,106,80,9,17,195,153,89,75,4,10,64,71,52,45,3,4,19,74,56,49,2,5,18,119,96,87,2,7,23
S01011666,736,389,297,19,73,347,359,121,86,7,28,238,158,110,82,7,21,48,81,60,43,2,15,21,52,38,30,2,6,14,86,60,56,1,3,26
S01011667,681,364,289,39,36,317,311,82,63,14,5,229,147,101,73,10,18,46,84,61,49,7,5,23,44,38,35,1,2,6,95,82,69,7,6,13
S01011668,782,481,392,14,75,301,351,167,135,1,31,184,224,155,121,6,28,69,59,46,37,3,6,13,62,45,39,4,2,17,86,68,60,0,8,18
S01011669,560,314,245,42,27,246,166,48,36,9,3,118,112,76,59,8,9,36,76,53,41,4,8,23,51,32,27,2,3,19,155,105,82,19,4,50
S01011670,406,276,222,18,36,130,156,78,62,8,8,78,134,99,74,4,21,35,31,28,22,2,4,3,39,32,28,2,2,7,46,39,36,2,1,7
S01011671,589,337,273,39,25,252,200,58,44,9,5,142,132,89,70,11,8,43,70,49,39,7,3,21,65,47,41,3,3,18,122,94,79,9,6,28
S01011672,498,275,216,19,40,223,182,60,40,6,14,122,120,80,57,6,17,40,60,36,29,3,4,24,48,37,32,2,3,11,88,62,58,2,2,26
S01011673,537,333,271,27,35,204,237,103,84,8,11,134,123,88,72,2,14,35,65,51,39,7,5,14,41,37,31,2,4,4,71,54,45,8,1,17
S01011674,825,550,473,25,52,275,266,88,69,7,12,178,222,178,144,11,23,44,94,80,75,1,4,14,97,75,66,3,6,22,146,129,119,3,7,17
S01011675,750,439,358,31,50,311,354,135,106,8,21,219,175,125,101,8,16,50,84,71,55,6,10,13,63,53,46,4,3,10,74,55,50,5,0,19
S01011676,567,328,257,16,55,239,257,96,68,4,24,161,147,113,87,5,21,34,61,41,33,3,5,20,56,40,35,2,3,16,46,38,34,2,2,8
S01011677,463,354,275,31,48,109,106,53,33,8,12,53,136,116,86,7,23,20,64,55,41,7,7,9,65,48,40,5,3,17,92,82,75,4,3,10
S01011678,380,203,148,20,35,177,182,71,46,9,16,111,92,58,39,7,12,34,37,23,19,0,4,14,22,15,12,1,2,7,47,36,32,3,1,11
S01011679,417,338,300,24,14,79,71,41,34,5,2,30,122,96,82,7,7,26,75,65,61,2,2,10,57,52,47,4,1,5,92,84,76,6,2,8
S01011680,864,479,379,36,64,385,391,130,98,8,24,261,246,177,139,8,30,69,66,50,37,8,5,16,85,65,55,6,4,20,76,57,50,6,1,19
S01011681,667,427,361,32,34,240,276,122,100,10,12,154,158,125,103,7,15,33,71,52,46,3,3,19,61,47,41,4,2,14,101,81,71,8,2,20
S01011682,429,238,165,58,15,191,174,52,32,14,6,122,91,59,37,17,5,32,45,38,28,9,1,7,45,34,24,9,1,11,74,55,44,9,2,19
S01011683,613,406,303,56,47,207,230,100,71,12,17,130,150,111,80,16,15,39,97,77,63,7,7,20,60,55,45,5,5,5,76,63,44,16,3,13
S01011684,437,261,212,29,20,176,176,62,46,10,6,114,105,76,69,3,4,29,48,39,34,3,2,9,43,34,25,4,5,9,65,50,38,9,3,15
S01011685,602,497,410,63,24,105,118,70,46,19,5,48,157,128,99,16,13,29,112,97,81,13,3,15,80,73,63,8,2,7,135,129,121,7,1,6
S01011686,703,495,422,54,19,208,140,55,44,11,0,85,180,142,116,17,9,38,120,90,78,8,4,30,78,66,55,9,2,12,185,142,129,9,4,43
S01011687,702,432,354,29,49,270,266,95,69,8,18,171,189,137,117,5,15,52,90,69,53,5,11,21,65,55,48,5,2,10,92,76,67,6,3,16
S01011688,631,453,352,73,28,178,156,64,46,15,3,92,168,128,92,22,14,40,97,82,62,13,7,15,80,70,57,12,1,10,130,109,95,11,3,21
S01011689,538,395,317,59,19,143,121,51,25,22,4,70,124,94,72,13,9,30,94,74,62,9,3,20,59,53,44,8,1,6,140,123,114,7,2,17
S01011690,747,562,452,71,39,185,185,90,62,16,12,95,195,157,123,22,12,38,122,104,82,13,9,18,89,71,60,6,5,18,156,140,125,14,1,16
S01011691,456,331,287,28,16,125,102,46,42,4,0,56,128,100,85,8,7,28,84,66,53,6,7,18,48,39,34,4,1,9,94,80,73,6,1,14
S01011692,860,499,418,25,56,361,374,130,117,2,11,244,211,163,122,14,27,48,113,85,73,5,7,28,84,68,60,1,7,16,78,53,46,3,4,25
S01011693,664,472,398,45,29,192,170,68,51,9,8,102,134,101,79,11,11,33,95,86,75,8,3,9,76,60,49,6,5,16,189,157,144,11,2,32
S01011694,383,318,271,29,18,65,72,35,22,4,9,37,91,78,65,10,3,13,54,49,46,3,0,5,49,47,37,7,3,2,117,109,101,5,3,8
S01011695,689,545,458,71,16,144,137,76,54,19,3,61,162,135,108,19,8,27,100,81,74,7,0,19,98,86,75,9,2,12,192,167,147,17,3,25
S01011696,728,624,527,80,17,104,66,45,30,13,2,21,147,114,91,18,5,33,105,91,81,9,1,14,95,80,67,10,3,15,315,294,258,30,6,21
S01011697,757,568,479,59,30,189,158,61,47,10,4,97,169,129,107,12,10,40,113,97,79,10,8,16,102,90,71,15,4,12,215,191,175,12,4,24
S01011698,537,340,273,30,37,197,206,75,50,11,14,131,136,102,78,10,14,34,74,60,53,2,5,14,52,44,39,1,4,8,69,59,53,6,0,10
S01011699,764,508,425,57,26,256,208,91,65,21,5,117,173,118,96,12,10,55,136,109,94,7,8,27,76,56,48,6,2,20,171,134,122,11,1,37
S01011700,661,385,319,36,30,276,218,67,51,13,3,151,131,86,66,10,10,45,111,83,70,6,7,28,79,57,50,4,3,22,122,92,82,3,7,30
S01011701,822,570,466,84,20,252,157,55,39,13,3,102,171,111,91,17,3,60,131,104,87,13,4,27,98,85,69,10,6,13,265,215,180,31,4,50
S01011702,626,368,298,44,26,258,184,62,47,9,6,122,131,78,61,11,6,53,80,52,42,5,5,28,67,55,42,7,6,12,164,121,106,12,3,43
S01011703,502,346,259,65,22,156,109,43,25,16,2,66,82,61,41,11,9,21,76,61,46,11,4,15,52,39,28,9,2,13,183,142,119,18,5,41
S01011704,555,414,358,42,14,141,97,37,30,5,2,60,122,95,80,9,6,27,83,66,59,3,4,17,71,58,49,7,2,13,182,158,140,18,0,24
S01011705,602,390,305,40,45,212,182,67,45,9,13,115,177,128,98,11,19,49,74,54,41,6,7,20,52,46,38,5,3,6,117,95,83,9,3,22
S01011706,883,508,417,50,41,375,328,99,75,13,11,229,164,112,82,13,17,52,135,104,87,11,6,31,84,62,54,3,5,22,172,131,119,10,2,41
S01011707,584,369,305,43,21,215,127,47,39,7,1,80,128,92,67,17,8,36,96,61,54,4,3,35,76,56,47,5,4,20,157,113,98,10,5,44
S01011708,797,464,380,37,47,333,291,105,85,12,8,186,171,112,87,7,18,59,120,88,69,6,13,32,81,64,52,7,5,17,134,95,87,5,3,39
S01011709,782,498,401,55,42,284,244,92,66,19,7,152,203,140,103,18,19,63,102,80,71,4,5,22,88,72,62,4,6,16,145,114,99,10,5,31
S01011710,477,320,245,18,57,157,191,86,67,3,16,105,161,124,92,5,27,37,51,44,33,7,4,7,39,35,26,2,7,4,35,31,27,1,3,4
S01011711,551,309,246,21,42,242,222,65,50,4,11,157,184,136,102,12,22,48,52,41,34,1,6,11,46,36,33,2,1,10,47,31,27,2,2,16
S01011712,461,314,264,17,33,147,153,63,44,6,13,90,122,95,73,8,14,27,63,56,54,1,1,7,39,30,28,0,2,9,84,70,65,2,3,14
S01011713,759,483,413,44,26,276,280,112,86,17,9,168,170,121,103,10,8,49,120,99,87,6,6,21,68,53,46,4,3,15,121,98,91,7,0,23
S01011714,396,349,296,36,17,47,64,45,34,10,1,19,106,96,83,6,7,10,75,65,53,7,5,10,56,51,43,7,1,5,95,92,83,6,3,3
S01011715,493,286,245,15,26,207,197,66,53,7,6,131,138,97,79,5,13,41,56,45,42,2,1,11,53,38,32,0,6,15,49,40,39,1,0,9
S01011716,701,550,459,55,36,151,124,57,40,9,8,67,201,172,134,23,15,29,127,104,92,8,4,23,82,72,64,3,5,10,167,145,129,12,4,22
S01011717,615,408,346,38,24,207,180,70,56,12,2,110,155,119,100,13,6,36,90,69,58,5,6,21,70,52,44,2,6,18,120,98,88,6,4,22
S01011718,577,495,420,54,21,82,75,42,29,12,1,33,134,114,86,17,11,20,104,88,68,13,7,16,77,73,65,8,0,4,187,178,172,4,2,9
S01011719,529,444,381,50,13,85,68,46,35,11,0,22,136,112,89,17,6,24,105,87,82,2,3,18,71,61,52,7,2,10,149,138,123,13,2,11
S01011720,465,309,269,30,10,156,95,31,25,5,1,64,106,74,61,9,4,32,83,65,53,8,4,18,70,56,51,5,0,14,111,83,79,3,1,28
S01011721,586,357,307,17,33,229,228,84,70,4,10,144,148,110,87,7,16,38,80,60,52,4,4,20,59,53,50,1,2,6,71,50,48,1,1,21
S01011722,589,327,262,27,38,262,217,69,55,5,9,148,153,93,72,8,13,60,79,65,47,10,8,14,55,40,33,0,7,15,85,60,55,4,1,25
S01011723,767,487,411,41,35,280,258,107,82,13,12,151,197,134,107,10,17,63,114,90,81,7,2,24,69,53,47,4,2,16,129,103,94,7,2,26
S01011724,525,422,355,39,28,103,79,46,37,5,4,33,159,120,93,12,15,39,93,82,71,6,5,11,78,68,61,5,2,10,116,106,93,11,2,10
S01011725,498,419,355,49,15,79,60,37,27,9,1,23,129,106,85,14,7,23,118,102,89,10,3,16,78,71,60,8,3,7,113,103,94,8,1,10
S01011726,424,338,297,31,10,86,69,32,27,4,1,37,105,85,75,8,2,20,74,61,54,4,3,13,72,64,57,6,1,8,104,96,84,9,3,8
S01011727,558,472,382,74,16,86,59,31,19,11,1,28,126,104,77,18,9,22,104,87,74,11,2,17,77,71,60,9,2,6,192,179,152,25,2,13
S01011728,767,522,446,49,27,245,231,84,58,19,7,147,220,172,143,17,12,48,116,97,87,6,4,19,92,78,72,4,2,14,108,91,86,3,2,17
S01011729,562,335,261,24,50,227,208,79,51,12,16,129,146,106,83,7,16,40,71,44,31,2,11,27,59,45,37,1,7,14,78,61,59,2,0,17
S01011730,782,478,410,50,18,304,237,82,64,15,3,155,173,112,95,9,8,61,118,91,78,10,3,27,88,71,62,7,2,17,166,122,111,9,2,44
S01011731,720,442,369,36,37,278,273,96,76,15,5,177,164,129,108,10,11,35,106,86,71,3,12,20,84,52,43,4,5,32,93,79,71,4,4,14
S01011732,680,476,406,49,21,204,118,49,38,9,2,69,165,118,97,13,8,47,124,101,82,11,8,23,82,65,58,5,2,17,191,143,131,11,1,48
S01011733,705,445,370,39,36,260,215,86,59,12,15,129,196,125,105,10,10,71,97,73,65,4,4,24,79,69,63,3,3,10,118,92,78,10,4,26
S01011734,646,406,340,42,24,240,175,60,47,10,3,115,139,94,75,8,11,45,116,83,70,7,6,33,71,60,51,8,1,11,145,109,97,9,3,36
S01011735,621,380,310,49,21,241,108,37,23,13,1,71,158,103,77,17,9,55,112,73,62,7,4,39,76,57,50,4,3,19,167,110,98,8,4,57
S01011736,578,406,341,28,37,172,130,51,39,6,6,79,194,147,119,10,18,47,81,65,52,7,6,16,75,58,53,2,3,17,98,85,78,3,4,13
S01011737,552,333,257,27,49,219,169,57,41,10,6,112,154,108,78,7,23,46,81,63,52,4,7,18,56,40,30,2,8,16,92,65,56,4,5,27
S01011738,851,547,427,55,65,304,238,82,59,12,11,156,222,159,117,18,24,63,133,95,74,8,13,38,95,81,61,7,13,14,163,130,116,10,4,33
S01011739,430,279,225,13,41,151,158,68,56,1,11,90,124,99,74,7,18,25,59,45,39,0,6,14,37,31,21,5,5,6,52,36,35,0,1,16
S01011740,602,349,266,17,66,253,198,62,44,2,16,136,184,124,86,5,33,60,72,52,40,2,10,20,65,53,46,5,2,12,83,58,50,3,5,25
S01011741,536,338,277,17,44,198,175,68,53,3,12,107,163,120,94,6,20,43,79,60,54,3,3,19,68,49,42,1,6,19,51,41,34,4,3,10
S01011742,614,385,319,28,38,229,185,79,64,3,12,106,181,125,94,12,19,56,82,58,51,3,4,24,72,52,44,6,2,20,94,71,66,4,1,23
S01011743,657,423,373,24,26,234,162,51,43,3,5,111,203,134,114,12,8,69,99,82,73,3,6,17,79,63,55,3,5,16,114,93,88,3,2,21
S01011744,715,406,332,32,42,309,243,73,63,3,7,170,191,127,98,8,21,64,102,78,61,8,9,24,80,61,53,4,4,19,99,67,57,9,1,32
S01011745,633,301,252,18,31,332,295,55,44,4,7,240,137,99,82,2,15,38,69,50,42,5,3,19,55,44,40,2,2,11,77,53,44,5,4,24
S01011746,412,273,217,13,43,139,147,72,52,3,17,75,134,100,80,4,16,34,75,59,49,2,8,16,24,20,17,1,2,4,32,22,19,3,0,10
S01011747,754,466,351,23,92,288,274,118,78,7,33,156,231,158,120,4,34,73,101,80,58,4,18,21,76,57,52,1,4,19,72,53,43,7,3,19
S01011748,647,422,352,19,51,225,201,88,74,3,11,113,200,150,115,7,28,50,92,64,56,3,5,28,84,67,61,3,3,17,70,53,46,3,4,17
S01011749,560,372,279,17,76,188,158,77,48,2,27,81,198,143,101,10,32,55,78,59,53,2,4,19,59,34,28,1,5,25,67,59,49,2,8,8
S01011750,709,417,339,34,44,292,232,70,58,6,6,162,203,141,110,13,18,62,97,71,55,6,10,26,85,63,55,4,4,22,92,72,61,5,6,20
S01011751,780,533,431,23,79,247,215,110,85,8,17,105,259,185,145,8,32,74,108,80,65,4,11,28,98,83,70,1,12,15,100,75,66,2,7,25
S01011752,750,532,455,31,46,218,199,78,64,3,11,121,205,162,137,8,17,43,129,107,89,8,10,22,98,89,77,7,5,9,119,96,88,5,3,23
S01011753,660,413,340,32,41,247,114,53,32,9,12,61,158,111,89,9,13,47,96,63,52,5,6,33,82,64,58,4,2,18,210,122,109,5,8,88
S01011754,619,369,306,24,39,250,192,65,48,7,10,127,146,107,93,4,10,39,107,77,65,4,8,30,86,64,55,5,4,22,88,56,45,4,7,32
S01011755,761,531,450,33,48,230,161,79,67,8,4,82,232,165,136,12,17,67,139,105,88,5,12,34,118,99,83,5,11,19,111,83,76,3,4,28
S01011756,783,527,437,30,60,256,187,76,58,4,14,111,234,171,135,9,27,63,145,107,93,6,8,38,112,86,76,3,7,26,105,87,75,8,4,18
S01011757,573,343,291,24,28,230,187,66,50,7,9,121,163,107,93,6,8,56,95,80,72,4,4,15,72,52,39,6,7,20,56,38,37,1,0,18
S01011758,498,343,294,19,30,155,143,68,62,4,2,75,153,120,98,7,15,33,74,57,54,0,3,17,57,46,37,2,7,11,71,52,43,6,3,19
S01011759,670,404,342,27,35,266,243,78,62,5,11,165,175,123,105,9,9,52,96,78,69,3,6,18,86,68,55,6,7,18,70,57,51,4,2,13
S01011760,729,474,397,31,46,255,196,69,59,8,2,127,224,159,124,11,24,65,113,91,78,5,8,22,97,76,67,4,5,21,99,79,69,3,7,20
S01011761,507,348,292,26,30,159,123,64,49,3,12,59,147,95,79,7,9,52,79,63,53,8,2,16,64,47,43,1,3,17,94,79,68,7,4,15
S01011762,532,332,273,24,35,200,145,58,45,4,9,87,176,122,91,11,20,54,86,52,47,2,3,34,60,52,48,3,1,8,65,48,42,4,2,17
S01011763,653,415,354,33,28,238,196,64,52,7,5,132,201,147,129,9,9,54,79,62,53,5,4,17,86,73,60,7,6,13,91,69,60,5,4,22
S01011764,332,225,194,14,17,107,82,30,25,1,4,52,113,83,71,5,7,30,58,49,43,2,4,9,40,33,28,3,2,7,39,30,27,3,0,9
S01011765,818,632,543,54,35,186,116,64,53,10,1,52,222,168,136,20,12,54,176,142,116,11,15,34,101,88,84,2,2,13,203,170,154,11,5,33
S01011766,416,293,248,35,10,123,98,50,38,10,2,48,106,82,67,12,3,24,63,49,44,3,2,14,61,49,41,6,2,12,88,63,58,4,1,25
S01011767,744,446,350,41,55,298,261,84,61,14,9,177,200,143,109,8,26,57,98,65,50,7,8,33,74,63,49,7,7,11,111,91,81,5,5,20
S01011768,591,378,316,18,44,213,184,61,35,5,21,123,179,139,121,3,15,40,59,45,37,6,2,14,85,67,61,1,5,18,84,66,62,3,1,18
S01011769,554,294,240,28,26,260,201,56,47,5,4,145,166,106,84,10,12,60,58,45,36,3,6,13,55,41,34,6,1,14,74,46,39,4,3,28
S01011770,680,414,332,25,57,266,219,69,51,4,14,150,189,148,121,6,21,41,88,61,45,5,11,27,71,58,48,3,7,13,113,78,67,7,4,35
S01011771,531,418,358,43,17,113,71,33,21,10,2,38,134,109,87,16,6,25,107,87,77,4,6,20,70,59,51,8,0,11,149,130,122,5,3,19
S01011772,886,620,481,108,31,266,149,60,33,22,5,89,152,110,83,19,8,42,171,121,94,19,8,50,117,90,76,9,5,27,297,239,195,39,5,58
S01011773,447,383,336,35,12,64,41,18,12,6,0,23,113,93,79,12,2,20,98,88,84,3,1,10,57,54,48,3,3,3,138,130,113,11,6,8
S01011774,692,525,435,57,33,167,104,46,31,11,4,58,180,134,108,11,15,46,124,101,80,11,10,23,99,78,69,6,3,21,185,166,147,18,1,19
S01011775,480,401,337,48,16,79,46,19,16,3,0,27,119,104,83,16,5,15,97,74,59,6,9,23,55,52,45,6,1,3,163,152,134,17,1,11
S01011776,789,613,502,87,24,176,129,47,34,11,2,82,160,124,99,21,4,36,125,102,75,20,7,23,84,75,63,7,5,9,291,265,231,28,6,26
S01011777,477,361,317,32,12,116,76,32,27,3,2,44,95,69,61,7,1,26,74,62,54,5,3,12,66,59,52,6,1,7,166,139,123,11,5,27
S01011778,493,382,322,42,18,111,68,23,13,8,2,45,97,70,58,9,3,27,117,95,79,10,6,22,68,61,47,8,6,7,143,133,125,7,1,10
S01011779,640,438,374,44,20,202,123,37,24,10,3,86,134,98,79,13,6,36,96,71,60,7,4,25,94,74,68,4,2,20,193,158,143,10,5,35
S01011780,728,539,440,82,17,189,126,59,44,13,2,67,130,90,75,13,2,40,134,109,87,18,4,25,91,73,60,8,5,18,247,208,174,30,4,39
S01011781,459,323,276,33,14,136,78,26,21,5,0,52,120,83,60,12,11,37,87,61,56,3,2,26,59,52,50,1,1,7,115,101,89,12,0,14
S01011782,582,397,337,45,15,185,106,43,36,5,2,63,125,93,71,15,7,32,97,75,64,9,2,22,81,64,57,6,1,17,173,122,109,10,3,51
S01011783,486,341,282,40,19,145,91,28,20,6,2,63,109,82,67,7,8,27,88,67,59,6,2,21,54,47,38,6,3,7,144,117,98,15,4,27
S01011784,660,415,352,29,34,245,218,87,74,9,4,131,180,117,96,5,16,63,103,76,66,5,5,27,78,64,55,5,4,14,81,71,61,5,5,10
S01011785,711,452,383,41,28,259,236,87,73,6,8,149,168,119,98,10,11,49,110,92,80,8,4,18,90,71,62,7,2,19,107,83,70,10,3,24
S01011786,296,241,203,27,11,55,38,19,16,1,2,19,66,47,33,9,5,19,49,41,34,5,2,8,37,32,27,3,2,5,106,102,93,9,0,4
S01011787,822,477,350,45,82,345,333,114,78,13,23,219,214,151,100,17,34,63,109,76,56,11,9,33,80,62,48,4,10,18,86,74,68,0,6,12
S01011788,513,379,263,98,18,134,54,30,19,9,2,24,92,60,36,20,4,32,82,55,36,17,2,27,57,48,27,17,4,9,228,186,145,35,6,42
S01011789,550,335,260,59,16,215,158,58,42,15,1,100,134,90,73,11,6,44,78,53,39,9,5,25,56,46,39,6,1,10,124,88,67,18,3,36
S01011790,778,500,372,74,54,278,233,92,64,15,13,141,243,171,120,27,24,72,96,75,58,12,5,21,80,62,44,10,8,18,126,100,86,10,4,26
S01011791,610,351,285,36,30,259,219,57,48,7,2,162,174,123,98,13,12,51,77,62,50,4,8,15,62,50,39,7,4,12,78,59,50,5,4,19
S01011792,784,389,313,44,32,395,314,63,45,9,9,251,176,115,94,12,9,61,67,44,37,2,5,23,71,53,42,7,4,18,156,114,95,14,5,42
S01011793,611,358,287,49,22,253,178,44,30,10,4,134,148,92,75,10,7,56,73,59,48,5,6,14,62,53,41,11,1,9,150,110,93,13,4,40
S01011794,709,418,341,41,36,291,228,76,54,11,11,152,249,162,132,18,12,87,80,70,57,6,7,10,64,48,42,3,3,16,88,62,56,3,3,26
S01011795,515,301,241,29,31,214,195,76,60,5,11,119,148,98,74,11,13,50,58,44,36,5,3,14,50,37,30,4,3,13,64,46,41,4,1,18
S01011796,599,375,293,28,54,224,213,80,52,9,19,133,176,126,96,6,24,50,70,56,50,3,3,14,58,46,39,1,6,12,82,67,56,9,2,15
S01011797,865,602,507,70,25,263,160,66,47,14,5,94,225,165,138,17,10,60,180,132,110,16,6,48,106,86,75,10,1,20,194,153,137,13,3,41
S01011798,453,269,214,27,28,184,165,48,37,6,5,117,134,97,68,13,16,37,53,45,39,2,4,8,42,33,26,4,3,9,59,46,44,2,0,13
S01011799,757,473,398,46,29,284,198,83,68,7,8,115,217,137,107,22,8,80,102,77,68,2,7,25,86,64,56,6,2,22,154,112,99,9,4,42
S01011800,425,268,226,28,14,157,152,55,45,7,3,97,135,100,84,11,5,35,52,44,37,5,2,8,40,33,30,2,1,7,46,36,30,3,3,10
S01011801,456,273,214,13,46,183,147,49,38,4,7,98,145,105,72,5,28,40,57,37,32,1,4,20,49,38,34,1,3,11,58,44,38,2,4,14
S01011802,582,330,260,30,40,252,222,67,49,9,9,155,170,120,90,9,21,50,79,57,48,5,4,22,50,37,31,3,3,13,61,49,42,4,3,12
S01011803,465,298,231,30,37,167,169,88,68,9,11,81,125,84,63,8,13,41,51,39,32,2,5,12,49,33,24,5,4,16,71,54,44,6,4,17
S01011804,631,399,316,66,17,232,207,81,65,10,6,126,120,90,76,10,4,30,77,64,57,5,2,13,49,45,32,12,1,4,178,119,86,29,4,59
S01011805,469,297,216,66,15,172,109,31,24,4,3,78,82,59,39,12,8,23,64,51,38,10,3,13,42,34,30,4,0,8,172,122,85,36,1,50
S01011806,627,389,309,68,12,238,169,63,42,17,4,106,128,93,73,17,3,35,105,77,68,7,2,28,54,44,37,7,0,10,171,112,89,20,3,59
S01011807,914,628,424,195,9,286,255,125,48,76,1,130,206,156,110,42,4,50,120,103,68,33,2,17,47,44,35,9,0,3,286,200,163,35,2,86
S01011808,521,352,286,50,16,169,134,42,29,10,3,92,122,93,74,12,7,29,93,76,64,8,4,17,32,31,25,6,0,1,140,110,94,14,2,30
S01011809,595,416,313,97,6,179,148,69,41,26,2,79,123,95,78,15,2,28,86,67,47,20,0,19,41,33,25,8,0,8,197,152,122,28,2,45
S01011810,785,520,382,118,20,265,241,111,65,42,4,130,176,127,95,28,4,49,108,89,64,21,4,19,65,55,44,7,4,10,195,138,114,20,4,57
S01011811,851,576,404,154,18,275,224,80,33,46,1,144,189,150,105,40,5,39,136,117,91,23,3,19,76,66,54,11,1,10,226,163,121,34,8,63
S01011812,545,365,247,108,10,180,113,48,19,28,1,65,123,90,62,26,2,33,74,57,45,11,1,17,40,31,24,7,0,9,195,139,97,36,6,56
S01011813,625,444,332,98,14,181,158,57,34,23,0,101,152,127,99,23,5,25,106,90,69,17,4,16,61,55,40,14,1,6,148,115,90,21,4,33
S01011814,575,419,302,105,12,156,137,56,26,29,1,81,118,95,70,20,5,23,79,69,52,17,0,10,56,46,36,7,3,10,185,153,118,32,3,32
S01011815,614,459,365,79,15,155,134,67,31,33,3,67,147,122,101,13,8,25,99,89,76,12,1,10,62,55,50,4,1,7,172,126,107,17,2,46
S01011816,530,361,293,62,6,169,110,41,26,13,2,69,99,73,57,14,2,26,92,75,61,12,2,17,55,45,40,5,0,10,174,127,109,18,0,47
S01011817,592,442,345,85,12,150,133,53,35,17,1,80,152,118,90,23,5,34,109,103,82,19,2,6,47,45,40,4,1,2,151,123,98,22,3,28
S01011818,894,626,547,62,17,268,234,85,69,14,2,149,240,201,169,23,9,39,148,124,112,11,1,24,72,58,54,1,3,14,200,158,143,13,2,42
S01011819,729,486,424,42,20,243,257,88,74,8,6,169,181,147,128,11,8,34,115,104,89,11,4,11,53,46,43,2,1,7,123,101,90,10,1,22
S01011820,640,390,320,55,15,250,186,36,25,9,2,150,137,98,76,14,8,39,99,86,77,7,2,13,52,44,40,3,1,8,166,126,102,22,2,40
S01011821,354,242,200,20,22,112,85,26,18,4,4,59,110,89,69,7,13,21,57,49,45,2,2,8,28,24,21,1,2,4,74,54,47,6,1,20
S01011822,615,430,353,51,26,185,176,72,52,14,6,104,153,126,101,15,10,27,95,81,67,9,5,14,54,49,42,5,2,5,137,102,91,8,3,35
S01011823,506,335,291,35,9,171,148,44,34,8,2,104,112,90,80,7,3,22,85,70,58,10,2,15,46,39,36,1,2,7,115,92,83,9,0,23
S01011824,553,404,344,36,24,149,165,77,59,9,9,88,180,150,127,13,10,30,83,72,67,4,1,11,43,40,34,4,2,3,82,65,57,6,2,17
S01011825,462,294,248,37,9,168,139,46,38,7,1,93,105,77,65,8,4,28,70,54,44,10,0,16,44,37,32,5,0,7,104,80,69,7,4,24
S01011826,550,388,328,44,16,162,118,35,30,5,0,83,122,98,77,13,8,24,90,70,55,12,3,20,62,55,47,6,2,7,158,130,119,8,3,28
S01011827,472,238,155,68,15,234,182,53,25,24,4,129,73,46,33,9,4,27,51,34,28,5,1,17,38,32,19,12,1,6,128,73,50,18,5,55
S01011828,764,507,327,162,18,257,220,92,46,42,4,128,161,117,79,35,3,44,105,85,56,24,5,20,68,60,41,15,4,8,210,153,105,46,2,57
S01011829,357,251,184,60,7,106,100,47,32,14,1,53,63,47,34,11,2,16,47,38,29,7,2,9,38,32,24,6,2,6,109,87,65,22,0,22
S01011830,480,305,159,130,16,175,148,60,17,40,3,88,95,64,37,23,4,31,53,43,17,20,6,10,37,29,21,7,1,8,147,109,67,40,2,38
S01011831,754,422,226,173,23,332,280,110,49,54,7,170,154,108,54,47,7,46,78,56,30,23,3,22,41,29,20,9,0,12,201,119,73,40,6,82
S01011832,719,458,274,175,9,261,287,126,47,77,2,161,159,130,95,31,4,29,81,68,45,22,1,13,32,26,17,8,1,6,160,108,70,37,1,52
S01011833,805,493,364,103,26,312,126,29,21,6,2,97,127,77,46,22,9,50,133,85,64,20,1,48,88,63,52,10,1,25,331,239,181,45,13,92
S01011834,376,261,206,48,7,115,50,18,11,5,2,32,56,31,28,2,1,25,44,32,22,7,3,12,30,21,15,5,1,9,196,159,130,29,0,37
S01011835,549,403,297,85,21,146,71,25,14,9,2,46,101,66,39,21,6,35,70,52,38,12,2,18,55,47,29,14,4,8,252,213,177,29,7,39
S01011836,661,400,301,79,20,261,116,37,21,14,2,79,115,73,57,10,6,42,94,60,49,10,1,34,57,45,33,9,3,12,279,185,141,36,8,94
S01011837,566,339,247,82,10,227,96,28,19,7,2,68,100,52,35,15,2,48,82,59,39,17,3,23,59,43,33,9,1,16,229,157,121,34,2,72
S01011838,693,429,349,65,15,264,89,18,15,3,0,71,117,65,47,13,5,52,98,72,62,9,1,26,78,51,44,4,3,27,311,223,181,36,6,88
S01011839,825,519,431,67,21,306,137,37,29,8,0,100,174,110,79,21,10,64,135,105,90,11,4,30,89,65,54,10,1,24,290,202,179,17,6,88
S01011840,788,548,446,72,30,240,161,69,57,8,4,92,177,122,99,16,7,55,112,93,71,13,9,19,92,75,65,5,5,17,246,189,154,30,5,57
S01011841,745,483,384,69,30,262,176,66,51,7,8,110,171,107,82,17,8,64,69,55,39,12,4,14,81,64,51,10,3,17,248,191,161,23,7,57
S01011842,791,490,403,45,42,301,274,119,94,9,16,155,173,119,98,10,11,54,88,63,53,7,3,25,68,55,47,4,4,13,188,134,111,15,8,54
S01011843,812,539,336,180,23,273,138,58,22,34,2,80,166,112,66,39,7,54,99,62,43,14,5,37,69,51,38,11,2,18,340,256,167,82,7,84
S01011844,611,361,274,77,10,250,94,23,15,7,1,71,79,47,35,6,6,32,90,54,42,10,2,36,69,51,44,6,1,18,279,186,138,48,0,93
S01011845,674,438,351,64,23,236,160,50,39,7,4,110,135,103,79,14,10,32,107,79,62,13,4,28,72,63,52,8,3,9,200,143,119,22,2,57
S01011846,724,480,365,99,16,244,123,52,39,12,1,71,121,79,55,17,7,42,102,76,57,15,4,26,75,60,50,10,0,15,303,213,164,45,4,90
S01011847,343,229,162,63,4,114,41,20,11,9,0,21,57,38,26,12,0,19,54,36,28,7,1,18,25,20,16,4,0,5,166,115,81,31,3,51
S01011848,588,399,286,103,10,189,103,46,28,14,4,57,117,86,63,20,3,31,81,60,45,14,1,21,49,37,26,10,1,12,238,170,124,45,1,68
S01011849,650,468,376,73,19,182,148,67,51,10,6,81,139,115,99,12,4,24,92,76,57,16,3,16,63,53,41,11,1,10,208,157,128,24,5,51
S01011850,583,381,277,90,14,202,79,31,20,10,1,48,108,80,55,19,6,28,105,70,50,19,1,35,52,42,31,11,0,10,239,158,121,31,6,81
S01011851,735,484,345,101,38,251,158,69,49,9,11,89,172,117,85,26,6,55,111,93,65,17,11,18,65,48,32,14,2,17,229,157,114,35,8,72
S01011852,847,519,404,86,29,328,230,67,45,13,9,163,211,150,117,24,9,61,120,96,71,19,6,24,75,55,44,10,1,20,211,151,127,20,4,60
S01011853,571,407,318,62,27,164,91,40,21,11,8,51,142,104,84,15,5,38,89,73,56,11,6,16,69,54,47,5,2,15,180,136,110,20,6,44
S01011854,712,397,320,62,15,315,174,50,39,10,1,124,127,88,69,12,7,39,99,69,58,7,4,30,66,46,39,6,1,20,246,144,115,27,2,102
S01011855,706,442,371,50,21,264,226,82,68,10,4,144,180,133,111,12,10,47,111,81,69,8,4,30,54,39,32,5,2,15,135,107,91,15,1,28
S01011856,597,298,210,75,13,299,75,16,5,11,0,59,100,47,36,9,2,53,101,57,41,10,6,44,55,40,28,10,2,15,266,138,100,35,3,128
S01011857,572,361,250,101,10,211,129,49,34,13,2,80,123,82,52,26,4,41,83,56,45,10,1,27,49,39,27,12,0,10,188,135,92,40,3,53
S01011858,753,351,247,93,11,402,127,35,29,5,1,92,131,68,51,14,3,63,102,58,40,14,4,44,70,50,42,8,0,20,323,140,85,52,3,183
S01011859,752,340,251,73,16,412,218,44,31,8,5,174,177,103,81,18,4,74,72,44,38,4,2,28,58,41,31,9,1,17,227,108,70,34,4,119
S01011860,529,417,315,81,21,112,75,40,29,8,3,35,112,87,73,9,5,25,87,74,62,12,0,13,53,47,31,14,2,6,202,169,120,38,11,33
S01011861,636,397,259,120,18,239,123,49,27,21,1,74,137,96,69,24,3,41,83,56,37,14,5,27,48,36,22,14,0,12,245,160,104,47,9,85
S01011862,827,425,339,67,19,402,127,31,22,7,2,96,148,73,59,9,5,75,108,67,57,10,0,41,75,45,40,2,3,30,369,209,161,39,9,160
S01011863,722,374,277,70,27,348,124,29,14,11,4,95,146,75,54,12,9,71,93,53,43,3,7,40,55,35,27,7,1,20,304,182,139,37,6,122
S01011864,612,349,265,73,11,263,102,29,19,8,2,73,121,78,57,19,2,43,102,73,57,12,4,29,48,32,25,7,0,16,239,137,107,27,3,102
S01011865,516,297,227,49,21,219,122,33,27,3,3,89,138,87,69,11,7,51,78,56,39,11,6,22,47,30,25,4,1,17,131,91,67,20,4,40
S01011866,636,407,317,69,21,229,160,77,50,20,7,83,170,127,96,22,9,43,84,62,52,7,3,22,46,31,28,3,0,15,176,110,91,17,2,66
S01011867,766,490,418,53,19,276,239,87,67,10,10,152,202,143,128,13,2,59,127,102,81,15,6,25,62,56,51,4,1,6,136,102,91,11,0,34
S01011868,717,451,353,74,24,266,167,60,42,11,7,107,153,107,94,10,3,46,107,73,54,16,3,34,68,56,47,5,4,12,222,155,116,32,7,67
S01011869,679,455,351,81,23,224,144,53,35,11,7,91,172,114,92,16,6,58,84,64,49,12,3,20,72,57,48,7,2,15,207,167,127,35,5,40
S01011870,565,343,273,45,25,222,145,57,46,8,3,88,161,104,82,12,10,57,93,62,49,6,7,31,58,46,41,3,2,12,108,74,55,16,3,34
S01011871,866,606,425,149,32,260,155,65,37,23,5,90,180,131,90,28,13,49,147,113,87,23,3,34,91,77,52,20,5,14,293,220,159,55,6,73
S01011872,723,499,344,136,19,224,91,41,28,13,0,50,141,96,59,30,7,45,122,90,61,26,3,32,78,60,39,19,2,18,291,212,157,48,7,79
S01011873,646,463,373,72,18,183,99,42,26,12,4,57,137,97,80,11,6,40,97,79,65,12,2,18,91,73,61,11,1,18,222,172,141,26,5,50
S01011874,542,379,310,58,11,163,111,43,32,9,2,68,129,96,76,17,3,33,101,85,75,8,2,16,63,52,39,11,2,11,138,103,88,13,2,35
S01011875,571,317,262,37,18,254,165,41,35,3,3,124,131,81,69,5,7,50,82,62,55,3,4,20,59,44,39,3,2,15,134,89,64,23,2,45
S01011876,770,517,386,112,19,253,161,65,45,18,2,96,143,100,65,26,9,43,109,86,67,15,4,23,72,56,36,20,0,16,285,210,173,33,4,75
S01011877,469,293,232,52,9,176,124,38,29,8,1,86,104,75,59,13,3,29,75,56,46,8,2,19,44,36,29,6,1,8,122,88,69,17,2,34
S01011878,976,543,419,103,21,433,162,62,41,19,2,100,234,97,83,13,1,137,167,69,52,12,5,98,79,63,47,11,5,16,334,252,196,48,8,82
S01011879,444,294,217,57,20,150,54,18,10,7,1,36,93,62,47,8,7,31,72,53,39,8,6,19,49,29,23,6,0,20,176,132,98,28,6,44
S01011880,482,313,234,68,11,169,90,38,26,10,2,52,83,50,34,13,3,33,68,53,38,13,2,15,52,45,35,9,1,7,189,127,101,23,3,62
S01011881,664,435,365,54,16,229,150,50,40,6,4,100,142,102,81,15,6,40,118,94,77,13,4,24,62,51,48,3,0,11,192,138,119,17,2,54
S01011882,810,480,407,45,28,330,266,74,56,13,5,192,193,134,115,9,10,59,129,108,93,10,5,21,60,55,45,6,4,5,162,109,98,7,4,53
S01011883,916,580,478,84,18,336,118,40,29,9,2,78,191,112,95,14,3,79,156,100,88,10,2,56,85,60,50,5,5,25,366,268,216,46,6,98
S01011884,347,244,177,59,8,103,61,27,20,7,0,34,77,63,45,13,5,14,47,37,26,10,1,10,38,30,19,10,1,8,124,87,67,19,1,37
S01011885,527,386,303,79,4,141,71,25,13,12,0,46,94,72,56,16,0,22,82,67,50,15,2,15,53,46,40,5,1,7,227,176,144,31,1,51
S01011886,703,459,375,63,21,244,147,60,49,9,2,87,150,98,79,13,6,52,90,63,48,11,4,27,74,55,45,6,4,19,242,183,154,24,5,59
S01011887,468,306,247,43,16,162,128,52,41,9,2,76,118,85,66,13,6,33,60,46,35,8,3,14,66,49,40,7,2,17,96,74,65,6,3,22
S01011888,669,461,385,39,37,208,224,102,80,10,12,122,178,139,125,5,9,39,90,78,65,7,6,12,58,46,38,4,4,12,119,96,77,13,6,23
S01011889,779,426,353,57,16,353,209,39,32,5,2,170,145,92,72,13,7,53,102,65,54,8,3,37,62,52,45,5,2,10,261,178,150,26,2,83
S01011890,570,396,336,41,19,174,128,38,31,5,2,90,110,77,62,10,5,33,78,68,59,6,3,10,64,59,55,2,2,5,190,154,129,18,7,36
S01011891,1121,410,345,28,37,711,407,81,61,6,14,326,343,130,107,7,16,213,136,67,56,8,3,69,98,58,52,4,2,40,137,74,69,3,2,63
S01011892,817,649,563,59,27,168,103,44,33,5,6,59,173,140,119,13,8,33,123,105,93,8,4,18,106,93,76,11,6,13,312,267,242,22,3,45
S01011893,798,542,466,43,33,256,162,48,37,6,5,114,160,116,101,3,12,44,143,118,106,7,5,25,95,77,67,3,7,18,238,183,155,24,4,55
S01011894,531,368,318,31,19,163,137,51,42,5,4,86,150,114,95,10,9,36,61,49,43,4,2,12,56,48,45,1,2,8,127,106,93,11,2,21
S01011895,579,291,215,62,14,288,101,13,3,10,0,88,87,43,30,10,3,44,95,64,45,11,8,31,58,36,26,8,2,22,238,135,111,23,1,103
S01011896,727,451,384,49,18,276,155,32,25,6,1,123,145,86,66,14,6,59,95,72,65,6,1,23,80,62,53,5,4,18,252,199,175,18,6,53
S01011897,826,510,420,64,26,316,149,55,41,10,4,94,175,112,89,17,6,63,105,75,65,4,6,30,66,49,40,4,5,17,331,219,185,29,5,112
S01011898,520,368,300,58,10,152,42,16,13,2,1,26,90,57,48,6,3,33,83,64,48,14,2,19,42,36,26,9,1,6,263,195,165,27,3,68
S01011899,662,389,351,29,9,273,143,39,35,3,1,104,154,92,80,9,3,62,104,73,66,4,3,31,73,59,54,4,1,14,188,126,116,9,1,62
S01011900,602,403,349,41,13,199,101,31,21,9,1,70,106,68,55,9,4,38,94,81,73,5,3,13,60,46,41,4,1,14,241,177,159,14,4,64
S01011901,729,474,377,70,27,255,91,26,16,9,1,65,161,104,76,16,12,57,110,82,70,7,5,28,78,63,51,9,3,15,289,199,164,29,6,90
S01011902,907,529,452,67,10,378,180,57,41,14,2,123,172,110,96,11,3,62,129,90,78,8,4,39,83,56,50,6,0,27,343,216,187,28,1,127
S01011903,678,388,324,49,15,290,109,24,15,7,2,85,144,85,69,15,1,59,93,64,51,9,4,29,76,56,48,4,4,20,256,159,141,14,4,97
S01011904,698,396,345,44,7,302,176,37,32,5,0,139,131,90,79,7,4,41,102,71,61,9,1,31,73,57,52,5,0,16,216,141,121,18,2,75
S01011905,641,434,364,59,11,207,109,32,22,9,1,77,122,79,61,14,4,43,104,78,70,5,3,26,69,55,44,10,1,14,237,190,167,21,2,47
S01011906,370,241,207,23,11,129,69,28,26,0,2,41,94,65,52,9,4,29,53,37,32,4,1,16,45,35,30,3,2,10,109,76,67,7,2,33
S01011907,632,463,412,35,16,169,110,45,35,5,5,65,166,123,103,14,6,43,96,73,64,6,3,23,79,65,63,1,1,14,181,157,147,9,1,24
S01011908,294,234,218,9,7,60,46,24,19,2,3,22,80,62,55,4,3,18,51,45,42,2,1,6,39,35,35,0,0,4,78,68,67,1,0,10
S01011909,783,702,632,50,20,81,76,50,42,6,2,26,224,204,174,25,5,20,135,123,118,1,4,12,133,124,111,8,5,9,215,201,187,10,4,14
S01011910,720,457,374,30,53,263,272,114,95,6,13,158,224,163,125,10,28,61,89,74,63,3,8,15,58,47,39,8,0,11,77,59,52,3,4,18
S01011911,538,342,300,22,20,196,198,78,65,5,8,120,139,98,85,7,6,41,69,58,51,4,3,11,49,41,40,1,0,8,83,67,59,5,3,16
S01011912,578,387,341,27,19,191,199,84,70,7,7,115,159,129,111,11,7,30,82,66,58,4,4,16,61,50,47,3,0,11,77,58,55,2,1,19
S01011913,581,383,323,25,35,198,199,86,71,7,8,113,195,146,119,8,19,49,63,54,46,2,6,9,58,47,44,1,2,11,66,50,43,7,0,16
S01011914,621,432,335,42,55,189,194,107,86,5,16,87,214,148,108,16,24,66,76,68,55,6,7,8,66,57,48,7,2,9,71,52,38,8,6,19
S01011915,643,419,361,28,30,224,228,93,81,5,7,135,181,135,112,11,12,46,76,63,57,2,4,13,59,51,45,2,4,8,99,77,66,8,3,22
S01011916,459,300,252,20,28,159,183,79,66,7,6,104,119,89,65,8,16,30,52,46,42,2,2,6,40,36,34,0,2,4,65,50,45,3,2,15
S01011917,421,270,231,17,22,151,158,62,49,8,5,96,107,79,66,1,12,28,56,45,42,1,2,11,37,29,24,3,2,8,63,55,50,4,1,8
S01011918,582,379,286,31,62,203,232,121,82,11,28,111,159,105,77,9,19,54,70,53,40,3,10,17,35,28,24,2,2,7,86,72,63,6,3,14
S01011919,758,543,443,32,68,215,177,79,62,10,7,98,202,158,123,8,27,44,145,113,93,3,17,32,92,83,71,3,9,9,142,110,94,8,8,32
S01011920,521,359,304,24,31,162,200,87,66,9,12,113,143,120,100,6,14,23,56,49,45,3,1,7,48,42,39,2,1,6,74,61,54,4,3,13
S01011921,465,303,254,22,27,162,164,65,52,3,10,99,151,112,93,9,10,39,46,42,37,3,2,4,39,36,30,4,2,3,65,48,42,3,3,17
S01011922,620,424,362,21,41,196,231,114,99,6,9,117,211,165,137,3,25,46,67,56,48,4,4,11,54,47,41,4,2,7,57,42,37,4,1,15
S01011923,730,457,380,28,49,273,263,100,79,8,13,163,227,155,131,3,21,72,76,62,50,4,8,14,72,63,56,3,4,9,92,77,64,10,3,15
S01011924,354,235,200,17,18,119,119,47,40,3,4,72,111,83,68,6,9,28,47,38,36,1,1,9,30,24,22,1,1,6,47,43,34,6,3,4
S01011925,551,462,387,58,17,89,77,47,32,13,2,30,151,127,103,17,7,24,108,99,90,6,3,9,61,49,42,4,3,12,154,140,120,18,2,14
S01011926,523,355,301,27,27,168,184,81,71,2,8,103,140,108,88,6,14,32,75,63,52,8,3,12,60,53,48,4,1,7,64,50,42,7,1,14
S01011927,502,320,272,21,27,182,194,79,63,5,11,115,152,118,102,8,8,34,59,44,39,2,3,15,43,35,31,1,3,8,54,44,37,5,2,10
S01011928,605,387,328,34,25,218,215,90,73,14,3,125,175,121,99,11,11,54,83,69,63,3,3,14,41,38,34,0,4,3,91,69,59,6,4,22
S01011929,588,378,342,12,24,210,221,87,76,4,7,134,177,138,124,3,11,39,65,53,49,2,2,12,54,45,43,1,1,9,71,55,50,2,3,16
S01011930,508,338,295,24,19,170,175,74,61,7,6,101,138,109,93,6,10,29,83,67,63,3,1,16,51,41,36,4,1,10,61,47,42,4,1,14
S01011931,474,317,251,23,43,157,176,79,62,2,15,97,129,98,77,7,14,31,60,50,41,3,6,10,43,35,28,4,3,8,66,55,43,7,5,11
S01011932,512,391,355,18,18,121,97,37,34,0,3,60,133,116,101,7,8,17,88,76,72,3,1,12,62,54,51,2,1,8,132,108,97,6,5,24
S01011933,561,395,341,28,26,166,174,69,57,6,6,105,105,82,65,7,10,23,70,61,54,3,4,9,67,57,53,1,3,10,145,126,112,11,3,19
S01011934,941,589,477,60,52,352,248,83,57,19,7,165,218,141,116,14,11,77,123,100,81,5,14,23,113,90,75,5,10,23,239,175,148,17,10,64
S01011935,751,549,441,64,44,202,201,92,72,7,13,109,186,143,115,16,12,43,76,62,50,8,4,14,91,81,62,9,10,10,197,171,142,24,5,26
S01011936,684,441,352,47,42,243,158,50,34,5,11,108,122,88,64,7,17,34,76,53,43,7,3,23,77,61,51,5,5,16,251,189,160,23,6,62
S01011937,615,424,361,34,29,191,147,57,51,2,4,90,134,95,74,10,11,39,85,65,54,7,4,20,84,71,58,5,8,13,165,136,124,10,2,29
S01011938,611,406,327,59,20,205,118,29,18,6,5,89,144,92,67,15,10,52,78,61,53,5,3,17,54,47,33,13,1,7,217,177,156,20,1,40
S01011939,666,470,387,31,52,196,143,67,49,6,12,76,165,125,102,6,17,40,100,77,65,4,8,23,84,61,47,6,8,23,174,140,124,9,7,34
S01011940,381,265,225,16,24,116,96,35,29,4,2,61,92,66,50,2,14,26,39,34,31,1,2,5,67,57,48,7,2,10,87,73,67,2,4,14
S01011941,650,524,437,35,52,126,99,47,26,10,11,52,162,135,112,4,19,27,90,75,68,0,7,15,88,82,70,4,8,6,211,185,161,17,7,26
S01011942,784,513,436,36,41,271,193,70,59,2,9,123,202,137,114,9,14,65,102,82,64,5,13,20,107,88,82,3,3,19,180,136,117,17,2,44
S01011943,1055,691,533,44,114,364,299,103,77,10,16,196,258,181,121,13,47,77,140,113,90,4,19,27,125,107,80,7,20,18,233,187,165,10,12,46
S01011944,384,223,154,57,12,161,66,26,14,11,1,40,61,27,16,9,2,34,60,38,30,5,3,22,30,21,16,4,1,9,167,111,78,28,5,56
S01011945,699,355,273,76,6,344,91,22,12,9,1,69,103,45,29,16,0,58,85,44,32,9,3,41,54,26,21,4,1,28,366,218,179,38,1,148
S01011946,671,369,283,46,40,302,188,63,40,8,15,125,151,92,71,5,16,59,76,53,43,5,5,23,52,37,34,2,1,15,204,124,95,26,3,80
S01011947,415,228,203,18,7,187,107,26,26,0,0,81,123,77,64,8,5,46,56,37,32,4,1,19,30,22,22,0,0,8,99,66,59,6,1,33
S01011948,996,520,393,97,30,476,263,46,33,6,7,217,157,94,64,19,11,63,120,87,67,16,4,33,72,50,43,6,1,22,384,243,186,50,7,141
S01011949,713,318,258,47,13,395,135,31,22,9,0,104,128,55,42,8,5,73,105,65,55,9,1,40,72,41,30,9,2,31,273,126,109,12,5,147
S01011950,669,321,272,37,12,348,207,39,31,6,2,168,138,73,61,6,6,65,81,57,48,8,1,24,64,43,37,5,1,21,179,109,95,12,2,70
S01011951,563,341,274,52,15,222,141,38,26,11,1,103,148,106,82,16,8,42,85,66,56,8,2,19,50,39,30,6,3,11,139,92,80,11,1,47
S01011952,393,240,203,31,6,153,54,7,6,1,0,47,74,49,39,7,3,25,73,56,45,10,1,17,39,31,27,3,1,8,153,97,86,10,1,56
S01011953,609,372,304,56,12,237,98,35,24,10,1,63,125,84,68,12,4,41,92,62,50,10,2,30,55,43,36,5,2,12,239,148,126,19,3,91
S01011954,402,252,215,17,20,150,117,48,33,8,7,69,104,71,64,4,3,33,53,40,38,1,1,13,40,31,26,1,4,9,88,62,54,3,5,26
S01011955,836,490,391,70,29,346,260,67,53,11,3,193,187,127,97,20,10,60,93,81,67,10,4,12,92,66,54,7,5,26,204,149,120,22,7,55
S01011956,783,545,463,68,14,238,144,47,34,12,1,97,145,100,82,14,4,45,118,89,73,13,3,29,98,88,84,3,1,10,278,221,190,26,5,57
S01011957,765,526,419,84,23,239,152,65,45,13,7,87,163,120,95,17,8,43,122,90,71,17,2,32,71,56,43,12,1,15,257,195,165,25,5,62
S01011958,903,565,414,136,15,338,198,70,46,19,5,128,205,144,103,37,4,61,130,99,72,26,1,31,90,72,54,16,2,18,280,180,139,38,3,100
S01011959,750,445,344,88,13,305,184,49,34,13,2,135,165,117,90,25,2,48,101,73,56,14,3,28,66,50,43,5,2,16,234,156,121,31,4,78
S01011960,637,477,400,69,8,160,101,37,21,15,1,64,102,69,56,9,4,33,102,78,64,12,2,24,80,69,65,4,0,11,252,224,194,29,1,28
S01011961,573,424,372,38,14,149,118,45,35,6,4,73,121,98,89,4,5,23,82,71,61,9,1,11,62,57,50,6,1,5,190,153,137,13,3,37
S01011962,541,378,298,71,9,163,73,25,12,12,1,48,101,70,48,18,4,31,75,55,47,7,1,20,63,50,37,11,2,13,229,178,154,23,1,51
S01011963,414,261,222,25,14,153,111,27,21,4,2,84,73,50,44,2,4,23,53,36,27,6,3,17,41,32,25,6,1,9,136,116,105,7,4,20
S01011964,827,552,470,52,30,275,161,59,52,6,1,102,190,129,109,10,10,61,102,73,59,10,4,29,92,73,56,8,9,19,282,218,194,18,6,64
S01011965,678,343,293,36,14,335,175,32,25,4,3,143,109,64,52,7,5,45,84,56,50,5,1,28,42,31,26,4,1,11,268,160,140,16,4,108
S01011966,675,413,336,55,22,262,147,47,31,11,5,100,137,85,66,11,8,52,73,61,52,7,2,12,55,40,35,4,1,15,263,180,152,22,6,83
S01011967,963,576,432,133,11,387,175,39,22,15,2,136,207,116,84,26,6,91,117,81,63,15,3,36,87,59,45,14,0,28,377,281,218,63,0,96
S01011968,832,550,452,59,39,282,157,52,41,11,0,105,196,132,96,19,17,64,105,79,63,8,8,26,78,55,49,5,1,23,296,232,203,16,13,64
S01011969,873,521,451,47,23,352,304,117,100,15,2,187,217,161,137,13,11,56,94,66,57,4,5,28,69,50,40,7,3,19,189,127,117,8,2,62
S01011970,761,535,441,52,42,226,268,129,101,13,15,139,224,178,141,22,15,46,78,68,57,4,7,10,61,54,51,2,1,7,130,106,91,11,4,24
S01011971,445,294,220,58,16,151,95,26,19,6,1,69,99,68,54,9,5,31,79,70,48,18,4,9,38,36,28,6,2,2,134,94,71,19,4,40
S01011972,978,624,437,159,28,354,233,100,67,27,6,133,220,152,100,43,9,68,146,112,73,35,4,34,91,70,49,19,2,21,288,190,148,35,7,98
S01011973,547,345,262,66,17,202,133,44,28,13,3,89,109,72,54,16,2,37,70,56,45,7,4,14,73,59,49,9,1,14,162,114,86,21,7,48
S01011974,649,427,335,81,11,222,147,57,38,17,2,90,128,97,76,18,3,31,92,70,56,13,1,22,60,52,38,14,0,8,222,151,127,19,5,71
S01011975,393,238,179,47,12,155,104,44,29,11,4,60,80,50,37,9,4,30,49,33,28,5,0,16,34,24,20,3,1,10,126,87,65,19,3,39
S01011976,645,394,300,71,23,251,155,54,35,15,4,101,150,100,73,14,13,50,92,75,58,14,3,17,57,43,31,11,1,14,191,122,103,17,2,69
S01011977,965,588,438,113,37,377,247,88,59,22,7,159,215,130,98,20,12,85,140,106,74,24,8,34,98,73,54,14,5,25,265,191,153,33,5,74
S01011978,587,304,246,36,22,283,226,65,50,13,2,161,126,78,60,8,10,48,61,46,37,5,4,15,59,45,38,5,2,14,115,70,61,5,4,45
S01011979,835,536,415,111,10,299,184,59,34,23,2,125,183,120,92,26,2,63,117,98,82,13,3,19,63,53,43,10,0,10,288,206,164,39,3,82
S01011980,342,217,146,60,11,125,60,25,14,9,2,35,85,61,44,14,3,24,44,33,23,8,2,11,44,34,23,11,0,10,109,64,42,18,4,45
S01011981,789,542,371,153,18,247,193,95,71,21,3,98,168,125,94,25,6,43,118,83,52,25,6,35,79,65,51,13,1,14,231,174,103,69,2,57
S01011982,786,539,367,150,22,247,165,87,56,30,1,78,145,118,81,28,9,27,127,98,57,35,6,29,71,52,38,11,3,19,278,184,135,46,3,94
S01011983,657,393,266,105,22,264,152,55,37,16,2,97,157,104,72,23,9,53,60,43,29,12,2,17,52,44,26,16,2,8,236,147,102,38,7,89
S01011984,539,320,261,36,23,219,220,78,65,6,7,142,125,100,74,14,12,25,59,43,34,7,2,16,33,22,19,3,0,11,102,77,69,6,2,25
S01011985,623,388,286,85,17,235,164,54,33,19,2,110,164,118,86,21,11,46,88,63,53,9,1,25,47,38,31,5,2,9,160,115,83,31,1,45
S01011986,530,319,235,45,39,211,214,91,66,10,15,123,132,87,64,7,16,45,73,50,39,7,4,23,31,25,19,3,3,6,80,66,47,18,1,14
S01011987,771,471,385,56,30,300,217,72,62,9,1,145,217,168,132,16,20,49,99,72,64,4,4,27,65,51,38,11,2,14,173,108,89,16,3,65
S01011988,602,296,232,56,8,306,181,33,26,6,1,148,107,65,50,12,3,42,76,51,41,7,3,25,51,34,29,5,0,17,187,113,86,26,1,74
S01011989,719,440,354,68,18,279,186,62,45,12,5,124,171,119,95,16,8,52,118,91,77,14,0,27,79,60,47,11,2,19,165,108,90,15,3,57
S01011990,654,335,259,54,22,319,171,39,24,9,6,132,151,90,68,13,9,61,76,59,55,2,2,17,53,40,33,5,2,13,203,107,79,25,3,96
S01011991,594,372,305,51,16,222,171,61,49,10,2,110,140,105,83,16,6,35,97,69,58,8,3,28,46,36,28,3,5,10,140,101,87,14,0,39
S01011992,856,460,352,84,24,396,201,60,39,15,6,141,151,92,71,16,5,59,113,73,55,16,2,40,73,53,42,8,3,20,318,182,145,29,8,136
S01011993,715,446,385,31,30,269,239,81,64,3,14,158,197,148,130,10,8,49,78,68,61,3,4,10,58,41,37,3,1,17,143,108,93,12,3,35
S01011994,655,272,188,71,13,383,119,14,8,5,1,105,113,55,33,19,3,58,80,42,28,10,4,38,42,25,21,2,2,17,301,136,98,35,3,165
S01011995,664,470,346,110,14,194,121,47,33,13,1,74,168,129,83,39,7,39,100,72,57,12,3,28,63,56,47,9,0,7,212,166,126,37,3,46
S01011996,462,289,234,36,19,173,162,58,42,13,3,104,119,89,70,7,12,30,67,55,46,5,4,12,35,27,26,1,0,8,79,60,50,10,0,19
S01011997,745,499,405,65,29,246,187,72,51,17,4,115,179,134,114,7,13,45,125,106,85,17,4,19,58,46,40,4,2,12,196,141,115,20,6,55
S01011998,426,256,192,55,9,170,61,22,13,7,2,39,82,50,33,14,3,32,72,49,44,5,0,23,46,35,27,7,1,11,165,100,75,22,3,65
S01011999,527,376,286,79,11,151,125,48,38,8,2,77,118,98,71,22,5,20,75,63,46,16,1,12,57,51,41,9,1,6,152,116,90,24,2,36
S01012000,375,257,214,39,4,118,74,23,21,2,0,51,103,82,69,11,2,21,66,51,41,10,0,15,39,32,28,3,1,7,93,69,55,13,1,24
S01012001,522,352,282,55,15,170,146,56,41,13,2,90,137,106,87,14,5,31,69,60,52,7,1,9,46,40,31,6,3,6,124,90,71,15,4,34
S01012002,484,259,214,36,9,225,164,46,37,8,1,118,120,68,50,12,6,52,67,55,46,8,1,12,42,34,29,4,1,8,91,56,52,4,0,35
S01012003,457,310,255,32,23,147,131,47,32,7,8,84,97,68,57,7,4,29,89,80,63,7,10,9,46,43,36,6,1,3,94,72,67,5,0,22
S01012004,755,448,369,64,15,307,221,63,41,18,4,158,162,113,97,11,5,49,107,81,71,9,1,26,77,62,56,4,2,15,188,129,104,22,3,59
S01012005,675,500,420,54,26,175,124,48,37,7,4,76,153,127,104,12,11,26,123,99,84,12,3,24,88,77,64,9,4,11,187,149,131,14,4,38
S01012006,745,419,305,96,18,326,102,40,18,20,2,62,197,89,59,23,7,108,153,61,44,14,3,92,47,37,27,9,1,10,246,192,157,30,5,54
S01012007,704,412,313,81,18,292,151,46,34,9,3,105,121,84,69,9,6,37,103,77,55,20,2,26,62,51,41,6,4,11,267,154,114,37,3,113
S01012008,804,542,395,125,22,262,164,65,45,18,2,99,154,112,81,24,7,42,106,80,59,20,1,26,64,55,38,15,2,9,316,230,172,48,10,86
S01012009,618,444,335,97,12,174,139,68,54,11,3,71,146,115,88,21,6,31,102,86,67,18,1,16,50,41,31,10,0,9,181,134,95,37,2,47
S01012010,1080,627,486,127,14,453,177,54,36,16,2,123,229,156,122,30,4,73,140,93,77,13,3,47,96,69,56,13,0,27,438,255,195,55,5,183
S01012011,960,619,479,115,25,341,221,88,66,18,4,133,256,193,153,27,13,63,110,79,63,14,2,31,110,88,68,20,0,22,263,171,129,36,6,92
S01012012,588,306,213,78,15,282,147,39,16,20,3,108,125,73,54,14,5,52,70,58,42,15,1,12,57,35,24,8,3,22,189,101,77,21,3,88
S01012013,649,416,275,128,13,233,139,58,38,16,4,81,139,103,67,32,4,36,89,67,44,21,2,22,45,36,31,5,0,9,237,152,95,54,3,85
S01012014,715,464,353,85,26,251,201,79,60,11,8,122,167,117,94,16,7,50,80,63,51,11,1,17,60,54,42,8,4,6,207,151,106,39,6,56
S01012015,780,486,370,91,25,294,177,62,44,13,5,115,201,144,114,20,10,57,119,85,74,11,0,34,64,45,37,6,2,19,219,150,101,41,8,69
S01012016,740,510,369,119,22,230,149,72,52,18,2,77,161,124,90,28,6,37,103,81,57,20,4,22,73,65,48,11,6,8,254,168,122,42,4,86
S01012017,432,268,137,118,13,164,79,35,16,16,3,44,71,46,25,16,5,25,52,44,22,19,3,8,36,29,16,12,1,7,194,114,58,55,1,80
S01012018,725,478,327,130,21,247,122,52,24,23,5,70,168,123,89,25,9,45,98,70,58,11,1,28,74,63,39,22,2,11,263,170,117,49,4,93
S01012019,661,466,385,49,32,195,96,26,17,5,4,70,123,84,59,11,14,39,105,79,68,5,6,26,85,72,60,10,2,13,252,205,181,18,6,47
S01012020,586,320,272,29,19,266,178,33,24,6,3,145,96,56,43,7,6,40,69,50,41,5,4,19,48,36,33,1,2,12,195,145,131,10,4,50
S01012021,472,310,246,39,25,162,93,40,35,1,4,53,92,54,42,4,8,38,73,47,36,9,2,26,54,47,36,5,6,7,160,122,97,20,5,38
S01012022,529,359,297,46,16,170,153,68,50,14,4,85,105,76,68,6,2,29,65,51,43,6,2,14,57,47,37,5,5,10,149,117,99,15,3,32
S01012023,449,309,198,96,15,140,69,25,7,18,0,44,67,41,26,11,4,26,72,58,41,15,2,14,52,41,22,16,3,11,189,144,102,36,6,45
S01012024,690,495,402,61,32,195,109,44,34,7,3,65,140,99,78,12,9,41,116,89,71,13,5,27,88,72,59,7,6,16,237,191,160,22,9,46
S01012025,563,379,322,37,20,184,149,56,44,9,3,93,125,94,75,10,9,31,77,58,50,7,1,19,75,61,53,2,6,14,137,110,100,9,1,27
S01012026,465,364,309,47,8,101,43,14,9,5,0,29,103,74,56,14,4,29,81,63,53,9,1,18,67,55,49,4,2,12,171,158,142,15,1,13
S01012027,841,467,370,77,20,374,257,41,24,14,3,216,119,66,50,11,5,53,112,95,74,15,6,17,94,70,55,13,2,24,259,195,167,24,4,64
S01012028,780,489,395,67,27,291,75,27,20,6,1,48,108,65,43,15,7,43,134,91,74,13,4,43,100,72,58,7,7,28,363,234,200,26,8,129
S01012029,1078,586,464,89,33,492,349,93,66,23,4,256,210,126,100,14,12,84,131,87,72,9,6,44,118,90,77,9,4,28,270,190,149,34,7,80
S01012030,534,392,290,86,16,142,97,45,23,22,0,52,117,85,59,20,6,32,78,59,46,10,3,19,52,45,39,6,0,7,190,158,123,28,7,32
S01012031,461,266,207,49,10,195,53,17,12,5,0,36,65,36,30,5,1,29,61,39,31,7,1,22,42,26,15,6,5,16,240,148,119,26,3,92
S01012032,301,200,145,48,7,101,51,15,5,9,1,36,52,36,24,11,1,16,39,27,21,5,1,12,34,25,13,8,4,9,125,97,82,15,0,28
S01012033,696,415,353,36,26,281,183,60,48,4,8,123,138,90,69,7,14,48,114,80,70,8,2,34,79,59,50,8,1,20,182,126,116,9,1,56
S01012034,658,411,330,53,28,247,176,55,46,6,3,121,125,84,55,10,19,41,95,64,54,7,3,31,62,54,44,9,1,8,200,154,131,21,2,46
S01012035,772,469,367,63,39,303,169,42,26,6,10,127,141,86,60,16,10,55,126,95,81,9,5,31,77,59,47,10,2,18,259,187,153,22,12,72
S01012036,735,431,360,43,28,304,113,24,15,5,4,89,160,88,68,7,13,72,125,94,80,9,5,31,92,63,54,6,3,29,245,162,143,16,3,83
S01012037,762,445,358,20,67,317,278,84,68,6,10,194,222,157,113,9,35,65,89,68,54,1,13,21,72,57,53,2,2,15,101,79,70,2,7,22
S01012038,630,360,263,22,75,270,233,100,67,3,30,133,232,146,106,10,30,86,72,48,36,4,8,24,42,30,23,2,5,12,51,36,31,3,2,15
S01012039,801,447,359,32,56,354,342,124,100,13,11,218,234,150,113,7,30,84,88,68,58,5,5,20,62,51,43,3,5,11,75,54,45,4,5,21
S01012040,558,385,330,34,21,173,127,51,37,11,3,76,155,109,93,7,9,46,91,71,67,1,3,20,68,59,52,5,2,9,117,95,81,10,4,22
S01012041,721,431,366,31,34,290,220,65,59,3,3,155,207,139,111,10,18,68,101,77,67,5,5,24,83,62,52,5,5,21,110,88,77,8,3,22
S01012042,754,451,376,41,34,303,283,103,79,13,11,180,193,142,116,13,13,51,89,69,62,3,4,20,72,57,49,4,4,15,117,80,70,8,2,37
S01012043,687,424,338,28,58,263,288,122,91,2,29,166,163,119,96,6,17,44,68,53,45,4,4,15,59,48,38,6,4,11,109,82,68,10,4,27
S01012044,756,357,282,23,52,399,369,94,67,6,21,275,172,100,72,6,22,72,71,54,45,4,5,17,51,35,32,2,1,16,93,74,66,5,3,19
S01012045,903,559,454,37,68,344,281,95,76,5,14,186,201,127,93,9,25,74,140,106,90,8,8,34,118,100,82,6,12,18,163,131,113,9,9,32
S01012046,571,289,230,15,44,282,240,61,46,4,11,179,161,99,74,7,18,62,64,50,43,2,5,14,41,32,28,0,4,9,65,47,39,2,6,18
S01012047,805,405,324,29,52,400,357,94,73,8,13,263,216,128,94,10,24,88,76,60,49,5,6,16,69,51,45,1,5,18,87,72,63,5,4,15
S01012048,615,308,251,17,40,307,263,50,33,7,10,213,128,90,72,3,15,38,78,64,54,4,6,14,64,42,35,1,6,22,82,62,57,2,3,20
S01012049,575,360,306,28,26,215,167,48,38,3,7,119,143,97,76,11,10,46,92,69,63,3,3,23,66,57,53,3,1,9,107,89,76,8,5,18
S01012050,801,583,502,40,41,218,180,69,57,5,7,111,228,182,148,17,17,46,128,104,92,5,7,24,112,92,81,7,4,20,153,136,124,6,6,17
S01012051,427,250,199,29,22,177,126,27,21,3,3,99,93,68,44,11,13,25,60,47,42,2,3,13,44,31,26,3,2,13,104,77,66,10,1,27
S01012052,763,459,401,25,33,304,261,78,66,10,2,183,191,130,104,10,16,61,86,65,56,3,6,21,82,71,68,1,2,11,143,115,107,1,7,28
S01012053,750,428,352,19,57,322,286,98,72,7,19,188,205,130,100,3,27,75,111,88,76,5,7,23,68,52,50,1,1,16,80,60,54,3,3,20
S01012054,650,422,305,23,94,228,206,91,61,2,28,115,205,140,97,8,35,65,90,74,55,4,15,16,68,50,40,4,6,18,81,67,52,5,10,14
S01012055,735,405,336,24,45,330,305,97,75,7,15,208,202,131,108,10,13,71,92,74,57,4,13,18,54,42,39,1,2,12,82,61,57,2,2,21
S01012056,671,388,323,42,23,283,170,37,27,6,4,133,159,94,82,7,5,65,116,84,68,11,5,32,60,45,38,4,3,15,166,128,108,14,6,38
S01012057,669,407,359,31,17,262,122,42,32,7,3,80,140,81,65,12,4,59,146,106,98,4,4,40,78,55,49,2,4,23,183,123,115,6,2,60
S01012058,633,381,313,48,20,252,134,40,25,11,4,94,124,80,63,12,5,44,112,89,75,8,6,23,72,51,43,8,0,21,191,121,107,9,5,70
S01012059,706,401,327,38,36,305,279,93,73,10,10,186,189,136,107,11,18,53,88,65,53,7,5,23,66,47,41,4,2,19,84,60,53,6,1,24
S01012060,713,411,332,33,46,302,281,80,57,11,12,201,145,104,76,10,18,41,94,74,67,2,5,20,74,62,50,4,8,12,119,91,82,6,3,28
S01012061,830,514,440,41,33,316,183,55,35,8,12,128,157,97,81,8,8,60,109,80,72,4,4,29,94,78,68,7,3,16,287,204,184,14,6,83
S01012062,692,510,434,53,23,182,132,62,50,8,4,70,163,128,108,15,5,35,139,109,94,6,9,30,93,83,75,7,1,10,165,128,107,17,4,37
S01012063,406,312,259,30,23,94,95,57,44,5,8,38,109,83,69,5,9,26,65,55,43,8,4,10,58,49,42,6,1,9,79,68,61,6,1,11
S01012064,473,278,185,9,84,195,176,72,41,1,30,104,155,99,59,5,35,56,41,30,22,0,8,11,43,28,16,2,10,15,58,49,47,1,1,9
S01012065,416,216,149,10,57,200,184,59,38,1,20,125,130,82,53,3,26,48,37,21,19,1,1,16,33,27,17,3,7,6,32,27,22,2,3,5
S01012066,635,412,340,21,51,223,244,116,91,9,16,128,190,134,106,4,24,56,72,50,44,2,4,22,49,44,37,2,5,5,80,68,62,4,2,12
S01012067,419,241,171,9,61,178,224,109,80,1,28,115,94,60,35,2,23,34,39,27,23,2,2,12,31,24,20,0,4,7,31,21,13,4,4,10
S01012068,433,183,121,6,56,250,240,69,38,1,30,171,107,60,42,2,16,47,33,19,17,0,2,14,32,20,11,3,6,12,21,15,13,0,2,6
S01012069,403,230,164,15,51,173,181,60,34,4,22,121,89,64,44,3,17,25,40,31,27,2,2,9,45,36,28,4,4,9,48,39,31,2,6,9
S01012070,615,323,234,16,73,292,257,84,55,5,24,173,152,99,69,3,27,53,42,31,22,2,7,11,78,48,41,1,6,30,86,61,47,5,9,25
S01012071,915,518,390,36,92,397,292,75,46,4,25,217,196,127,91,3,33,69,145,95,68,12,15,50,103,85,68,6,11,18,179,136,117,11,8,43
S01012072,971,538,403,34,101,433,360,101,66,4,31,259,190,120,77,8,35,70,133,101,77,4,20,32,94,74,62,5,7,20,194,142,121,13,8,52
S01012073,564,411,352,28,31,153,110,38,30,4,4,72,138,98,76,7,15,40,86,71,63,5,3,15,82,72,64,6,2,10,148,132,119,6,7,16
S01012074,588,444,378,38,28,144,95,30,22,7,1,65,134,103,76,13,14,31,114,97,87,6,4,17,65,53,45,3,5,12,180,161,148,9,4,19
S01012075,582,484,400,47,37,98,75,41,31,5,5,34,155,132,100,18,14,23,125,110,94,5,11,15,71,65,56,6,3,6,156,136,119,13,4,20
S01012076,615,386,332,31,23,229,182,36,29,5,2,146,146,109,84,12,13,37,97,85,77,4,4,12,61,49,41,5,3,12,129,107,101,5,1,22
S01012077,587,389,325,17,47,198,171,73,60,4,9,98,182,120,94,2,24,62,65,54,42,5,7,11,77,62,56,3,3,15,92,80,73,3,4,12
S01012078,783,515,439,34,42,268,202,63,47,7,9,139,196,145,112,13,20,51,109,89,77,6,6,20,94,74,68,4,2,20,182,144,135,4,5,38
S01012079,763,446,353,32,61,317,321,112,85,9,18,209,204,154,119,9,26,50,71,54,47,2,5,17,69,53,39,6,8,16,98,73,63,6,4,25
S01012080,564,368,294,18,56,196,156,67,46,6,15,89,182,131,104,5,22,51,66,50,44,2,4,16,76,54,44,3,7,22,84,66,56,2,8,18
S01012081,581,356,266,21,69,225,234,93,58,6,29,141,161,123,92,6,25,38,71,54,43,6,5,17,56,45,39,1,5,11,59,41,34,2,5,18
S01012082,512,289,229,14,46,223,215,74,54,8,12,141,151,105,79,3,23,46,56,39,37,0,2,17,48,41,32,1,8,7,42,30,27,2,1,12
S01012083,643,319,254,16,49,324,295,67,53,3,11,228,163,110,82,5,23,53,76,50,42,2,6,26,54,45,36,2,7,9,55,47,41,4,2,8
S01012084,487,331,286,26,19,156,135,50,42,5,3,85,123,101,86,8,7,22,76,59,49,4,6,17,67,58,50,6,2,9,86,63,59,3,1,23
S01012085,588,386,343,22,21,202,166,53,42,5,6,113,142,104,90,7,7,38,111,96,89,3,4,15,70,56,50,3,3,14,99,77,72,4,1,22
S01012086,750,451,371,15,65,299,273,73,55,2,16,200,238,183,151,10,22,55,106,83,64,1,18,23,63,56,48,1,7,7,70,56,53,1,2,14
S01012087,608,350,296,15,39,258,215,59,51,2,6,156,173,124,92,6,26,49,74,56,51,2,3,18,73,61,55,3,3,12,73,50,47,2,1,23
S01012088,555,423,356,33,34,132,96,49,34,6,9,47,143,107,88,5,14,36,87,69,55,9,5,18,71,62,55,3,4,9,158,136,124,10,2,22
S01012089,692,476,407,43,26,216,109,34,22,11,1,75,134,91,81,5,5,43,119,93,73,8,12,26,102,77,62,13,2,25,228,181,169,6,6,47
S01012090,770,468,379,67,22,302,123,36,27,8,1,87,114,75,58,12,5,39,120,83,69,10,4,37,103,74,60,7,7,29,310,200,165,30,5,110
S01012091,465,328,294,19,15,137,98,44,36,6,2,54,110,81,72,4,5,29,89,71,62,4,5,18,57,45,39,4,2,12,111,87,85,1,1,24
S01012092,433,301,263,28,10,132,90,37,30,5,2,53,98,70,60,9,1,28,79,66,57,5,4,13,59,47,42,4,1,12,107,81,74,5,2,26
S01012093,478,294,254,28,12,184,103,34,23,8,3,69,91,53,49,3,1,38,72,52,46,5,1,20,68,57,54,2,1,11,144,98,82,10,6,46
S01012094,683,421,342,60,19,262,148,44,27,14,3,104,107,69,53,13,3,38,112,88,73,10,5,24,59,39,33,4,2,20,257,181,156,19,6,76
S01012095,874,615,520,43,52,259,218,94,77,8,9,124,223,165,126,13,26,58,162,131,113,9,9,31,84,64,59,4,1,20,187,161,145,9,7,26
S01012096,725,422,340,29,53,303,287,98,79,8,11,189,208,147,115,10,22,61,88,69,52,6,11,19,68,54,46,2,6,14,74,54,48,3,3,20
S01012097,537,338,283,17,38,199,200,80,64,4,12,120,157,114,91,7,16,43,61,48,41,2,5,13,50,44,38,3,3,6,69,52,49,1,2,17
S01012098,509,313,272,14,27,196,190,83,70,3,10,107,151,94,82,4,8,57,63,51,44,2,5,12,42,35,31,1,3,7,63,50,45,4,1,13
S01012099,737,378,315,9,54,359,317,102,85,2,15,215,194,122,95,2,25,72,76,49,43,1,5,27,66,44,40,1,3,22,84,61,52,3,6,23
S01012100,876,512,420,39,53,364,366,111,88,13,10,255,209,161,128,10,23,48,111,93,81,4,8,18,68,57,46,3,8,11,122,90,77,9,4,32
S01012101,662,438,367,43,28,224,116,39,31,4,4,77,119,84,64,9,11,35,109,84,75,4,5,25,71,57,44,9,4,14,247,174,153,17,4,73
S01012102,501,315,258,13,44,186,153,71,52,4,15,82,154,99,76,5,18,55,61,47,43,2,2,14,64,45,38,0,7,19,69,53,49,2,2,16
S01012103,763,568,473,45,50,195,167,75,59,5,11,92,195,154,117,17,20,41,134,111,97,6,8,23,94,77,64,5,8,17,173,151,136,12,3,22
S01012104,700,530,453,58,19,170,71,25,18,5,2,46,158,112,90,16,6,46,124,101,87,11,3,23,95,76,66,9,1,19,252,216,192,17,7,36
S01012105,928,635,535,65,35,293,165,54,40,11,3,111,170,124,104,13,7,46,159,118,98,8,12,41,115,96,75,14,7,19,319,243,218,19,6,76
S01012106,897,647,548,70,29,250,120,51,40,8,3,69,172,120,85,21,14,52,168,137,119,11,7,31,99,78,71,7,0,21,338,261,233,23,5,77
S01012107,587,348,275,47,26,239,120,35,26,6,3,85,100,66,43,10,13,34,72,41,38,2,1,31,59,45,30,13,2,14,236,161,138,16,7,75
S01012108,852,363,296,24,43,489,444,69,54,7,8,375,152,88,70,7,11,64,84,62,43,5,14,22,50,45,39,1,5,5,122,99,90,4,5,23
S01012109,766,500,399,28,73,266,224,73,56,6,11,151,184,127,88,9,30,57,102,87,71,3,13,15,92,74,62,5,7,18,164,139,122,5,12,25
S01012110,635,357,295,19,43,278,242,60,40,7,13,182,122,87,69,8,10,35,70,54,48,2,4,16,67,50,43,0,7,17,134,106,95,2,9,28
S01012111,461,279,219,18,42,182,135,35,24,2,9,100,126,92,73,6,13,34,64,54,38,6,10,10,50,34,27,2,5,16,86,64,57,2,5,22
S01012112,666,336,282,25,29,330,254,55,42,8,5,199,109,66,56,2,8,43,70,48,39,6,3,22,72,58,53,2,3,14,161,109,92,7,10,52
S01012113,866,476,409,38,29,390,304,86,75,8,3,218,188,119,92,10,17,69,123,84,73,8,3,39,79,55,50,2,3,24,172,132,119,10,3,40
S01012114,834,463,365,60,38,371,108,27,22,4,1,81,131,65,55,5,5,66,149,102,65,17,20,47,96,57,51,5,1,39,350,212,172,29,11,138
S01012115,429,243,230,5,8,186,183,59,55,2,2,124,106,79,74,1,4,27,36,28,25,2,1,8,41,30,29,0,1,11,63,47,47,0,0,16
S01012116,498,295,254,22,19,203,204,70,60,6,4,134,120,90,76,6,8,30,69,55,47,5,3,14,38,28,25,1,2,10,67,52,46,4,2,15
S01012117,575,485,431,41,13,90,65,38,32,6,0,27,108,91,76,7,8,17,108,96,84,10,2,12,93,83,71,11,1,10,201,177,168,7,2,24
S01012118,494,391,346,34,11,103,55,29,25,2,2,26,130,102,87,11,4,28,102,83,67,12,4,19,56,50,46,3,1,6,151,127,121,6,0,24
S01012119,741,476,411,44,21,265,154,52,40,11,1,102,195,136,112,15,9,59,125,92,82,6,4,33,80,58,55,2,1,22,187,138,122,10,6,49
S01012120,468,293,242,15,36,175,155,62,53,2,7,93,129,92,71,3,18,37,53,43,33,4,6,10,61,43,38,3,2,18,70,53,47,3,3,17
S01012121,787,423,350,21,52,364,343,90,74,2,14,253,208,148,115,10,23,60,76,63,56,2,5,13,65,51,42,2,7,14,95,71,63,5,3,24
S01012122,671,413,350,20,43,258,267,91,79,6,6,176,166,130,104,7,19,36,72,61,51,1,9,11,64,55,47,2,6,9,102,76,69,4,3,26
S01012123,429,299,238,32,29,130,107,44,36,4,4,63,84,62,46,7,9,22,69,53,43,5,5,16,55,49,37,6,6,6,114,91,76,10,5,23
S01012124,447,318,283,20,15,129,94,39,34,3,2,55,98,74,63,7,4,24,86,67,62,2,3,19,69,56,47,4,5,13,100,82,77,4,1,18
S01012125,665,400,305,22,73,265,224,74,53,5,16,150,153,106,72,5,29,47,78,57,49,3,5,21,98,75,57,6,12,23,112,88,74,3,11,24
S01012126,673,505,425,47,33,168,123,46,33,6,7,77,131,96,81,5,10,35,119,102,86,9,7,17,82,65,57,3,5,17,218,196,168,24,4,22
S01012127,745,512,386,38,88,233,157,66,38,7,21,91,176,129,84,8,37,47,111,72,58,6,8,39,104,82,64,7,11,22,197,163,142,10,11,34
S01012128,421,317,262,15,40,104,67,29,17,3,9,38,93,63,52,2,9,30,75,57,46,3,8,18,53,51,46,3,2,2,133,117,101,4,12,16
S01012129,607,393,319,27,47,214,166,59,44,7,8,107,144,96,73,5,18,48,87,68,52,6,10,19,63,54,45,4,5,9,147,116,105,5,6,31
S01012130,982,484,408,30,46,498,405,72,61,0,11,333,190,116,88,11,17,74,105,85,72,7,6,20,83,65,56,2,7,18,199,146,131,10,5,53
S01012131,997,585,455,24,106,412,274,84,57,2,25,190,229,148,115,7,26,81,128,99,77,4,18,29,106,78,68,4,6,28,260,176,138,7,31,84
S01012132,592,375,285,27,63,217,165,56,42,5,9,109,108,75,50,4,21,33,76,56,40,3,13,20,71,54,42,3,9,17,172,134,111,12,11,38
S01012133,788,494,385,31,78,294,107,45,25,5,15,62,178,111,79,7,25,67,122,93,68,5,20,29,97,59,49,2,8,38,284,186,164,12,10,98
S01012134,1060,602,502,57,43,458,244,47,39,3,5,197,178,105,76,13,16,73,155,105,90,6,9,50,118,82,66,10,6,36,365,263,231,25,7,102
S01012135,744,433,338,19,76,311,254,73,49,3,21,181,189,142,105,7,30,47,86,60,46,5,9,26,88,58,50,0,8,30,127,100,88,4,8,27
S01012136,715,466,375,19,72,249,159,56,41,2,13,103,167,114,80,3,31,53,97,84,69,2,13,13,102,68,58,4,6,34,190,144,127,8,9,46
S01012137,608,307,249,19,39,301,198,42,34,4,4,156,155,90,67,8,15,65,80,62,52,2,8,18,49,34,29,1,4,15,126,79,67,4,8,47
S01012138,785,485,410,41,34,300,193,53,41,7,5,140,123,79,67,4,8,44,125,91,76,6,9,34,96,64,55,4,5,32,248,198,171,20,7,50
S01012139,783,456,390,38,28,327,246,67,61,4,2,179,178,117,91,11,15,61,102,78,69,7,2,24,89,65,54,7,4,24,168,129,115,9,5,39
S01012140,441,289,248,26,15,152,77,26,17,8,1,51,62,36,26,6,4,26,71,53,45,3,5,18,61,44,39,3,2,17,170,130,121,6,3,40
S01012141,829,515,441,46,28,314,157,49,39,9,1,108,149,82,64,10,8,67,165,115,99,9,7,50,104,78,70,3,5,26,254,191,169,15,7,63
S01012142,800,459,384,55,20,341,167,55,43,10,2,112,152,84,65,14,5,68,125,84,69,8,7,41,100,70,57,9,4,30,256,166,150,14,2,90
S01012143,766,429,353,56,20,337,149,37,24,11,2,112,128,71,53,14,4,57,138,86,75,6,5,52,73,48,40,6,2,25,278,187,161,19,7,91
S01012144,874,522,443,54,25,352,199,47,30,15,2,152,156,99,80,11,8,57,129,97,83,9,5,32,115,83,74,5,4,32,275,196,176,14,6,79
S01012145,836,506,442,49,15,330,132,37,25,12,0,95,117,64,54,4,6,53,133,87,79,5,3,46,91,67,55,10,2,24,363,251,229,18,4,112
S01012146,819,438,367,28,43,381,312,72,65,4,3,240,181,122,96,4,22,59,86,62,50,6,6,24,96,63,53,4,6,33,144,119,103,10,6,25
S01012147,622,336,263,19,54,286,245,73,58,4,11,172,162,100,73,7,20,62,69,49,37,3,9,20,68,50,41,3,6,18,78,64,54,2,8,14
S01012148,574,318,254,11,53,256,213,66,44,6,16,147,175,103,86,3,14,72,58,50,39,1,10,8,68,51,38,1,12,17,60,48,47,0,1,12
S01012149,693,422,349,45,28,271,170,48,34,11,3,122,168,119,95,14,10,49,108,80,74,3,3,28,91,61,49,7,5,30,156,114,97,10,7,42
S01012150,623,333,273,17,43,290,280,85,66,5,14,195,157,97,74,4,19,60,62,49,41,4,4,13,50,41,34,3,4,9,74,61,58,1,2,13
S01012151,626,331,283,12,36,295,265,74,63,2,9,191,156,105,85,2,18,51,72,52,44,5,3,20,56,44,40,2,2,12,77,56,51,1,4,21
S01012152,601,336,267,19,50,265,245,99,72,6,21,146,181,108,82,2,24,73,60,47,43,2,2,13,59,45,39,5,1,14,56,37,31,4,2,19
S01012153,447,285,230,15,40,162,125,39,28,1,10,86,119,84,66,6,12,35,65,53,43,2,8,12,53,45,37,3,5,8,85,64,56,3,5,21
S01012154,688,404,320,18,66,284,224,64,45,1,18,160,182,113,88,6,19,69,73,63,53,2,8,10,95,73,56,5,12,22,114,91,78,4,9,23
S01012155,497,312,245,14,53,185,169,59,39,5,15,110,128,95,73,4,18,33,52,40,34,0,6,12,60,52,41,2,9,8,88,66,58,3,5,22
S01012156,529,289,222,20,47,240,228,76,58,2,16,152,131,79,56,6,17,52,58,45,32,4,9,13,48,41,34,3,4,7,64,48,42,5,1,16
S01012157,802,548,466,30,52,254,271,108,84,7,17,163,193,152,121,13,18,41,106,86,77,3,6,20,91,73,65,1,7,18,141,129,119,6,4,12
S01012158,877,666,553,61,52,211,169,76,51,15,10,93,204,170,138,10,22,34,116,89,68,14,7,27,140,117,99,12,6,23,248,214,197,10,7,34
S01012159,454,272,235,19,18,182,131,41,35,4,2,90,103,72,59,7,6,31,71,50,42,5,3,21,63,48,39,2,7,15,86,61,60,1,0,25
S01012160,569,383,330,30,23,186,152,51,46,3,2,101,133,95,82,8,5,38,88,76,63,6,7,12,76,65,57,8,0,11,120,96,82,5,9,24
S01012161,343,210,178,10,22,133,130,46,35,2,9,84,102,69,59,5,5,33,32,27,24,0,3,5,34,32,28,0,4,2,45,36,32,3,1,9
S01012162,731,463,386,25,52,268,232,78,58,6,14,154,189,135,108,5,22,54,93,71,63,3,5,22,86,67,59,4,4,19,131,112,98,7,7,19
S01012163,586,386,323,28,35,200,157,48,35,4,9,109,152,115,94,8,13,37,72,60,52,4,4,12,72,57,49,3,5,15,133,106,93,9,4,27
S01012164,804,678,613,44,21,126,96,58,45,12,1,38,206,177,153,15,9,29,170,153,137,8,8,17,115,100,94,4,2,15,217,190,184,5,1,27
S01012165,712,447,346,24,77,265,263,107,80,6,21,156,204,146,108,5,33,58,92,76,60,7,9,16,70,54,47,2,5,16,83,64,51,4,9,19
S01012166,490,338,296,18,24,152,150,75,63,3,9,75,147,104,89,8,7,43,57,49,45,2,2,8,68,53,49,2,2,15,68,57,50,3,4,11
S01012167,690,444,375,32,37,246,248,100,74,11,15,148,172,129,106,7,16,43,91,74,66,6,2,17,75,53,47,3,3,22,104,88,82,5,1,16
S01012168,714,432,368,33,31,282,180,43,32,6,5,137,163,121,100,9,12,42,124,84,71,3,10,40,80,61,53,6,2,19,167,123,112,9,2,44
S01012169,725,394,351,19,24,331,266,65,58,2,5,201,162,102,86,7,9,60,91,67,59,3,5,24,96,76,71,2,3,20,110,84,77,5,2,26
S01012170,849,448,397,25,26,401,349,84,77,4,3,265,192,123,102,10,11,69,91,74,67,4,3,17,103,80,72,2,6,23,114,87,79,5,3,27
S01012171,832,505,467,12,26,327,317,103,96,1,6,214,215,163,148,4,11,52,109,83,76,1,6,26,111,89,84,3,2,22,80,67,63,3,1,13
S01012172,611,343,303,15,25,268,244,72,65,4,3,172,144,101,83,5,13,43,79,51,43,0,8,28,74,61,57,3,1,13,70,58,55,3,0,12
S01012173,633,309,276,26,7,324,193,39,32,7,0,154,121,66,57,5,4,55,94,65,57,7,1,29,60,40,38,1,1,20,165,99,92,6,1,66
S01012174,665,554,490,49,15,111,89,53,44,5,4,36,181,146,122,22,2,35,132,116,108,4,4,16,82,75,66,6,3,7,181,164,150,12,2,17
S01012175,686,503,449,25,29,183,166,82,60,7,15,84,133,102,91,6,5,31,127,103,97,3,3,24,76,65,61,2,2,11,184,151,140,7,4,33
S01012176,727,512,446,35,31,215,176,77,62,12,3,99,177,132,108,11,13,45,122,97,86,5,6,25,108,93,87,2,4,15,144,113,103,5,5,31
S01012177,523,342,291,36,15,181,133,59,46,8,5,74,128,81,62,12,7,47,85,65,60,4,1,20,66,52,48,4,0,14,111,85,75,8,2,26
S01012178,451,302,266,25,11,149,114,48,42,5,1,66,114,87,73,10,4,27,80,59,54,5,0,21,43,31,28,0,3,12,100,77,69,5,3,23
S01012179,520,283,237,27,19,237,194,53,38,6,9,141,107,70,59,8,3,37,70,56,50,4,2,14,55,40,32,4,4,15,94,64,58,5,1,30
S01012180,480,239,203,22,14,241,172,36,30,4,2,136,96,58,44,8,6,38,60,46,41,2,3,14,55,36,31,2,3,19,97,63,57,6,0,34
S01012181,648,365,300,33,32,283,233,61,50,5,6,172,132,80,59,13,8,52,82,66,51,7,8,16,65,55,44,5,6,10,136,103,96,3,4,33
S01012182,853,677,603,52,22,176,144,77,63,12,2,67,197,154,131,11,12,43,143,122,113,7,2,21,122,107,93,11,3,15,247,217,203,11,3,30
S01012183,616,402,339,25,38,214,182,63,49,6,8,119,160,112,92,9,11,48,83,67,56,2,9,16,77,63,55,3,5,14,114,97,87,5,5,17
S01012184,447,360,308,24,28,87,49,17,12,4,1,32,95,80,63,9,8,15,65,51,42,0,9,14,68,60,52,3,5,8,170,152,139,8,5,18
S01012185,626,429,334,26,69,197,193,85,53,6,26,108,154,111,82,7,22,43,79,66,54,6,6,13,58,53,49,2,2,5,142,114,96,5,13,28
S01012186,593,310,257,18,35,283,233,56,45,6,5,177,142,89,70,5,14,53,72,54,44,4,6,18,64,49,44,0,5,15,82,62,54,3,5,20
S01012187,584,344,285,11,48,240,230,81,63,3,15,149,158,105,80,4,21,53,67,50,47,3,0,17,65,59,52,1,6,6,64,49,43,0,6,15
S01012188,506,283,244,21,18,223,163,45,35,6,4,118,118,78,70,4,4,40,68,53,46,4,3,15,49,35,31,2,2,14,108,72,62,5,5,36
S01012189,469,323,291,20,12,146,119,38,29,4,5,81,111,79,71,6,2,32,73,62,58,2,2,11,60,51,45,5,1,9,106,93,88,3,2,13
S01012190,402,330,300,23,7,72,61,29,24,4,1,32,79,63,54,8,1,16,65,60,55,3,2,5,47,43,36,5,2,4,150,135,131,3,1,15
S01012191,718,505,440,42,23,213,128,50,39,8,3,78,153,113,96,12,5,40,137,115,96,9,10,22,91,77,69,6,2,14,209,150,140,7,3,59
S01012192,426,279,236,30,13,147,81,27,23,4,0,54,105,70,57,9,4,35,77,53,44,5,4,24,49,43,37,4,2,6,114,86,75,8,3,28
S01012193,427,371,323,31,17,56,46,26,24,2,0,20,97,81,63,9,9,16,92,83,71,6,6,9,62,58,50,7,1,4,130,123,115,7,1,7
S01012194,427,344,311,14,19,83,28,16,14,1,1,12,112,87,77,5,5,25,117,91,82,4,5,26,56,44,40,1,3,12,114,106,98,3,5,8
S01012195,899,648,576,38,34,251,161,49,39,7,3,112,222,168,146,11,11,54,160,132,119,6,7,28,113,92,77,9,6,21,243,207,195,5,7,36
S01012196,438,350,305,33,12,88,68,30,24,6,0,38,99,72,60,6,6,27,82,72,67,5,0,10,56,50,40,6,4,6,133,126,114,10,2,7
S01012197,579,346,295,19,32,233,184,40,33,2,5,144,153,115,98,6,11,38,88,68,60,1,7,20,63,47,44,1,2,16,91,76,60,9,7,15
S01012198,770,461,409,33,19,309,255,64,59,5,0,191,159,110,91,8,11,49,122,93,85,6,2,29,89,72,65,5,2,17,145,122,109,9,4,23
S01012199,602,389,340,14,35,213,199,77,67,4,6,122,170,118,101,3,14,52,93,79,65,3,11,14,55,40,38,1,1,15,85,75,69,3,3,10
S01012200,516,323,270,23,30,193,164,54,42,4,8,110,124,79,58,9,12,45,73,58,50,3,5,15,57,49,41,4,4,8,98,83,79,3,1,15
S01012201,610,378,338,23,17,232,186,59,49,7,3,127,172,118,106,4,8,54,107,84,76,7,1,23,55,48,43,1,4,7,90,69,64,4,1,21
S01012202,473,310,282,16,12,163,118,40,37,2,1,78,138,96,86,5,5,42,59,43,39,2,2,16,55,42,37,5,0,13,103,89,83,2,4,14
S01012203,676,439,380,36,23,237,177,57,42,11,4,120,133,91,72,9,10,42,108,85,71,7,7,23,81,60,56,3,1,21,177,146,139,6,1,31
S01012204,662,511,444,42,25,151,98,48,38,5,5,50,160,123,101,14,8,37,140,107,98,5,4,33,75,71,62,7,2,4,189,162,145,11,6,27
S01012205,572,418,351,52,15,154,91,35,25,10,0,56,131,98,81,13,4,33,100,81,68,7,6,19,66,59,50,7,2,7,184,145,127,15,3,39
S01012206,682,528,467,36,25,154,138,60,50,5,5,78,174,139,121,7,11,35,138,119,107,8,4,19,91,85,69,12,4,6,141,125,120,4,1,16
S01012207,724,425,374,27,24,299,220,60,53,4,3,160,214,146,127,6,13,68,106,86,72,8,6,20,87,63,59,3,1,24,97,70,63,6,1,27
S01012208,830,500,425,42,33,330,257,80,65,10,5,177,213,149,127,10,12,64,119,87,69,12,6,32,113,84,76,3,5,29,128,100,88,7,5,28
S01012209,588,376,304,32,40,212,183,61,39,14,8,122,146,102,75,4,23,44,94,77,73,1,3,17,80,72,64,4,4,8,85,64,53,9,2,21
S01012210,647,346,307,16,23,301,233,45,39,2,4,188,158,105,85,7,13,53,85,64,59,3,2,21,88,69,64,2,3,19,83,63,60,2,1,20
S01012211,739,477,397,42,38,262,181,49,38,7,4,132,158,117,89,8,20,41,110,81,66,10,5,29,95,76,64,6,6,19,195,154,140,11,3,41
S01012212,665,406,357,24,25,259,109,27,21,3,3,82,135,84,69,9,6,51,111,77,66,4,7,34,81,59,52,0,7,22,229,159,149,8,2,70
S01012213,707,454,402,34,18,253,113,42,35,5,2,71,141,95,82,9,4,46,118,85,76,3,6,33,106,79,70,6,3,27,229,153,139,11,3,76
S01012214,567,341,280,49,12,226,87,32,29,3,0,55,95,53,41,9,3,42,98,74,59,12,3,24,70,38,31,5,2,32,217,144,120,20,4,73
S01012215,722,505,452,33,20,217,97,35,24,7,4,62,159,98,86,6,6,61,131,99,97,0,2,32,93,71,60,7,4,22,242,202,185,13,4,40
S01012216,586,405,351,40,14,181,80,29,24,4,1,51,107,72,56,9,7,35,115,87,77,9,1,28,77,58,53,4,1,19,207,159,141,14,4,48
S01012217,440,270,214,13,43,170,152,52,36,3,13,100,125,89,67,3,19,36,46,40,33,2,5,6,67,52,45,4,3,15,50,37,33,1,3,13
S01012218,354,232,169,8,55,122,124,60,41,0,19,64,121,83,62,4,17,38,41,33,25,2,6,8,31,26,23,0,3,5,37,30,18,2,10,7
S01012219,721,354,296,17,41,367,345,81,66,4,11,264,171,121,99,5,17,50,92,68,61,2,5,24,52,40,32,2,6,12,61,44,38,4,2,17
S01012220,544,275,218,17,40,269,255,70,51,4,15,185,137,87,62,5,20,50,46,40,38,0,2,6,42,30,29,1,0,12,64,48,38,7,3,16
S01012221,546,282,238,17,27,264,252,64,55,4,5,188,129,93,73,6,14,36,70,52,44,4,4,18,40,33,28,1,4,7,55,40,38,2,0,15
S01012222,685,366,326,20,20,319,306,87,74,4,9,219,161,115,102,4,9,46,67,51,46,5,0,16,76,61,57,2,2,15,75,52,47,5,0,23
S01012223,584,320,268,16,36,264,253,75,56,9,10,178,167,112,91,3,18,55,52,44,40,0,4,8,54,47,45,0,2,7,58,42,36,4,2,16
S01012224,589,386,336,22,28,203,201,71,61,5,5,130,164,126,105,7,14,38,77,65,57,4,4,12,70,58,52,3,3,12,77,66,61,3,2,11
S01012225,817,514,431,32,51,303,273,92,77,5,10,181,246,184,149,13,22,62,105,86,69,5,12,19,78,61,54,4,3,17,115,91,82,5,4,24
S01012226,580,383,325,27,31,197,165,57,47,9,1,108,179,140,116,7,17,39,90,76,63,5,8,14,56,43,39,2,2,13,90,67,60,4,3,23
S01012227,527,343,304,13,26,184,149,58,54,3,1,91,145,108,90,4,14,37,86,66,59,1,6,20,81,63,58,3,2,18,66,48,43,2,3,18
S01012228,542,361,324,17,20,181,139,60,54,1,5,79,164,118,103,8,7,46,104,75,66,3,6,29,53,45,42,2,1,8,82,63,59,3,1,19
S01012229,580,430,363,37,30,150,104,42,31,6,5,62,117,85,74,2,9,32,96,74,58,7,9,22,60,53,43,7,3,7,203,176,157,15,4,27
S01012230,735,514,447,47,20,221,120,34,29,3,2,86,130,100,82,13,5,30,147,101,85,9,7,46,86,71,66,3,2,15,252,208,185,19,4,44
S01012231,645,457,372,65,20,188,61,22,18,4,0,39,112,76,55,15,6,36,136,95,78,10,7,41,66,53,47,4,2,13,270,211,174,32,5,59
S01012232,674,473,405,47,21,201,70,26,20,5,1,44,130,73,55,12,6,57,124,88,77,4,7,36,77,64,55,5,4,13,273,222,198,21,3,51
S01012233,753,501,424,55,22,252,71,31,25,6,0,40,126,81,64,11,6,45,129,88,82,3,3,41,94,71,60,8,3,23,333,230,193,27,10,103
S01012234,843,614,506,74,34,229,91,26,19,6,1,65,158,97,68,16,13,61,148,112,92,12,8,36,102,88,74,11,3,14,344,291,253,29,9,53
S01012235,407,210,174,33,3,197,67,14,11,3,0,53,72,37,32,5,0,35,76,49,40,7,2,27,42,23,22,1,0,19,150,87,69,17,1,63
S01012236,500,310,255,36,19,190,137,37,28,5,4,100,108,67,54,7,6,41,76,60,51,4,5,16,39,33,30,3,0,6,140,113,92,17,4,27
S01012237,635,390,300,66,24,245,67,21,10,8,3,46,78,43,28,7,8,35,103,65,51,10,4,38,64,42,34,5,3,22,323,219,177,36,6,104
S01012238,509,308,247,34,27,201,142,39,27,6,6,103,115,73,53,8,12,42,69,46,41,1,4,23,59,44,36,6,2,15,124,106,90,13,3,18
S01012239,485,288,226,25,37,197,147,48,41,2,5,99,130,88,61,7,20,42,68,45,36,3,6,23,53,43,37,4,2,10,87,64,51,9,4,23
S01012240,701,383,317,36,30,318,219,57,49,2,6,162,145,85,60,10,15,60,108,76,66,8,2,32,58,43,34,5,4,15,171,122,108,11,3,49
S01012241,444,268,202,55,11,176,46,14,7,6,1,32,44,17,13,1,3,27,58,30,22,7,1,28,43,31,17,12,2,12,253,176,143,29,4,77
S01012242,639,399,318,63,18,240,58,20,12,8,0,38,96,54,43,5,6,42,108,66,57,6,3,42,71,51,41,9,1,20,306,208,165,35,8,98
S01012243,485,309,249,44,16,176,64,26,19,4,3,38,89,53,43,5,5,36,75,54,48,4,2,21,58,37,29,6,2,21,199,139,110,25,4,60
S01012244,749,519,364,139,16,230,104,32,18,11,3,72,105,76,49,22,5,29,74,55,36,18,1,19,62,49,39,8,2,13,404,307,222,80,5,97
S01012245,587,350,269,65,16,237,108,37,25,7,5,71,75,42,29,9,4,33,77,52,41,9,2,25,43,26,20,5,1,17,284,193,154,35,4,91
S01012246,581,408,310,84,14,173,59,24,16,6,2,35,86,60,38,17,5,26,75,47,32,13,2,28,43,33,26,5,2,10,318,244,198,43,3,74
S01012247,613,413,323,79,11,200,93,26,17,8,1,67,95,62,48,12,2,33,80,55,42,12,1,25,57,48,37,9,2,9,288,222,179,38,5,66
S01012248,656,470,313,136,21,186,121,63,33,24,6,58,136,95,58,28,9,41,99,67,48,17,2,32,59,46,27,17,2,13,241,199,147,50,2,42
S01012249,694,488,317,148,23,206,116,51,28,21,2,65,126,90,58,24,8,36,119,91,58,27,6,28,49,41,32,9,0,8,284,215,141,67,7,69
S01012250,563,397,276,108,13,166,100,42,21,18,3,58,90,67,48,17,2,23,89,63,40,21,2,26,66,60,37,23,0,6,218,165,130,29,6,53
S01012251,780,499,393,58,48,281,262,101,64,10,27,161,186,138,100,24,14,48,114,91,77,9,5,23,51,44,41,3,0,7,167,125,111,12,2,42
S01012252,566,389,302,55,32,177,151,67,46,6,15,84,121,85,61,13,11,36,103,84,64,17,3,19,52,37,31,5,1,15,139,116,100,14,2,23
S01012253,789,469,373,70,26,320,235,75,54,16,5,160,166,116,90,15,11,50,104,83,66,10,7,21,53,39,36,3,0,14,231,156,127,26,3,75
S01012254,700,460,365,69,26,240,158,53,34,14,5,105,139,98,74,16,8,41,89,65,53,8,4,24,75,59,49,7,3,16,239,185,155,24,6,54
S01012255,815,436,337,74,25,379,147,41,30,6,5,106,161,98,71,20,7,63,108,67,55,10,2,41,67,40,28,8,4,27,332,190,153,30,7,142
S01012256,671,454,370,65,19,217,90,31,26,5,0,59,140,93,73,10,10,47,132,102,84,12,6,30,57,38,30,7,1,19,252,190,157,31,2,62
S01012257,764,503,422,50,31,261,219,106,87,12,7,113,156,111,85,12,14,45,88,73,64,5,4,15,60,48,39,7,2,12,241,165,147,14,4,76
S01012258,585,331,268,51,12,254,70,22,16,6,0,48,85,37,29,7,1,48,74,43,34,7,2,31,47,27,23,4,0,20,309,202,166,27,9,107
S01012259,518,273,205,55,13,245,61,23,11,8,4,38,79,35,28,6,1,44,77,52,39,10,3,25,29,13,10,3,0,16,272,150,117,28,5,122
S01012260,713,392,305,67,20,321,197,58,44,9,5,139,152,96,73,16,7,56,90,65,48,15,2,25,35,25,22,3,0,10,239,148,118,24,6,91
S01012261,632,455,377,63,15,177,44,19,15,2,2,25,124,77,63,7,7,47,96,73,59,12,2,23,64,51,44,6,1,13,304,235,196,36,3,69
S01012262,653,449,303,130,16,204,103,43,25,17,1,60,141,96,59,36,1,45,79,61,41,15,5,18,69,59,47,10,2,10,261,190,131,52,7,71
S01012263,596,407,294,74,39,189,186,91,59,19,13,95,142,115,81,24,10,27,84,67,51,8,8,17,56,43,33,7,3,13,128,91,70,16,5,37
S01012264,385,221,174,34,13,164,92,31,25,3,3,61,75,45,30,8,7,30,54,35,25,8,2,19,24,15,15,0,0,9,140,95,79,15,1,45
S01012265,638,396,320,45,31,242,256,93,69,15,9,163,188,148,123,10,15,40,65,48,39,8,1,17,50,41,37,3,1,9,79,66,52,9,5,13
S01012266,904,512,413,76,23,392,270,44,33,8,3,226,188,119,92,18,9,69,127,100,85,13,2,27,74,58,51,7,0,16,245,191,152,30,9,54
S01012267,596,370,278,80,12,226,113,33,24,8,1,80,100,73,55,13,5,27,97,69,44,23,2,28,43,30,26,4,0,13,243,165,129,32,4,78
S01012268,504,357,239,105,13,147,92,37,21,14,2,55,95,62,38,21,3,33,78,63,44,16,3,15,55,48,29,17,2,7,184,147,107,37,3,37
S01012269,830,519,409,88,22,311,244,86,60,18,8,158,168,120,89,28,3,48,114,91,71,14,6,23,87,71,60,11,0,16,217,151,129,17,5,66
S01012270,626,397,320,53,24,229,206,63,49,9,5,143,160,124,98,16,10,36,87,67,54,7,6,20,39,34,29,5,0,5,134,109,90,16,3,25
S01012271,817,603,409,167,27,214,136,70,34,31,5,66,164,126,81,37,8,38,115,89,58,26,5,26,72,63,41,21,1,9,330,255,195,52,8,75
S01012272,569,384,296,69,19,185,106,38,27,9,2,68,95,59,44,9,6,36,100,73,53,17,3,27,50,39,37,1,1,11,218,175,135,33,7,43
S01012273,592,381,302,60,19,211,114,36,25,11,0,78,114,77,59,8,10,37,85,68,52,14,2,17,73,57,43,10,4,16,206,143,123,17,3,63
S01012274,763,551,446,67,38,212,166,80,66,10,4,86,194,144,112,18,14,50,105,88,68,12,8,17,81,64,55,6,3,17,217,175,145,21,9,42
S01012275,724,517,422,42,53,207,150,64,44,10,10,86,165,129,103,5,21,36,148,119,101,8,10,29,99,76,64,5,7,23,162,129,110,14,5,33
S01012276,807,524,433,55,36,283,210,63,38,13,12,147,180,136,113,14,9,44,117,102,89,8,5,15,78,62,53,7,2,16,222,161,140,13,8,61
S01012277,842,595,474,73,48,247,200,81,59,11,11,119,237,182,137,22,23,55,142,124,99,18,7,18,79,70,59,7,4,9,184,138,120,15,3,46
S01012278,649,376,302,35,39,273,184,45,38,1,6,139,134,94,70,13,11,40,81,60,46,4,10,21,70,55,47,2,6,15,180,122,101,15,6,58
S01012279,639,428,368,26,34,211,154,52,39,6,7,102,163,121,96,10,15,42,80,65,59,4,2,15,87,63,57,2,4,24,155,127,117,4,6,28
S01012280,764,526,426,44,56,238,237,106,79,6,21,131,226,170,137,16,17,56,114,94,74,7,13,20,85,71,63,6,2,14,102,85,73,9,3,17
S01012281,617,420,357,40,23,197,169,51,40,6,5,118,154,131,112,8,11,23,90,74,56,13,5,16,63,57,54,3,0,6,141,107,95,10,2,34
S01012282,978,504,391,65,48,474,242,55,39,12,4,187,178,102,78,19,5,76,203,123,83,13,27,80,95,65,52,7,6,30,260,159,139,14,6,101
S01012283,713,469,367,71,31,244,148,50,31,12,7,98,147,105,77,13,15,42,121,88,67,16,5,33,68,58,47,10,1,10,229,168,145,20,3,61
S01012284,669,403,305,40,58,266,236,76,55,9,12,160,162,114,76,13,25,48,78,62,52,6,4,16,69,53,44,4,5,16,124,98,78,8,12,26
S01012285,487,272,226,32,14,215,136,44,35,5,4,92,91,55,43,7,5,36,65,42,37,4,1,23,46,40,32,6,2,6,149,91,79,10,2,58
S01012286,879,518,411,49,58,361,280,108,87,9,12,172,262,183,138,15,30,79,117,82,72,4,6,35,67,46,39,3,4,21,153,99,75,18,6,54
S01012287,764,452,336,37,79,312,279,97,60,9,28,182,227,160,121,12,27,67,75,56,47,2,7,19,64,52,39,5,8,12,119,87,69,9,9,32
S01012288,623,402,287,29,86,221,264,134,95,9,30,130,174,137,81,11,45,37,70,56,46,3,7,14,43,33,29,2,2,10,72,42,36,4,2,30
S01012289,740,371,268,91,12,369,148,30,22,6,2,118,85,50,37,12,1,35,86,51,33,15,3,35,57,34,26,4,4,23,364,206,150,54,2,158
S01012290,475,276,216,38,22,199,116,32,24,6,2,84,103,73,54,9,10,30,62,40,29,8,3,22,32,27,22,5,0,5,162,104,87,10,7,58
S01012291,734,505,412,67,26,229,111,32,23,6,3,79,140,98,79,11,8,42,95,69,57,8,4,26,66,59,53,4,2,7,322,247,200,38,9,75
S01012292,625,305,214,85,6,320,133,24,13,11,0,109,81,44,29,14,1,37,70,42,29,12,1,28,41,29,20,8,1,12,300,166,123,40,3,134
S01012293,380,241,205,26,10,139,72,28,20,5,3,44,104,67,57,7,3,37,55,32,25,7,0,23,34,28,25,2,1,6,115,86,78,5,3,29
S01012294,704,481,415,41,25,223,182,71,60,8,3,111,177,141,118,13,10,36,109,82,68,8,6,27,93,80,75,3,2,13,143,107,94,9,4,36
S01012295,569,423,345,55,23,146,94,32,23,5,4,62,149,111,80,17,14,38,100,81,64,15,2,19,58,54,46,7,1,4,168,145,132,11,2,23
S01012296,631,488,394,83,11,143,96,44,32,12,0,52,119,96,74,19,3,23,98,84,65,16,3,14,69,58,48,10,0,11,249,206,175,26,5,43
S01012297,476,337,201,126,10,139,88,32,12,20,0,56,94,72,40,27,5,22,71,52,29,23,0,19,45,41,20,17,4,4,178,140,100,39,1,38
S01012298,679,434,335,82,17,245,166,50,34,14,2,116,126,90,61,26,3,36,103,78,66,11,1,25,75,56,39,11,6,19,209,160,135,20,5,49
S01012299,506,364,262,91,11,142,108,47,27,19,1,61,108,76,55,14,7,32,73,60,43,15,2,13,41,35,24,11,0,6,176,146,113,32,1,30
S01012300,538,321,235,68,18,217,195,83,59,17,7,112,122,84,58,19,7,38,69,47,38,7,2,22,41,28,23,5,0,13,111,79,57,20,2,32
S01012301,788,508,349,134,25,280,177,80,45,27,8,97,178,121,87,26,8,57,118,87,57,27,3,31,60,47,31,13,3,13,255,173,129,41,3,82
S01012302,483,310,197,94,19,173,89,30,19,8,3,59,129,80,58,18,4,49,62,42,25,14,3,20,54,42,27,12,3,12,149,116,68,42,6,33
S01012303,720,494,318,154,22,226,142,76,48,25,3,66,134,95,63,27,5,39,98,67,38,23,6,31,70,54,36,17,1,16,276,202,133,62,7,74
S01012304,789,513,365,125,23,276,208,96,62,31,3,112,181,126,94,20,12,55,92,70,46,23,1,22,74,61,42,17,2,13,234,160,121,34,5,74
S01012305,592,328,246,62,20,264,167,51,37,11,3,116,144,101,74,20,7,43,78,47,33,9,5,31,44,29,21,8,0,15,159,100,81,14,5,59
S01012306,486,258,215,32,11,228,188,52,45,5,2,136,124,91,84,6,1,33,49,39,25,9,5,10,34,22,15,5,2,12,91,54,46,7,1,37
S01012307,533,313,252,41,20,220,182,72,61,7,4,110,122,88,72,8,8,34,63,42,33,4,5,21,43,31,28,1,2,12,123,80,58,21,1,43
S01012308,677,449,390,44,15,228,210,91,80,8,3,119,161,123,104,15,4,38,124,96,82,10,4,28,58,47,43,4,0,11,124,92,81,7,4,32
S01012309,465,264,202,53,9,201,133,38,25,12,1,95,126,98,74,19,5,28,46,29,24,3,2,17,31,25,20,4,1,6,129,74,59,15,0,55
S01012310,778,475,300,156,19,303,197,71,39,31,1,126,196,142,87,45,10,54,104,76,51,25,0,28,46,33,23,7,3,13,235,153,100,48,5,82
S01012311,494,246,187,43,16,248,131,32,20,11,1,99,107,66,52,6,8,41,67,53,43,7,3,14,34,19,15,4,0,15,155,76,57,15,4,79
S01012312,870,543,351,171,21,327,216,88,62,21,5,128,242,160,99,51,10,82,112,79,49,27,3,33,72,54,33,20,1,18,228,162,108,52,2,66
S01012313,643,423,309,91,23,220,160,65,45,17,3,95,140,97,67,23,7,43,102,78,62,12,4,24,66,50,32,14,4,16,175,133,103,25,5,42
S01012314,673,406,328,51,27,267,260,101,79,13,9,159,188,135,106,14,15,53,90,73,60,11,2,17,43,37,30,7,0,6,92,60,53,6,1,32
S01012315,663,335,237,64,34,328,269,73,46,18,9,196,161,111,84,16,11,50,73,46,31,9,6,27,37,29,21,6,2,8,123,76,55,15,6,47
S01012316,517,290,235,29,26,227,215,79,62,13,4,136,135,97,73,11,13,38,60,46,40,2,4,14,31,23,20,0,3,8,76,45,40,3,2,31
S01012317,406,256,199,40,17,150,93,34,22,5,7,59,121,81,59,18,4,40,50,35,30,3,2,15,34,29,27,2,0,5,108,77,61,12,4,31
S01012318,646,411,344,39,28,235,204,86,69,14,3,118,219,158,130,13,15,61,90,72,58,6,8,18,40,32,31,0,1,8,93,63,56,6,1,30
S01012319,642,434,309,111,14,208,134,61,45,13,3,73,162,107,90,16,1,55,97,75,41,27,7,22,56,45,29,16,0,11,193,146,104,39,3,47
S01012320,554,349,281,44,24,205,228,98,79,12,7,130,153,111,86,14,11,42,54,42,36,5,1,12,41,38,32,4,2,3,78,60,48,9,3,18
S01012321,623,354,260,57,37,269,182,53,34,13,6,129,178,118,89,13,16,60,82,55,44,9,2,27,47,38,25,7,6,9,134,90,68,15,7,44
S01012322,833,512,330,159,23,321,194,69,49,18,2,125,186,127,81,35,11,59,98,71,46,21,4,27,66,48,29,18,1,18,289,197,125,67,5,92
S01012323,763,435,282,132,21,328,199,67,39,28,0,132,159,94,59,29,6,65,86,66,45,17,4,20,53,41,21,16,4,12,266,167,118,42,7,99
S01012324,692,402,253,129,20,290,201,74,45,24,5,127,163,99,62,35,2,64,81,56,40,13,3,25,50,37,19,15,3,13,197,136,87,42,7,61
S01012325,533,213,175,22,16,320,223,54,45,4,5,169,107,58,44,8,6,49,55,32,27,3,2,23,34,20,17,1,2,14,114,49,42,6,1,65
S01012326,489,263,190,42,31,226,155,48,29,10,9,107,137,92,75,8,9,45,62,46,32,9,5,16,33,19,13,2,4,14,102,58,41,13,4,44
S01012327,659,389,306,55,28,270,230,95,67,20,8,135,174,125,96,16,13,49,84,61,51,7,3,23,50,38,33,3,2,12,121,70,59,9,2,51
S01012328,489,225,160,51,14,264,136,36,26,7,3,100,97,55,43,7,5,42,51,36,22,12,2,15,42,26,16,8,2,16,163,72,53,17,2,91
S01012329,694,412,259,133,20,282,166,65,43,20,2,101,150,93,49,36,8,57,102,73,52,17,4,29,55,44,19,23,2,11,221,137,96,37,4,84
S01012330,508,284,219,51,14,224,139,55,40,12,3,84,110,76,54,15,7,34,53,32,24,7,1,21,48,30,23,5,2,18,158,91,78,12,1,67
S01012331,492,353,297,45,11,139,102,46,34,9,3,56,106,80,65,13,2,26,71,62,52,9,1,9,58,43,35,7,1,15,155,122,111,7,4,33
S01012332,830,563,379,159,25,267,166,75,49,22,4,91,185,133,95,31,7,52,134,101,69,27,5,33,74,64,43,18,3,10,271,190,123,61,6,81
S01012333,817,501,334,138,29,316,207,76,50,20,6,131,157,104,68,29,7,53,111,79,57,20,2,32,82,62,45,16,1,20,260,180,114,53,13,80
S01012334,711,403,320,55,28,308,303,107,88,12,7,196,186,121,92,18,11,65,84,67,49,10,8,17,44,40,34,6,0,4,94,68,57,9,2,26
S01012335,799,590,516,49,25,209,225,112,99,9,4,113,235,185,166,12,7,50,119,104,88,11,5,15,81,69,57,9,3,12,139,120,106,8,6,19
S01012336,512,298,260,30,8,214,240,81,72,8,1,159,119,91,81,7,3,28,61,44,37,7,0,17,36,34,29,3,2,2,56,48,41,5,2,8
S01012337,748,405,315,44,46,343,314,99,68,12,19,215,174,116,88,9,19,58,86,65,53,9,3,21,45,34,30,3,1,11,129,91,76,11,4,38
S01012338,631,350,273,55,22,281,212,61,43,12,6,151,117,68,50,8,10,49,93,70,60,9,1,23,44,35,24,9,2,9,165,116,96,17,3,49
S01012339,525,305,236,37,32,220,142,30,18,5,7,112,103,72,56,7,9,31,79,59,48,6,5,20,53,44,34,4,6,9,148,100,80,15,5,48
S01012340,830,482,378,74,30,348,213,87,62,18,7,126,195,132,105,18,9,63,134,97,83,8,6,37,66,47,36,7,4,19,222,119,92,23,4,103
S01012341,796,570,343,203,24,226,138,70,43,24,3,68,205,156,91,57,8,49,121,99,62,30,7,22,97,78,42,32,4,19,235,167,105,60,2,68
S01012342,786,464,335,112,17,322,215,56,34,16,6,159,174,124,93,25,6,50,100,76,51,24,1,24,76,64,51,11,2,12,221,144,106,36,2,77
S01012343,821,543,357,158,28,278,175,78,51,23,4,97,191,133,93,30,10,58,124,98,59,31,8,26,71,62,41,17,4,9,260,172,113,57,2,88
S01012344,483,335,264,37,34,148,145,58,39,10,9,87,117,97,73,8,16,20,69,56,47,3,6,13,46,40,34,6,0,6,106,84,71,10,3,22
S01012345,586,381,307,56,18,205,174,63,47,15,1,111,140,110,88,12,10,30,94,70,54,13,3,24,55,43,38,4,1,12,123,95,80,12,3,28
S01012346,708,425,287,125,13,283,141,45,31,14,0,96,136,87,52,30,5,49,107,77,48,26,3,30,74,60,43,16,1,14,250,156,113,39,4,94
S01012347,639,391,309,56,26,248,187,59,51,5,3,128,147,112,83,15,14,35,84,66,50,13,3,18,53,43,35,6,2,10,168,111,90,17,4,57
S01012348,587,333,256,63,14,254,129,39,25,8,6,90,111,68,53,9,6,43,67,52,42,10,0,15,48,35,30,5,0,13,232,139,106,31,2,93
S01012349,746,463,384,47,32,283,302,120,99,14,7,182,203,151,124,15,12,52,100,80,73,5,2,20,61,51,41,4,6,10,80,61,47,9,5,19
S01012350,625,352,279,57,16,273,187,58,41,13,4,129,185,127,109,14,4,58,70,46,32,13,1,24,60,44,37,5,2,16,123,77,60,12,5,46
S01012351,674,433,357,48,28,241,226,80,67,10,3,146,207,155,125,14,16,52,88,73,64,8,1,15,56,45,37,6,2,11,97,80,64,10,6,17
S01012352,630,361,275,67,19,269,212,55,36,15,4,157,173,128,96,23,9,45,83,60,43,12,5,23,52,44,36,7,1,8,110,74,64,10,0,36
S01012353,670,407,312,55,40,263,211,73,51,9,13,138,160,111,79,18,14,49,94,68,56,10,2,26,60,51,44,3,4,9,145,104,82,15,7,41
S01012354,668,354,260,77,17,314,268,81,55,23,3,187,158,114,76,28,10,44,63,52,42,9,1,11,32,22,19,2,1,10,147,85,68,15,2,62
S01012355,768,505,305,187,13,263,183,85,44,39,2,98,187,126,72,52,2,61,115,86,50,34,2,29,61,47,32,15,0,14,222,161,107,47,7,61
S01012356,555,306,231,66,9,249,164,55,33,18,4,109,122,83,60,22,1,39,77,55,46,8,1,22,43,29,23,4,2,14,149,84,69,14,1,65
S01012357,740,467,291,160,16,273,168,69,37,30,2,99,146,89,42,43,4,57,108,87,51,33,3,21,72,59,40,15,4,13,246,163,121,39,3,83
S01012358,680,409,234,161,14,271,174,68,39,24,5,106,152,87,43,40,4,65,107,86,52,32,2,21,51,40,22,18,0,11,196,128,78,47,3,68
S01012359,619,357,287,27,43,262,294,119,93,9,17,175,168,117,89,11,17,51,56,45,41,1,3,11,37,32,28,1,3,5,64,44,36,5,3,20
S01012360,590,375,286,30,59,215,228,103,81,8,14,125,182,135,95,11,29,47,65,53,47,2,4,12,46,34,29,1,4,12,69,50,34,8,8,19
S01012361,487,290,210,29,51,197,207,83,55,10,18,124,145,99,72,6,21,46,52,45,36,4,5,7,37,29,22,3,4,8,46,34,25,6,3,12
S01012362,579,357,277,32,48,222,221,105,76,10,19,116,179,119,88,12,19,60,66,48,41,4,3,18,52,40,33,4,3,12,61,45,39,2,4,16
S01012363,845,466,345,57,64,379,310,88,61,15,12,222,195,142,103,12,27,53,116,92,76,9,7,24,78,55,39,7,9,23,146,89,66,14,9,57
S01012364,595,352,283,36,33,243,236,81,63,8,10,155,122,88,67,9,12,34,95,72,60,10,2,23,43,32,29,2,1,11,99,79,64,7,8,20
S01012365,792,510,433,61,16,282,263,77,67,9,1,186,183,140,110,23,7,43,140,122,104,15,3,18,61,51,46,4,1,10,145,120,106,10,4,25
S01012366,783,468,380,54,34,315,309,100,81,13,6,209,164,128,101,10,17,36,112,91,78,11,2,21,60,48,41,4,3,12,138,101,79,16,6,37
S01012367,787,466,400,44,22,321,291,96,85,5,6,195,179,125,106,13,6,54,117,87,75,9,3,30,68,57,49,4,4,11,132,101,85,13,3,31
S01012368,531,295,233,45,17,236,177,42,32,7,3,135,103,71,59,10,2,32,68,54,42,8,4,14,51,39,30,7,2,12,132,89,70,13,6,43
S01012369,726,438,343,75,20,288,250,82,59,19,4,168,168,115,91,21,3,53,116,94,78,12,4,22,45,38,27,7,4,7,147,109,88,16,5,38
S01012370,818,476,386,61,29,342,357,120,95,14,11,237,178,128,100,16,12,50,112,96,80,14,2,16,58,47,38,7,2,11,113,85,73,10,2,28
S01012371,813,447,366,45,36,366,331,81,67,7,7,250,192,138,101,17,20,54,91,74,66,7,1,17,89,69,61,3,5,20,110,85,71,11,3,25
S01012372,657,380,295,50,35,277,287,96,73,13,10,191,154,109,90,10,9,45,81,65,50,9,6,16,62,53,43,4,6,9,73,57,39,14,4,16
S01012373,848,503,408,54,41,345,309,119,95,13,11,190,204,134,110,9,15,70,111,93,70,15,8,18,71,59,50,6,3,12,153,98,83,11,4,55
S01012374,742,499,410,59,30,243,274,120,94,17,9,154,203,163,130,20,13,40,85,68,63,3,2,17,76,65,57,5,3,11,104,83,66,14,3,21
S01012375,755,485,399,36,50,270,303,119,98,10,11,184,216,163,133,9,21,53,89,75,62,7,6,14,71,63,55,2,6,8,76,65,51,8,6,11
S01012376,790,530,350,154,26,260,146,64,38,22,4,82,134,105,63,39,3,29,125,90,69,13,8,35,80,55,30,24,1,25,305,216,150,56,10,89
S01012377,608,379,258,117,4,229,98,42,28,13,1,56,122,82,53,29,0,40,75,52,36,15,1,23,52,38,29,8,1,14,261,165,112,52,1,96
S01012378,494,308,202,96,10,186,117,55,32,19,4,62,90,66,47,17,2,24,62,42,24,18,0,20,56,44,29,13,2,12,169,101,70,29,2,68
S01012379,427,254,171,71,12,173,76,25,14,11,0,51,91,57,40,14,3,34,55,36,22,12,2,19,38,29,20,9,0,9,167,107,75,25,7,60
S01012380,731,486,401,54,31,245,207,73,58,9,6,134,196,140,116,10,14,56,108,85,69,10,6,23,82,71,59,9,3,11,138,117,99,16,2,21
S01012381,713,374,306,46,22,339,298,85,66,12,7,213,146,96,81,8,7,50,92,65,59,5,1,27,65,47,32,11,4,18,112,81,68,10,3,31
S01012382,811,522,416,90,16,289,191,55,38,15,2,136,160,113,87,19,7,47,156,124,101,20,3,32,75,62,52,9,1,13,229,168,138,27,3,61
S01012383,734,406,340,52,14,328,268,72,57,7,8,196,128,94,84,8,2,34,108,81,63,15,3,27,63,54,48,5,1,9,167,105,88,17,0,62
S01012384,433,269,210,40,19,164,118,31,23,7,1,87,77,61,44,7,10,16,77,58,43,14,1,19,44,35,26,4,5,9,117,84,74,8,2,33
S01012385,595,422,326,72,24,173,123,56,34,16,6,67,136,97,80,10,7,39,84,66,53,10,3,18,59,53,38,10,5,6,193,150,121,26,3,43
S01012386,806,497,387,48,62,309,284,94,69,10,15,190,237,183,137,13,33,54,93,74,59,12,3,19,59,47,39,4,4,12,133,99,83,9,7,34
S01012387,755,543,452,79,12,212,154,63,47,16,0,91,207,169,138,21,10,38,103,94,80,12,2,9,65,50,45,5,0,15,226,167,142,25,0,59
S01012388,579,410,348,61,1,169,135,47,37,10,0,88,111,87,73,14,0,24,72,59,52,7,0,13,49,42,38,4,0,7,212,175,148,26,1,37
S01012389,661,501,433,56,12,160,145,70,54,12,4,75,171,136,114,17,5,35,93,80,73,7,0,13,62,54,48,6,0,8,190,161,144,14,3,29
S01012390,620,452,407,40,5,168,105,38,31,7,0,67,178,141,126,14,1,37,110,85,79,4,2,25,57,50,47,3,0,7,170,138,124,12,2,32
S01012391,785,614,539,59,16,171,99,42,29,11,2,57,199,152,136,12,4,47,131,111,90,17,4,20,85,76,70,4,2,9,271,233,214,15,4,38
S01012392,606,446,402,30,14,160,117,49,40,5,4,68,148,115,102,8,5,33,115,95,85,9,1,20,58,55,53,1,1,3,168,132,122,7,3,36
S01012393,728,537,467,65,5,191,143,61,50,11,0,82,205,160,139,19,2,45,103,90,77,11,2,13,66,58,53,5,0,8,211,168,148,19,1,43
S01012394,531,363,315,27,21,168,138,55,42,11,2,83,188,138,119,8,11,50,65,54,50,1,3,11,44,40,37,1,2,4,96,76,67,6,3,20
S01012395,514,357,310,38,9,157,137,50,43,5,2,87,116,92,74,14,4,24,67,62,56,6,0,5,47,40,34,4,2,7,147,113,103,9,1,34
S01012396,533,354,307,32,15,179,135,40,35,3,2,95,140,98,84,7,7,42,71,58,48,7,3,13,44,41,36,4,1,3,143,117,104,11,2,26
S01012397,730,481,400,60,21,249,174,63,52,7,4,111,176,139,110,19,10,37,85,67,54,10,3,18,61,49,44,4,1,12,234,163,140,20,3,71
S01012398,768,555,506,37,12,213,164,58,50,7,1,106,187,150,137,8,5,37,117,104,94,6,4,13,67,54,51,2,1,13,233,189,174,14,1,44
S01012399,505,348,330,14,4,157,146,57,54,2,1,89,131,101,92,7,2,30,63,53,51,2,0,10,54,44,43,1,0,10,111,93,90,2,1,18
S01012400,487,375,326,34,15,112,135,66,56,8,2,69,139,116,103,8,5,23,88,83,73,5,5,5,36,32,29,3,0,4,89,78,65,10,3,11
S01012401,662,499,443,28,28,163,200,101,82,9,10,99,198,164,141,11,12,34,75,67,63,1,3,8,76,69,66,3,0,7,113,98,91,4,3,15
S01012402,352,284,243,36,5,68,71,40,30,9,1,31,104,89,75,12,2,15,58,50,44,6,0,8,34,30,29,1,0,4,85,75,65,8,2,10
S01012403,860,663,546,106,11,197,203,95,74,19,2,108,202,173,140,29,4,29,121,114,96,16,2,7,71,58,51,6,1,13,263,223,185,36,2,40
S01012404,826,587,505,59,23,239,209,93,70,18,5,116,194,141,116,20,5,53,115,102,91,7,4,13,84,75,69,2,4,9,224,176,159,12,5,48
S01012405,554,432,368,60,4,122,84,44,35,8,1,40,155,122,98,24,0,33,90,75,64,9,2,15,55,50,46,4,0,5,170,141,125,15,1,29
S01012406,500,345,290,48,7,155,123,46,28,17,1,77,128,103,84,16,3,25,73,59,56,3,0,14,54,42,39,3,0,12,122,95,83,9,3,27
S01012407,639,475,398,62,15,164,141,65,50,13,2,76,181,140,113,19,8,41,105,87,73,12,2,18,49,46,40,5,1,3,163,137,122,13,2,26
S01012408,502,359,288,66,5,143,103,42,27,14,1,61,145,114,93,20,1,31,87,68,58,9,1,19,48,40,34,6,0,8,119,95,76,17,2,24
S01012409,563,390,312,66,12,173,136,43,24,16,3,93,130,107,93,10,4,23,98,78,64,12,2,20,43,40,35,5,0,3,156,122,96,23,3,34
S01012410,843,646,576,56,14,197,178,89,73,14,2,89,229,192,164,21,7,37,148,131,121,8,2,17,63,56,55,1,0,7,225,178,163,12,3,47
S01012411,763,569,500,45,24,194,163,79,66,11,2,84,246,201,178,13,10,45,132,107,97,6,4,25,81,67,61,3,3,14,141,115,98,12,5,26
S01012412,540,379,301,68,10,161,173,69,43,23,3,104,122,98,86,11,1,24,71,61,50,8,3,10,51,47,37,10,0,4,123,104,85,16,3,19
S01012413,794,494,432,55,7,300,236,68,54,13,1,168,207,163,143,18,2,44,85,67,59,6,2,18,51,43,38,4,1,8,215,153,138,14,1,62
S01012414,589,370,288,59,23,219,176,64,40,19,5,112,155,115,84,18,13,40,64,52,45,5,2,12,42,36,27,7,2,6,152,103,92,10,1,49
S01012415,451,284,207,68,9,167,150,45,25,16,4,105,121,96,76,18,2,25,47,35,29,5,1,12,39,33,25,7,1,6,94,75,52,22,1,19
S01012416,456,288,217,66,5,168,167,55,35,20,0,112,105,88,62,22,4,17,33,28,24,3,1,5,38,30,24,6,0,8,113,87,72,15,0,26
S01012417,544,277,200,64,13,267,190,58,30,27,1,132,125,82,63,15,4,43,67,45,37,4,4,22,54,32,25,6,1,22,108,60,45,12,3,48
S01012418,680,413,236,146,31,267,234,110,51,48,11,124,160,112,74,25,13,48,69,47,24,20,3,22,60,44,32,12,0,16,157,100,55,41,4,57
S01012419,678,372,215,129,28,306,242,81,35,43,3,161,157,103,58,32,13,54,73,50,27,17,6,23,54,40,25,13,2,14,152,98,70,24,4,54
S01012420,694,418,332,52,34,276,261,92,81,7,4,169,211,162,122,20,20,49,87,62,56,3,3,25,54,48,36,8,4,6,81,54,37,14,3,27
S01012421,629,382,278,79,25,247,206,83,62,18,3,123,143,108,72,22,14,35,74,47,32,12,3,27,64,49,42,5,2,15,142,95,70,22,3,47
S01012422,725,443,316,94,33,282,226,104,63,32,9,122,179,126,97,18,11,53,88,65,46,16,3,23,52,35,26,3,6,17,180,113,84,25,4,67
S01012423,696,423,310,85,28,273,195,65,37,21,7,130,143,92,68,20,4,51,121,95,71,16,8,26,71,57,41,11,5,14,166,114,93,17,4,52
S01012424,752,473,383,40,50,279,280,102,86,9,7,178,214,160,120,13,27,54,104,85,69,4,12,19,60,53,51,2,0,7,94,73,57,12,4,21
S01012425,497,210,176,16,18,287,240,52,40,6,6,188,134,83,71,4,8,51,44,29,25,3,1,15,41,24,22,1,1,17,38,22,18,2,2,16
S01012426,383,206,154,15,37,177,142,44,31,0,13,98,135,92,72,6,14,43,44,29,21,4,4,15,31,22,14,3,5,9,31,19,16,2,1,12
S01012427,523,289,234,16,39,234,220,68,54,3,11,152,176,133,101,8,24,43,55,37,33,1,3,18,29,23,22,1,0,6,43,28,24,3,1,15
S01012428,539,316,267,26,23,223,177,66,53,10,3,111,161,121,105,5,11,40,72,50,41,4,5,22,41,26,25,1,0,15,88,53,43,6,4,35
S01012429,466,228,184,22,22,238,160,32,24,3,5,128,110,70,52,8,10,40,72,44,36,5,3,28,50,36,32,3,1,14,74,46,40,3,3,28
S01012430,475,267,223,29,15,208,160,47,37,7,3,113,98,65,58,3,4,33,65,47,41,3,3,18,44,38,30,6,2,6,108,70,57,10,3,38
S01012431,790,413,290,93,30,377,281,74,49,22,3,207,160,102,76,15,11,58,96,70,49,13,8,26,66,50,35,13,2,16,187,117,81,30,6,70
S01012432,622,281,224,30,27,341,225,48,35,7,6,177,152,95,72,7,16,57,67,40,36,4,0,27,49,32,29,3,0,17,129,66,52,9,5,63
S01012433,440,253,206,29,18,187,169,46,39,4,3,123,111,84,69,7,8,27,56,42,34,5,3,14,41,34,27,4,3,7,63,47,37,9,1,16
S01012434,578,349,282,29,38,229,219,68,57,4,7,151,174,126,97,9,20,48,63,54,42,6,6,9,48,35,30,3,2,13,74,66,56,7,3,8
S01012435,527,328,253,32,43,199,206,81,59,7,15,125,151,106,81,10,15,45,65,54,43,4,7,11,52,44,35,7,2,8,53,43,35,4,4,10
S01012436,595,349,270,29,50,246,243,100,77,8,15,143,155,102,70,6,26,53,75,57,48,5,4,18,44,37,30,4,3,7,78,53,45,6,2,25
S01012437,616,370,301,34,35,246,245,92,74,10,8,153,133,100,78,11,11,33,92,69,57,3,9,23,62,50,43,6,1,12,84,59,49,4,6,25
S01012438,534,351,263,47,41,183,160,57,38,7,12,103,159,127,90,22,15,32,71,58,48,3,7,13,54,39,30,4,5,15,90,70,57,11,2,20
S01012439,645,341,266,33,42,304,204,53,32,11,10,151,170,107,84,6,17,63,87,62,51,5,6,25,54,40,35,2,3,14,130,79,64,9,6,51
S01012440,444,285,221,47,17,159,105,40,24,13,3,65,114,80,61,12,7,34,79,65,54,7,4,14,43,33,29,2,2,10,103,67,53,13,1,36
S01012441,764,482,340,120,22,282,191,90,55,31,4,101,154,103,67,32,4,51,115,79,51,20,8,36,79,59,43,13,3,20,225,151,124,24,3,74
S01012442,808,515,386,100,29,293,166,58,31,20,7,108,172,117,77,30,10,55,99,75,58,14,3,24,84,71,58,7,6,13,287,194,162,29,3,93
S01012443,616,423,319,81,23,193,136,56,32,19,5,80,152,121,92,19,10,31,88,68,54,10,4,20,72,58,40,17,1,14,168,120,101,16,3,48
S01012444,712,350,274,57,19,362,184,30,15,11,4,154,121,64,43,15,6,57,95,53,45,5,3,42,78,53,45,4,4,25,234,150,126,22,2,84
S01012445,403,280,208,54,18,123,56,20,9,7,4,36,57,37,31,2,4,20,54,37,28,7,2,17,37,31,29,2,0,6,199,155,111,36,8,44
S01012446,430,258,212,21,25,172,143,33,25,6,2,110,105,78,57,8,13,27,52,41,33,2,6,11,52,43,37,3,3,9,78,63,60,2,1,15
S01012447,725,470,389,59,22,255,167,65,42,17,6,102,147,97,84,8,5,50,117,86,68,12,6,31,96,82,72,8,2,14,198,140,123,14,3,58
S01012448,712,470,368,73,29,242,138,45,31,8,6,93,138,92,62,21,9,46,132,101,81,14,6,31,79,63,52,7,4,16,225,169,142,23,4,56
S01012449,482,329,276,34,19,153,145,50,39,5,6,95,105,76,60,7,9,29,73,63,54,7,2,10,69,62,54,6,2,7,90,78,69,9,0,12
S01012450,700,447,331,98,18,253,167,65,37,26,2,102,144,103,72,25,6,41,115,79,59,14,6,36,80,62,52,9,1,18,194,138,111,24,3,56
S01012451,787,330,250,64,16,457,136,19,13,5,1,117,124,55,39,11,5,69,107,59,44,12,3,48,73,34,27,7,0,39,347,163,127,29,7,184
S01012452,505,265,221,36,8,240,110,26,20,4,2,84,91,51,42,8,1,40,83,48,43,5,0,35,54,37,30,5,2,17,167,103,86,14,3,64
S01012453,699,392,299,75,18,307,98,16,9,7,0,82,92,52,33,15,4,40,89,55,42,8,5,34,71,50,40,9,1,21,349,219,175,36,8,130
S01012454,578,293,233,40,20,285,102,21,18,2,1,81,99,50,37,9,4,49,99,52,38,5,9,47,63,37,33,3,1,26,215,133,107,21,5,82
S01012455,498,256,180,65,11,242,78,27,12,14,1,51,75,35,23,9,3,40,64,34,24,8,2,30,51,31,21,9,1,20,230,129,100,25,4,101
S01012456,649,318,250,49,19,331,82,15,8,5,2,67,110,45,38,4,3,65,77,44,31,9,4,33,56,36,31,4,1,20,324,178,142,27,9,146
S01012457,757,338,261,60,17,419,110,18,10,8,0,92,94,41,26,12,3,53,131,61,48,9,4,70,61,34,25,7,2,27,361,184,152,24,8,177
S01012458,669,353,265,69,19,316,77,13,6,6,1,64,107,47,32,9,6,60,95,61,45,13,3,34,44,36,27,7,2,8,346,196,155,34,7,150
S01012459,584,405,346,41,18,179,107,39,28,8,3,68,142,101,83,12,6,41,95,73,62,6,5,22,56,45,41,2,2,11,184,147,132,13,2,37
S01012460,473,251,200,34,17,222,102,32,23,8,1,70,82,38,29,7,2,44,57,33,23,5,5,24,62,44,34,3,7,18,170,104,91,11,2,66
S01012461,450,283,238,26,19,167,164,55,39,11,5,109,102,69,60,5,4,33,57,49,40,4,5,8,34,30,26,0,4,4,93,80,73,6,1,13
S01012462,653,373,293,24,56,280,237,67,51,8,8,170,192,133,98,8,27,59,65,49,33,5,11,16,54,44,40,0,4,10,105,80,71,3,6,25
S01012463,480,291,225,30,36,189,171,65,50,5,10,106,130,87,64,9,14,43,66,51,38,7,6,15,43,35,29,3,3,8,70,53,44,6,3,17
S01012464,491,345,266,24,55,146,158,81,67,4,10,77,138,104,78,7,19,34,79,65,45,6,14,14,56,47,37,2,8,9,60,48,39,5,4,12
S01012465,566,350,288,26,36,216,192,89,71,9,9,103,166,109,86,7,16,57,67,45,41,2,2,22,58,52,42,3,7,6,83,55,48,5,2,28
S01012466,673,374,278,57,39,299,208,60,44,10,6,148,134,90,58,21,11,44,94,71,49,11,11,23,60,42,35,3,4,18,177,111,92,12,7,66
S01012467,562,333,267,38,28,229,181,56,47,3,6,125,150,98,72,13,13,52,64,43,33,7,3,21,74,62,50,8,4,12,93,74,65,7,2,19
S01012468,618,377,309,40,28,241,181,54,45,2,7,127,150,101,79,12,10,49,94,71,58,6,7,23,60,52,42,8,2,8,133,99,85,12,2,34
S01012469,676,362,281,65,16,314,116,16,10,6,0,100,88,41,33,7,1,47,95,60,48,10,2,35,60,42,33,6,3,18,317,203,157,36,10,114
S01012470,827,443,366,41,36,384,277,66,51,7,8,211,176,120,94,14,12,56,110,75,71,1,3,35,81,67,57,2,8,14,183,115,93,17,5,68
S01012471,732,390,283,95,12,342,123,27,16,10,1,96,119,66,41,19,6,53,95,62,44,17,1,33,61,44,35,8,1,17,334,191,147,41,3,143
S01012472,614,296,243,39,14,318,123,28,23,2,3,95,114,63,51,10,2,51,68,33,27,4,2,35,55,36,26,6,4,19,254,136,116,17,3,118
S01012473,470,284,241,31,12,186,91,26,21,5,0,65,89,55,44,7,4,34,75,50,42,4,4,25,46,36,32,4,0,10,169,117,102,11,4,52
S01012474,629,323,266,34,23,306,204,46,34,8,4,158,104,59,48,2,9,45,82,51,40,8,3,31,66,47,40,4,3,19,173,120,104,12,4,53
S01012475,558,286,244,26,16,272,143,26,19,5,2,117,117,69,56,5,8,48,56,35,30,3,2,21,66,46,39,4,3,20,176,110,100,9,1,66
S01012476,770,448,373,33,42,322,271,79,58,8,13,192,203,147,119,12,16,56,90,69,64,1,4,21,88,71,56,7,8,17,118,82,76,5,1,36
S01012477,571,370,326,27,17,201,89,30,22,7,1,59,123,81,70,5,6,42,103,77,63,8,6,26,82,57,54,1,2,25,174,125,117,6,2,49
S01012478,690,440,368,43,29,250,227,77,63,9,5,150,156,111,93,7,11,45,103,79,62,10,7,24,82,74,63,8,3,8,122,99,87,9,3,23
S01012479,554,409,339,53,17,145,80,39,28,9,2,41,119,83,67,14,2,36,101,79,67,8,4,22,88,71,59,8,4,17,166,137,118,14,5,29
S01012480,480,306,250,34,22,174,100,33,25,4,4,67,93,66,52,6,8,27,64,40,36,3,1,24,58,42,33,4,5,16,165,125,104,17,4,40
S01012481,714,471,362,49,60,243,162,56,36,7,13,106,139,87,65,7,15,52,114,86,59,9,18,28,91,70,53,8,9,21,208,172,149,18,5,36
S01012482,741,359,251,62,46,382,198,39,14,7,18,159,119,55,31,10,14,64,92,63,45,10,8,29,67,50,43,6,1,17,265,152,118,29,5,113
S01012483,811,434,338,40,56,377,259,61,43,8,10,198,157,102,73,5,24,55,106,74,60,6,8,32,104,86,75,5,6,18,185,111,87,16,8,74
S01012484,674,373,278,70,25,301,115,21,12,7,2,94,101,50,35,9,6,51,90,55,43,6,6,35,70,50,39,9,2,20,298,197,149,39,9,101
S01012485,743,381,283,81,17,362,132,19,13,5,1,113,87,44,30,8,6,43,118,69,48,17,4,49,57,41,33,8,0,16,349,208,159,43,6,141
S01012486,587,206,151,47,8,381,180,15,9,6,0,165,77,27,20,6,1,50,58,29,23,4,2,29,49,29,21,7,1,20,223,106,78,24,4,117
S01012487,529,336,267,37,32,193,180,65,45,7,13,115,134,99,71,14,14,35,69,50,43,4,3,19,57,50,40,9,1,7,89,72,68,3,1,17
S01012488,807,471,399,36,36,336,287,76,61,8,7,211,176,125,106,8,11,51,125,91,80,8,3,34,87,72,62,2,8,15,132,107,90,10,7,25
S01012489,845,516,386,32,98,329,293,117,73,10,34,176,251,159,116,9,34,92,120,90,72,3,15,30,72,57,51,2,4,15,109,93,74,8,11,16
S01012490,860,505,387,32,86,355,316,83,59,3,21,233,197,140,100,11,29,57,112,90,69,7,14,22,81,70,55,4,11,11,154,122,104,7,11,32
S01012491,359,233,161,9,63,126,127,53,34,3,16,74,118,87,57,0,30,31,51,43,31,2,10,8,30,26,21,0,5,4,33,24,18,4,2,9
S01012492,699,341,231,23,87,358,291,70,42,3,25,221,163,101,58,9,34,62,91,58,39,3,16,33,67,52,42,4,6,15,87,60,50,4,6,27
S01012493,606,230,194,18,18,376,271,34,23,6,5,237,99,40,32,5,3,59,51,34,29,1,4,17,48,35,32,1,2,13,137,87,78,5,4,50
S01012494,802,464,377,33,54,338,300,102,83,12,7,198,201,135,111,8,16,66,128,100,76,6,18,28,72,54,41,3,10,18,101,73,66,4,3,28
S01012495,862,498,401,29,68,364,338,115,90,5,20,223,232,169,133,8,28,63,117,86,71,8,7,31,76,65,55,4,6,11,99,63,52,4,7,36
S01012496,639,369,300,22,47,270,290,110,87,7,16,180,174,124,100,6,18,50,73,59,51,1,7,14,36,30,22,4,4,6,66,46,40,4,2,20
S01012497,426,229,179,12,38,197,214,71,53,4,14,143,117,84,64,6,14,33,36,27,26,1,0,9,30,24,20,0,4,6,29,23,16,1,6,6
S01012498,637,352,265,14,73,285,317,128,91,6,31,189,179,114,80,2,32,65,65,52,46,2,4,13,33,25,19,3,3,8,43,33,29,1,3,10
S01012499,589,334,257,21,56,255,264,85,64,5,16,179,134,95,67,6,22,39,69,59,48,2,9,10,55,45,36,4,5,10,67,50,42,4,4,17
S01012500,377,227,172,11,44,150,153,61,42,4,15,92,117,83,63,3,17,34,43,37,27,2,8,6,34,26,23,1,2,8,30,20,17,1,2,10
S01012501,449,243,199,1,43,206,207,82,64,0,18,125,133,75,58,0,17,58,50,44,39,0,5,6,33,25,23,0,2,8,26,17,15,1,1,9
S01012502,602,351,235,24,92,251,240,95,65,7,23,145,200,135,77,9,49,65,70,51,36,3,12,19,56,43,33,3,7,13,36,27,24,2,1,9
S01012503,523,282,221,19,42,241,252,95,75,7,13,157,121,81,61,5,15,40,60,36,28,1,7,24,41,34,25,4,5,7,49,36,32,2,2,13
S01012504,489,295,226,17,52,194,198,85,56,6,23,113,131,87,68,5,14,44,54,37,31,0,6,17,62,54,46,3,5,8,44,32,25,3,4,12
S01012505,869,502,389,43,70,367,343,104,73,10,21,239,224,155,120,12,23,69,118,95,80,5,10,23,70,62,46,6,10,8,114,86,70,10,6,28
S01012506,434,231,189,27,15,203,128,33,21,9,3,95,94,61,50,5,6,33,70,44,38,1,5,26,31,21,19,2,0,10,111,72,61,10,1,39
S01012507,815,465,388,36,41,350,272,76,58,10,8,196,203,141,120,7,14,62,110,75,59,7,9,35,78,61,53,3,5,17,152,112,98,9,5,40
S01012508,653,407,341,31,35,246,226,67,53,7,7,159,142,108,83,6,19,34,83,67,56,9,2,16,73,62,56,4,2,11,129,103,93,5,5,26
S01012509,459,286,236,35,15,173,140,40,35,4,1,100,88,65,49,10,6,23,72,56,43,9,4,16,57,45,38,5,2,12,102,80,71,7,2,22
S01012510,710,486,424,31,31,224,196,70,53,9,8,126,173,124,109,4,11,49,93,85,78,6,1,8,86,75,65,5,5,11,162,132,119,7,6,30
S01012511,552,359,331,13,15,193,163,52,45,3,4,111,117,89,80,1,8,28,91,67,63,3,1,24,61,54,50,4,0,7,120,97,93,2,2,23
S01012512,515,326,250,36,40,189,151,52,34,5,13,99,132,92,68,7,17,40,75,57,41,9,7,18,49,37,30,5,2,12,108,88,77,10,1,20
S01012513,446,324,291,22,11,122,79,34,28,5,1,45,91,73,65,3,5,18,63,43,37,2,4,20,62,51,45,5,1,11,151,123,116,7,0,28
S01012514,738,616,535,56,25,122,89,49,43,3,3,40,170,133,113,13,7,37,132,114,96,12,6,18,117,107,97,8,2,10,230,213,186,20,7,17
S01012515,529,281,230,21,30,248,215,55,42,8,5,160,118,82,63,5,14,36,73,59,45,5,9,14,43,33,30,2,1,10,80,52,50,1,1,28
S01012516,536,298,246,24,28,238,177,47,36,3,8,130,123,78,64,10,4,45,75,52,44,2,6,23,50,38,31,3,4,12,111,83,71,6,6,28
S01012517,694,455,377,36,42,239,206,67,52,5,10,139,169,122,94,8,20,47,115,98,86,7,5,17,75,65,57,4,4,10,129,103,88,12,3,26
S01012518,488,288,227,41,20,200,95,27,23,4,0,68,98,59,46,9,4,39,75,52,37,6,9,23,49,32,28,4,0,17,171,118,93,18,7,53
S01012519,460,261,199,44,18,199,118,23,12,6,5,95,89,60,44,9,7,29,77,57,46,9,2,20,53,37,28,7,2,16,123,84,69,13,2,39
S01012520,715,386,319,48,19,329,169,22,13,8,1,147,109,62,50,6,6,47,92,62,49,5,8,30,68,49,44,4,1,19,277,191,163,25,3,86
S01012521,437,264,208,39,17,173,85,18,12,4,2,67,83,53,33,12,8,30,73,51,41,6,4,22,50,43,33,7,3,7,146,99,89,10,0,47
S01012522,737,425,321,82,22,312,131,43,29,11,3,88,126,68,45,16,7,58,136,94,74,16,4,42,82,58,42,15,1,24,262,162,131,24,7,100
S01012523,750,452,381,43,28,298,145,37,30,3,4,108,150,94,77,7,10,56,138,97,78,11,8,41,106,82,70,8,4,24,211,142,126,14,2,69
S01012524,785,402,334,49,19,383,203,49,33,12,4,154,131,67,57,7,3,64,114,76,60,10,6,38,106,69,59,6,4,37,231,141,125,14,2,90
S01012525,632,399,341,42,16,233,125,36,27,8,1,89,138,95,79,10,6,43,103,73,63,8,2,30,80,64,59,4,1,16,186,131,113,12,6,55
S01012526,665,369,304,50,15,296,102,19,14,5,0,83,102,58,43,12,3,44,113,70,62,4,4,43,77,52,43,7,2,25,271,170,142,22,6,101
S01012527,539,295,243,37,15,244,164,52,43,6,3,112,103,61,46,7,8,42,70,49,36,11,2,21,58,38,33,4,1,20,144,95,85,9,1,49
S01012528,660,430,374,32,24,230,242,97,82,7,8,145,155,116,98,8,10,39,89,65,57,5,3,24,66,54,49,4,1,12,108,98,88,8,2,10
S01012529,621,372,310,33,29,249,182,65,47,6,12,117,148,93,79,9,5,55,83,65,58,3,4,18,68,51,40,6,5,17,140,98,86,9,3,42
S01012530,759,412,354,33,25,347,171,44,38,4,2,127,164,96,78,10,8,68,117,75,65,4,6,42,97,72,61,6,5,25,210,125,112,9,4,85
S01012531,621,408,325,55,28,213,139,45,35,5,5,94,125,86,62,14,10,39,91,66,52,8,6,25,89,70,57,9,4,19,177,141,119,19,3,36
S01012532,660,409,318,66,25,251,191,72,52,17,3,119,143,88,63,15,10,55,102,75,61,9,5,27,76,62,51,8,3,14,148,112,91,17,4,36
S01012533,467,291,248,27,16,176,118,38,30,4,4,80,119,82,64,11,7,37,60,40,34,3,3,20,54,43,41,2,0,11,116,88,79,7,2,28
S01012534,537,285,245,21,19,252,185,39,27,7,5,146,131,87,74,5,8,44,66,55,51,2,2,11,53,39,37,1,1,14,102,65,56,6,3,37
S01012535,685,440,366,36,38,245,253,87,70,10,7,166,175,132,109,8,15,43,104,86,71,7,8,18,74,66,57,4,5,8,79,69,59,7,3,10
S01012536,623,400,312,48,40,223,211,95,74,9,12,116,191,144,115,11,18,47,81,61,44,11,6,20,56,38,29,9,0,18,84,62,50,8,4,22
S01012537,674,391,299,35,57,283,282,100,76,12,12,182,136,108,84,10,14,28,106,78,60,4,14,28,79,57,42,4,11,22,71,48,37,5,6,23
S01012538,909,526,422,47,57,383,341,103,84,6,13,238,240,167,123,14,30,73,112,91,70,13,8,21,84,66,57,3,6,18,132,99,88,11,0,33
S01012539,584,367,267,75,25,217,182,64,42,16,6,118,170,121,82,33,6,49,87,75,59,8,8,12,56,45,35,9,1,11,89,62,49,9,4,27
S01012540,568,332,254,32,46,236,227,81,57,9,15,146,175,122,84,13,25,53,66,52,45,6,1,14,54,42,39,1,2,12,46,35,29,3,3,11
S01012541,859,598,418,144,36,261,272,133,81,40,12,139,206,151,103,36,12,55,105,84,61,20,3,21,91,81,59,18,4,10,185,149,114,30,5,36
S01012542,797,421,336,55,30,376,245,54,39,7,8,191,150,90,70,6,14,60,110,75,58,12,5,35,71,46,35,11,0,25,221,156,134,19,3,65
S01012543,549,376,282,74,20,173,102,45,25,18,2,57,132,101,75,16,10,31,82,58,43,13,2,24,60,39,31,7,1,21,173,133,108,20,5,40
S01012544,670,397,318,57,22,273,182,54,41,9,4,128,143,97,77,12,8,46,81,57,48,6,3,24,85,65,55,7,3,20,179,124,97,23,4,55
S01012545,377,239,187,26,26,138,136,39,33,2,4,97,98,79,57,10,12,19,37,34,26,6,2,3,37,32,25,3,4,5,69,55,46,5,4,14
S01012546,648,419,319,59,41,229,162,60,42,10,8,102,147,101,77,13,11,46,123,92,70,10,12,31,80,69,55,8,6,11,136,97,75,18,4,39
S01012547,627,322,255,46,21,305,141,30,21,5,4,111,122,74,54,11,9,48,95,57,48,5,4,38,69,37,34,2,1,32,200,124,98,23,3,76
S01012548,712,397,322,50,25,315,171,45,28,10,7,126,142,86,71,12,3,56,110,76,60,10,6,34,70,47,42,2,3,23,219,143,121,16,6,76
S01012549,438,275,226,17,32,163,143,45,40,0,5,98,108,81,59,6,16,27,59,47,42,2,3,12,61,46,35,4,7,15,67,56,50,5,1,11
S01012550,670,418,332,46,40,252,174,64,50,8,6,110,154,99,70,11,18,55,109,73,60,9,4,36,74,60,48,6,6,14,159,122,104,12,6,37
S01012551,677,467,401,52,14,210,115,38,29,7,2,77,145,97,81,14,2,48,129,100,90,5,5,29,86,73,62,10,1,13,202,159,139,16,4,43
S01012552,761,482,397,66,19,279,108,27,19,8,0,81,147,85,71,8,6,62,128,87,67,12,8,41,100,76,63,12,1,24,278,207,177,26,4,71
S01012553,652,487,415,49,23,165,78,26,18,7,1,52,149,106,86,13,7,43,122,97,85,5,7,25,89,74,62,8,4,15,214,184,164,16,4,30
S01012554,387,247,210,26,11,140,67,22,18,3,1,45,74,46,40,2,4,28,79,57,49,5,3,22,49,38,33,3,2,11,118,84,70,13,1,34
S01012555,437,286,252,26,8,151,58,23,20,3,0,35,94,59,52,5,2,35,81,53,46,4,3,28,59,42,40,1,1,17,145,109,94,13,2,36
S01012556,486,294,242,38,14,192,58,21,16,2,3,37,88,42,32,8,2,46,92,57,43,9,5,35,57,37,32,4,1,20,191,137,119,15,3,54
S01012557,533,288,224,40,24,245,80,21,12,6,3,59,95,59,43,8,8,36,73,42,38,1,3,31,63,34,31,1,2,29,222,132,100,24,8,90
S01012558,489,314,257,20,37,175,136,50,36,6,8,86,133,97,76,5,16,36,70,49,43,2,4,21,52,41,35,4,2,11,98,77,67,3,7,21
S01012559,661,335,257,36,42,326,231,50,37,5,8,181,149,89,64,8,17,60,84,58,46,7,5,26,88,62,50,6,6,26,109,76,60,10,6,33
S01012560,446,230,195,19,16,216,150,31,22,4,5,119,92,58,52,4,2,34,62,47,41,1,5,15,48,34,30,2,2,14,94,60,50,8,2,34
S01012561,626,341,295,24,22,285,180,39,28,4,7,141,142,89,81,4,4,53,92,63,54,2,7,29,65,46,39,5,2,19,147,104,93,9,2,43
S01012562,641,377,304,32,41,264,174,43,37,2,4,131,143,95,72,8,15,48,91,64,52,4,8,27,90,66,50,7,9,24,143,109,93,11,5,34
S01012563,560,260,206,43,11,300,77,16,10,6,0,61,65,22,18,2,2,43,75,40,32,5,3,35,59,32,24,7,1,27,284,150,122,23,5,134
S01012564,703,371,283,73,15,332,134,30,17,13,0,104,104,61,43,14,4,43,109,63,47,11,5,46,70,38,32,5,1,32,286,179,144,30,5,107
S01012565,663,331,264,57,10,332,132,25,14,10,1,107,111,46,30,11,5,65,97,61,55,4,2,36,59,35,32,3,0,24,264,164,133,29,2,100
S01012566,642,379,294,58,27,263,144,33,24,8,1,111,130,93,72,6,15,37,79,51,40,8,3,28,77,58,45,9,4,19,212,144,113,27,4,68
S01012567,897,525,410,64,51,372,224,76,55,13,8,148,205,119,85,10,24,86,121,91,68,12,11,30,106,73,61,9,3,33,241,166,141,20,5,75
S01012568,519,252,183,50,19,267,67,10,4,4,2,57,68,24,13,4,7,44,76,44,30,10,4,32,41,27,17,9,1,14,267,147,119,23,5,120
S01012569,709,339,237,89,13,370,133,20,11,8,1,113,91,40,29,11,0,51,108,69,48,17,4,39,46,30,18,10,2,16,331,180,131,43,6,151
S01012570,392,254,192,49,13,138,121,51,36,11,4,70,90,64,49,9,6,26,48,34,24,8,2,14,45,40,34,6,0,5,88,65,49,15,1,23
S01012571,672,440,302,102,36,232,211,84,59,15,10,127,132,103,72,20,11,29,112,85,58,18,9,27,65,48,33,12,3,17,152,120,80,37,3,32
S01012572,435,287,204,61,22,148,135,70,46,19,5,65,106,70,52,12,6,36,59,48,40,5,3,11,38,29,18,9,2,9,97,70,48,16,6,27
S01012573,677,453,335,111,7,224,164,71,37,32,2,93,137,100,70,28,2,37,80,59,41,17,1,21,64,52,39,12,1,12,232,171,148,22,1,61
S01012574,715,469,355,94,20,246,152,59,39,18,2,93,121,87,61,21,5,34,120,92,65,21,6,28,71,53,42,8,3,18,251,178,148,26,4,73
S01012575,542,356,267,66,23,186,109,44,32,8,4,65,101,76,62,8,6,25,91,66,46,14,6,25,61,43,30,10,3,18,180,127,97,26,4,53
S01012576,646,400,308,78,14,246,135,40,29,11,0,95,120,74,56,13,5,46,102,79,63,13,3,23,59,46,38,5,3,13,230,161,122,36,3,69
S01012577,618,425,320,88,17,193,177,83,59,19,5,94,113,82,69,9,4,31,81,64,39,22,3,17,57,50,38,12,0,7,190,146,115,26,5,44
S01012578,851,438,339,80,19,413,282,67,47,14,6,215,146,91,63,21,7,55,101,71,60,9,2,30,68,45,36,8,1,23,254,164,133,28,3,90
S01012579,547,369,275,67,27,178,115,55,42,9,4,60,135,97,68,18,11,38,79,57,40,13,4,22,55,45,28,12,5,10,163,115,97,15,3,48
S01012580,620,442,304,116,22,178,122,58,35,19,4,64,125,90,63,19,8,35,83,60,33,20,7,23,56,49,33,14,2,7,234,185,140,44,1,49
S01012581,577,381,288,34,59,196,212,95,71,6,18,117,166,130,96,4,30,36,74,63,48,9,6,11,56,47,38,7,2,9,69,46,35,8,3,23
S01012582,732,523,405,91,27,209,133,47,31,13,3,86,162,123,93,20,10,39,119,100,74,18,8,19,79,63,45,16,2,16,239,190,162,24,4,49
S01012583,584,388,323,26,39,196,185,85,66,8,11,100,146,107,89,4,14,39,77,61,50,8,3,16,62,50,42,3,5,12,114,85,76,3,6,29
S01012584,621,394,302,69,23,227,163,62,46,13,3,101,137,101,76,16,9,36,98,75,55,16,4,23,53,39,29,5,5,14,170,117,96,19,2,53
S01012585,676,435,346,44,45,241,247,113,82,14,17,134,169,131,102,11,18,38,93,67,54,9,4,26,58,48,43,2,3,10,109,76,65,8,3,33
S01012586,790,480,373,86,21,310,222,68,53,12,3,154,171,105,77,20,8,66,126,97,76,19,2,29,84,66,47,14,5,18,187,144,120,21,3,43
S01012587,708,485,363,101,21,223,162,65,35,25,5,97,156,111,71,34,6,45,110,89,69,14,6,21,79,65,57,6,2,14,201,155,131,22,2,46
S01012588,520,354,270,70,14,166,127,53,37,15,1,74,116,84,63,16,5,32,74,55,39,12,4,19,60,48,39,8,1,12,143,114,92,19,3,29
S01012589,565,364,315,24,25,201,203,83,68,6,9,120,166,128,109,8,11,38,71,60,54,3,3,11,39,30,29,1,0,9,86,63,55,6,2,23
S01012590,653,392,311,32,49,261,243,88,71,7,10,155,178,130,99,5,26,48,72,53,39,5,9,19,58,44,39,4,1,14,102,77,63,11,3,25
S01012591,653,312,259,15,38,341,345,99,72,4,23,246,157,103,90,4,9,54,64,50,43,3,4,14,39,31,28,2,1,8,48,29,26,2,1,19
S01012592,455,311,248,53,10,144,94,33,20,11,2,61,83,59,44,14,1,24,72,54,42,9,3,18,55,45,38,4,3,10,151,120,104,15,1,31
S01012593,676,494,437,34,23,182,111,46,35,5,6,65,174,127,108,12,7,47,97,82,72,6,4,15,81,64,60,2,2,17,213,175,162,9,4,38
S01012594,395,224,199,13,12,171,112,36,32,1,3,76,98,62,53,1,8,36,53,30,27,3,0,23,40,29,28,1,0,11,92,67,59,7,1,25
S01012595,532,323,266,31,26,209,187,58,47,7,4,129,123,95,75,5,15,28,65,50,44,5,1,15,56,45,39,4,2,11,101,75,61,10,4,26
S01012596,614,385,309,28,48,229,263,108,85,6,17,155,140,109,83,13,13,31,58,43,34,3,6,15,59,49,41,3,5,10,94,76,66,3,7,18
S01012597,351,276,231,20,25,75,64,26,18,3,5,38,87,75,52,8,15,12,57,50,42,4,4,7,44,34,32,1,1,10,99,91,87,4,0,8
S01012598,585,401,355,34,12,184,96,23,16,5,2,73,108,76,67,5,4,32,87,71,60,9,2,16,73,59,52,6,1,14,221,172,160,9,3,49
S01012599,565,335,282,38,15,230,144,38,30,5,3,106,109,77,63,6,8,32,88,62,55,5,2,26,61,45,36,8,1,16,163,113,98,14,1,50
S01012600,595,425,365,34,26,170,90,37,29,4,4,53,109,75,61,7,7,34,114,94,82,9,3,20,76,56,48,4,4,20,206,163,145,10,8,43
S01012601,724,538,472,50,16,186,108,45,36,7,2,63,166,114,95,15,4,52,148,128,113,9,6,20,84,75,65,8,2,9,218,176,163,11,2,42
S01012602,537,271,231,13,27,266,206,29,21,0,8,177,101,68,53,4,11,33,87,72,67,3,2,15,40,28,22,4,2,12,103,74,68,2,4,29
S01012603,588,338,273,28,37,250,232,83,63,9,11,149,132,94,73,10,11,38,64,50,42,2,6,14,69,46,37,3,6,23,91,65,58,4,3,26
S01012604,561,336,282,17,37,225,173,63,57,3,3,110,159,108,85,3,20,51,81,60,51,2,7,21,49,37,30,3,4,12,99,68,59,6,3,31
S01012605,436,228,197,15,16,208,146,44,38,2,4,102,90,62,50,5,7,28,54,32,28,3,1,22,40,31,27,2,2,9,106,59,54,3,2,47
S01012606,550,499,454,32,13,51,28,14,12,2,0,14,116,100,85,6,9,16,100,91,84,5,2,9,82,78,72,4,2,4,224,216,201,15,0,8
S01012607,624,420,341,46,33,204,154,57,39,11,7,97,148,116,88,14,14,32,94,69,56,8,5,25,65,53,45,5,3,12,163,125,113,8,4,38
S01012608,674,435,359,32,44,239,237,93,74,6,13,144,161,122,96,7,19,39,103,85,72,7,6,18,55,45,36,5,4,10,118,90,81,7,2,28
S01012609,680,405,337,24,44,275,267,103,83,8,12,164,193,134,107,8,19,59,102,76,65,3,8,26,47,33,29,3,1,14,71,59,53,2,4,12
S01012610,748,438,358,27,53,310,251,83,61,6,16,168,202,135,105,9,21,67,95,74,61,4,9,21,74,58,52,2,4,16,126,88,79,6,3,38
S01012611,697,435,366,42,27,262,169,58,43,12,3,111,139,87,71,7,9,52,116,89,75,6,8,27,85,67,57,8,2,18,188,134,120,9,5,54
S01012612,606,338,271,25,42,268,187,67,48,8,11,120,164,95,72,7,16,69,93,70,59,3,8,23,57,43,34,5,4,14,105,63,58,2,3,42
S01012613,549,365,301,21,43,184,139,66,53,5,8,73,173,131,98,6,27,42,75,54,47,1,6,21,52,34,30,4,0,18,110,80,73,5,2,30
S01012614,884,539,458,38,43,345,223,56,39,8,9,167,172,117,95,9,13,55,162,119,101,10,8,43,98,77,69,4,4,21,229,170,154,7,9,59
S01012615,572,357,266,68,23,215,130,46,31,10,5,84,116,71,53,13,5,45,89,68,52,5,11,21,56,43,32,11,0,13,181,129,98,29,2,52
S01012616,789,481,364,90,27,308,214,75,51,22,2,139,146,106,82,19,5,40,121,75,59,10,6,46,82,61,44,12,5,21,226,164,128,27,9,62
S01012617,354,236,185,43,8,118,80,21,10,11,0,59,67,47,37,7,3,20,57,50,41,7,2,7,47,38,30,7,1,9,103,80,67,11,2,23
S01012618,443,311,253,39,19,132,103,52,43,4,5,51,115,79,64,9,6,36,64,50,41,4,5,14,36,27,23,2,2,9,125,103,82,20,1,22
S01012619,490,257,199,26,32,233,184,50,34,7,9,134,94,59,43,6,10,35,67,44,34,3,7,23,52,39,33,2,4,13,93,65,55,8,2,28
S01012620,646,388,310,62,16,258,122,36,25,10,1,86,94,56,43,8,5,38,117,84,72,7,5,33,62,42,29,11,2,20,251,170,141,26,3,81
S01012621,512,277,225,33,19,235,130,23,16,3,4,107,78,46,37,6,3,32,82,59,46,7,6,23,46,39,35,2,2,7,176,110,91,15,4,66
S01012622,600,376,304,41,31,224,177,57,35,13,9,120,140,105,85,11,9,35,83,61,53,0,8,22,73,61,51,6,4,12,127,92,80,11,1,35
S01012623,555,324,274,27,23,231,206,77,62,8,7,129,122,80,67,7,6,42,86,66,56,5,5,20,44,33,29,2,2,11,97,68,60,5,3,29
S01012624,588,367,302,30,35,221,205,65,50,7,8,140,154,113,87,12,14,41,68,56,46,3,7,12,66,58,48,7,3,8,95,75,71,1,3,20
S01012625,455,286,238,21,27,169,179,60,44,5,11,119,98,77,64,4,9,21,69,54,44,5,5,15,40,38,32,5,1,2,69,57,54,2,1,12
S01012626,412,267,226,24,17,145,81,39,32,6,1,42,96,56,46,5,5,40,66,56,50,3,3,10,41,33,28,0,5,8,128,83,70,10,3,45
S01012627,431,277,208,30,39,154,111,48,33,4,11,63,91,64,47,5,12,27,70,52,44,4,4,18,44,33,21,5,7,11,115,80,63,12,5,35
S01012628,795,510,417,69,24,285,171,41,32,5,4,130,128,96,78,11,7,32,126,89,71,12,6,37,69,57,43,12,2,12,301,227,193,29,5,74
S01012629,401,268,215,39,14,133,73,19,11,6,2,54,60,31,25,2,4,29,55,42,30,7,5,13,38,30,25,4,1,8,175,146,124,20,2,29
S01012630,769,402,307,56,39,367,239,55,35,10,10,184,160,92,72,11,9,68,105,75,61,7,7,30,72,55,42,7,6,17,193,125,97,21,7,68
S01012631,727,484,393,34,57,243,231,85,58,10,17,146,190,140,108,12,20,50,117,102,83,5,14,15,67,60,53,2,5,7,122,97,91,5,1,25
S01012632,590,394,284,97,13,196,148,71,39,29,3,77,135,87,59,24,4,48,93,70,49,17,4,23,69,56,45,11,0,13,145,110,92,16,2,35
S01012633,568,365,243,96,26,203,128,47,23,21,3,81,114,80,51,19,10,34,92,68,50,13,5,24,74,59,35,19,5,15,160,111,84,24,3,49
S01012634,574,332,257,42,33,242,223,86,56,16,14,137,148,103,81,11,11,45,80,58,50,6,2,22,35,28,22,4,2,7,88,57,48,5,4,31
S01012635,878,573,453,85,35,305,199,69,48,14,7,130,193,134,103,20,11,59,130,105,88,10,7,25,87,76,61,11,4,11,269,189,153,30,6,80
S01012636,502,358,262,86,10,144,124,56,41,15,0,68,116,92,73,11,8,24,69,54,40,14,0,15,46,39,25,14,0,7,147,117,83,32,2,30
S01012637,664,392,318,22,52,272,285,113,81,12,20,172,192,139,111,6,22,53,71,53,47,1,5,18,49,41,37,0,4,8,67,46,42,3,1,21
S01012638,723,413,329,46,38,310,298,91,66,12,13,207,179,133,106,13,14,46,93,72,58,9,5,21,37,30,27,2,1,7,116,87,72,10,5,29
S01012639,683,427,345,41,41,256,280,102,74,18,10,178,186,151,121,7,23,35,89,73,65,5,3,16,59,47,42,2,3,12,69,54,43,9,2,15
S01012640,775,427,279,53,95,348,339,129,73,14,42,210,219,152,93,19,40,67,85,60,42,7,11,25,63,42,35,6,1,21,69,44,36,7,1,25
S01012641,944,460,364,44,52,484,388,102,78,6,18,286,214,157,115,23,19,57,102,73,62,6,5,29,67,46,37,3,6,21,173,82,72,6,4,91
S01012642,653,361,277,19,65,292,297,104,71,8,25,193,207,150,115,7,28,57,65,49,37,2,10,16,32,21,20,0,1,11,52,37,34,2,1,15
S01012643,375,229,190,14,25,146,153,57,47,2,8,96,105,80,69,3,8,25,49,42,28,6,8,7,32,25,22,2,1,7,36,25,24,1,0,11
S01012644,536,322,267,25,30,214,211,70,56,5,9,141,142,103,87,5,11,39,60,48,40,3,5,12,46,40,30,6,4,6,77,61,54,6,1,16
S01012645,684,414,326,58,30,270,246,78,51,17,10,168,156,113,82,19,12,43,70,51,41,5,5,19,61,51,46,3,2,10,151,121,106,14,1,30
S01012646,764,517,428,70,19,247,187,71,51,15,5,116,211,152,123,21,8,59,111,86,72,10,4,25,85,68,61,7,0,17,170,140,121,17,2,30
S01012647,529,444,390,32,22,85,62,34,29,3,2,28,115,96,73,12,11,19,94,79,71,4,4,15,78,73,65,8,0,5,180,162,152,5,5,18
S01012648,438,265,215,17,33,173,174,67,48,8,11,107,139,100,79,3,18,39,50,38,31,3,4,12,31,25,24,1,0,6,44,35,33,2,0,9
S01012649,550,340,274,34,32,210,195,72,54,9,9,123,121,90,67,12,11,31,68,52,42,6,4,16,51,41,36,3,2,10,115,85,75,4,6,30
S01012650,497,320,259,44,17,177,134,43,31,9,3,91,126,97,80,8,9,29,64,48,34,13,1,16,57,45,39,4,2,12,116,87,75,10,2,29
S01012651,523,308,251,13,44,215,261,104,84,3,17,157,130,105,81,6,18,25,39,27,22,1,4,12,43,32,29,0,3,11,50,40,35,3,2,10
S01012652,883,615,522,55,38,268,176,75,60,10,5,101,173,132,109,14,9,41,178,140,118,11,11,38,127,103,92,5,6,24,229,165,143,15,7,64
S01012653,704,469,354,55,60,235,269,122,82,15,25,147,181,144,102,16,26,37,93,75,63,7,5,18,58,49,41,6,2,9,103,79,66,11,2,24
S01012654,614,434,334,73,27,180,139,71,46,16,9,68,131,97,75,14,8,34,105,76,59,12,5,29,70,57,45,12,0,13,169,133,109,19,5,36
S01012655,964,541,431,65,45,423,414,124,86,16,22,290,234,171,135,25,11,63,112,97,87,5,5,15,75,56,45,6,5,19,129,93,78,13,2,36
S01012656,673,386,316,30,40,287,263,77,58,10,9,186,174,131,106,11,14,43,68,54,48,2,4,14,85,69,58,2,9,16,83,55,46,5,4,28
S01012657,455,252,219,17,16,203,185,54,43,4,7,131,114,77,66,6,5,37,53,38,31,3,4,15,49,40,39,1,0,9,54,43,40,3,0,11
S01012658,818,508,432,55,21,310,229,67,52,13,2,162,194,135,115,14,6,59,134,97,80,13,4,37,99,76,65,6,5,23,162,133,120,9,4,29
S01012659,771,611,539,54,18,160,122,58,45,10,3,64,164,130,115,9,6,34,151,120,110,7,3,31,88,79,70,8,1,9,246,224,199,20,5,22
S01012660,591,356,299,32,25,235,211,60,46,3,11,151,127,105,89,10,6,22,74,49,42,5,2,25,65,53,49,3,1,12,114,89,73,11,5,25
S01012661,645,435,351,59,25,210,168,59,46,8,5,109,153,109,79,18,12,44,112,98,83,12,3,14,74,60,53,6,1,14,138,109,90,15,4,29
S01012662,633,346,281,31,34,287,246,76,59,8,9,170,164,102,77,9,16,62,90,68,54,9,5,22,59,48,41,5,2,11,74,52,50,0,2,22
S01012663,597,360,295,43,22,237,184,65,49,10,6,119,129,98,77,10,11,31,96,66,54,9,3,30,75,60,55,5,0,15,113,71,60,9,2,42
S01012664,815,519,404,71,44,296,304,98,79,13,6,206,161,125,86,18,21,36,119,101,81,17,3,18,89,84,67,8,9,5,142,111,91,15,5,31
S01012665,565,309,237,26,46,256,270,85,61,5,19,185,132,102,76,9,17,30,74,56,46,4,6,18,37,29,22,6,1,8,52,37,32,2,3,15
S01012666,553,295,227,26,42,258,279,92,66,6,20,187,136,91,68,6,17,45,51,43,35,6,2,8,42,33,30,1,2,9,45,36,28,7,1,9
S01012667,482,268,197,26,45,214,201,68,48,7,13,133,150,98,65,5,28,52,61,47,40,6,1,14,28,22,18,3,1,6,42,33,26,5,2,9
S01012668,597,368,281,35,52,229,239,92,58,14,20,147,167,118,93,8,17,49,79,65,56,3,6,14,50,45,37,2,6,5,62,48,37,8,3,14
S01012669,618,379,353,11,15,239,140,44,38,4,2,96,131,93,86,3,4,38,120,83,80,0,3,37,86,62,56,2,4,24,141,97,93,2,2,44
S01012670,613,355,309,35,11,258,140,31,26,5,0,109,144,99,79,13,7,45,114,80,73,6,1,34,57,43,40,2,1,14,158,102,91,9,2,56
S01012671,762,475,397,43,35,287,376,168,141,12,15,208,167,135,119,10,6,32,90,67,53,9,5,23,61,47,39,2,6,14,68,58,45,10,3,10
S01012672,588,292,227,20,45,296,302,93,72,5,16,209,157,110,87,6,17,47,47,30,20,4,6,17,30,23,19,1,3,7,52,36,29,4,3,16
S01012673,478,287,235,13,39,191,222,97,75,6,16,125,131,92,70,5,17,39,54,40,36,2,2,14,37,32,29,0,3,5,34,26,25,0,1,8
S01012674,441,253,179,12,62,188,209,79,50,3,26,130,115,85,55,4,26,30,53,45,37,2,6,8,26,16,12,2,2,10,38,28,25,1,2,10
S01012675,641,381,299,32,50,260,285,99,72,12,15,186,184,140,101,11,28,44,64,52,48,0,4,12,38,31,28,2,1,7,70,59,50,7,2,11
S01012676,634,448,358,37,53,186,193,97,73,8,16,96,196,152,118,11,23,44,97,76,64,5,7,21,62,48,39,6,3,14,86,75,64,7,4,11
S01012677,476,280,220,24,36,196,203,73,60,5,8,130,126,103,74,9,20,23,56,40,35,3,2,16,39,31,23,5,3,8,52,33,28,2,3,19
S01012678,575,440,376,40,24,135,119,59,44,8,7,60,153,123,105,10,8,30,108,94,78,10,6,14,62,53,49,4,0,9,133,111,100,8,3,22
S01012679,668,395,330,42,23,273,211,58,42,9,7,153,173,125,102,12,11,48,90,63,55,6,2,27,70,54,48,5,1,16,124,95,83,10,2,29
S01012680,437,320,278,32,10,117,99,40,33,5,2,59,101,75,58,12,5,26,60,53,45,6,2,7,52,44,40,3,1,8,125,108,102,6,0,17
S01012681,568,366,271,61,34,202,170,65,36,18,11,105,136,90,65,14,11,46,94,73,53,13,7,21,57,49,35,11,3,8,111,89,82,5,2,22
S01012682,665,353,291,46,16,312,248,51,42,6,3,197,128,90,76,12,2,38,82,60,53,5,2,22,61,46,36,7,3,15,146,106,84,16,6,40
S01012683,604,415,327,29,59,189,179,72,56,6,10,107,176,137,94,11,32,39,82,68,53,6,9,14,64,59,52,2,5,5,103,79,72,4,3,24
S01012684,441,284,233,37,14,157,121,36,24,10,2,85,93,68,50,12,6,25,51,38,28,7,3,13,62,53,49,4,0,9,114,89,82,4,3,25
S01012685,623,415,333,38,44,208,218,96,76,10,10,122,155,115,89,10,16,40,85,70,58,3,9,15,64,53,44,5,4,11,101,81,66,10,5,20
S01012686,794,529,419,82,28,265,138,34,20,11,3,104,133,95,70,14,11,38,137,100,76,14,10,37,90,76,62,12,2,14,296,224,191,31,2,72
S01012687,456,218,167,45,6,238,73,16,10,6,0,57,56,32,26,5,1,24,79,44,32,10,2,35,42,22,17,4,1,20,206,104,82,20,2,102
S01012688,692,408,328,46,34,284,164,40,29,5,6,124,132,81,62,6,13,51,90,56,45,4,7,34,77,62,50,10,2,15,229,169,142,21,6,60
S01012689,392,243,195,39,9,149,57,22,16,5,1,35,62,40,31,8,1,22,63,42,35,4,3,21,48,33,28,2,3,15,162,106,85,20,1,56
S01012690,424,277,234,32,11,147,84,29,22,7,0,55,82,52,46,3,3,30,71,53,42,7,4,18,53,43,36,6,1,10,134,100,88,9,3,34
S01012691,595,389,312,49,28,206,63,17,7,3,7,46,95,56,45,5,6,39,100,71,56,8,7,29,47,33,28,5,0,14,290,212,176,28,8,78
S01012692,625,357,296,43,18,268,178,38,31,3,4,140,115,80,61,13,6,35,95,70,54,11,5,25,61,46,40,6,0,15,176,123,110,10,3,53
S01012693,701,498,405,68,25,203,69,21,11,5,5,48,107,72,58,9,5,35,121,93,78,6,9,28,91,70,56,12,2,21,313,242,202,36,4,71
S01012694,363,238,210,20,8,125,113,33,27,5,1,80,74,59,50,3,6,15,51,39,37,2,0,12,42,38,32,6,0,4,83,69,64,4,1,14
S01012695,651,445,301,119,25,206,186,92,49,40,3,94,148,106,74,23,9,42,88,64,47,13,4,24,69,56,43,11,2,13,160,127,88,32,7,33
S01012696,734,440,294,127,19,294,184,74,30,42,2,110,148,90,60,28,2,58,102,69,52,11,6,33,66,43,23,17,3,23,234,164,129,29,6,70
S01012697,405,269,189,76,4,136,90,41,23,18,0,49,66,47,27,18,2,19,66,36,26,9,1,30,35,30,23,7,0,5,148,115,90,24,1,33
S01012698,653,425,320,83,22,228,124,55,32,19,4,69,144,97,69,19,9,47,119,82,64,15,3,37,81,60,44,14,2,21,185,131,111,16,4,54
S01012699,847,581,424,127,30,266,222,89,51,31,7,133,167,125,83,30,12,42,129,96,73,19,4,33,78,69,54,10,5,9,251,202,163,37,2,49
S01012700,671,428,331,73,24,243,152,49,29,15,5,103,162,114,89,17,8,48,105,77,56,14,7,28,70,50,40,8,2,20,182,138,117,19,2,44
S01012701,467,277,232,34,11,190,109,37,26,9,2,72,88,60,53,6,1,28,76,49,35,9,5,27,46,29,25,3,1,17,148,102,93,7,2,46
S01012702,483,340,274,43,23,143,108,34,22,10,2,74,90,71,52,10,9,19,54,42,34,3,5,12,52,44,36,6,2,8,179,149,130,14,5,30
S01012703,464,382,327,34,21,82,98,55,43,10,2,43,106,90,70,11,9,16,83,77,72,1,4,6,69,64,59,3,2,5,108,96,83,9,4,12
S01012704,597,391,309,30,52,206,247,111,83,8,20,136,171,129,102,11,16,42,72,58,43,5,10,14,49,45,37,4,4,4,58,48,44,2,2,10
S01012705,584,470,412,47,11,114,74,42,30,11,1,32,150,117,94,16,7,33,119,94,88,4,2,25,63,58,50,8,0,5,178,159,150,8,1,19
S01012706,557,349,284,25,40,208,247,106,83,8,15,141,144,118,94,7,17,26,65,45,39,2,4,20,34,25,22,2,1,9,67,55,46,6,3,12
S01012707,728,531,458,57,16,197,98,39,29,7,3,59,134,99,77,20,2,35,140,113,100,7,6,27,93,73,66,7,0,20,263,207,186,16,5,56
S01012708,595,354,275,25,54,241,255,90,63,7,20,165,144,103,71,7,25,41,72,54,45,4,5,18,47,40,36,2,2,7,77,67,60,5,2,10
S01012709,430,238,202,15,21,192,146,44,33,4,7,102,104,73,61,4,8,31,49,28,24,1,3,21,50,37,33,2,2,13,81,56,51,4,1,25
S01012710,605,367,305,33,29,238,235,83,53,17,13,152,127,90,81,4,5,37,87,62,52,4,6,25,58,51,45,3,3,7,98,81,74,5,2,17
S01012711,716,396,308,25,63,320,326,99,71,8,20,227,150,104,80,5,19,46,72,58,48,2,8,14,50,39,28,3,8,11,118,96,81,7,8,22
S01012712,695,394,328,39,27,301,123,27,21,3,3,96,119,63,47,7,9,56,117,77,61,7,9,40,84,58,49,8,1,26,252,169,150,14,5,83
S01012713,614,347,294,36,17,267,140,32,18,12,2,108,111,63,49,8,6,48,91,66,61,3,2,25,77,58,51,5,2,19,195,128,115,8,5,67
S01012714,516,278,235,33,10,238,81,28,22,4,2,53,84,42,36,5,1,42,94,60,50,5,5,34,78,51,45,5,1,27,179,97,82,14,1,82
S01012715,624,370,306,27,37,254,192,60,45,5,10,132,116,67,50,8,9,49,87,65,55,4,6,22,69,48,43,3,2,21,160,130,113,7,10,30
S01012716,739,394,301,73,20,345,159,29,20,7,2,130,111,65,41,20,4,46,96,57,50,5,2,39,76,48,38,9,1,28,297,195,152,32,11,102
S01012717,869,483,387,47,49,386,293,72,53,10,9,221,158,110,80,8,22,48,114,77,69,5,3,37,82,58,49,6,3,24,222,166,136,18,12,56
S01012718,868,509,410,60,39,359,238,56,37,12,7,182,124,78,63,6,9,46,113,83,65,11,7,30,98,78,63,8,7,20,295,214,182,23,9,81
S01012719,695,452,365,46,41,243,175,51,33,9,9,124,139,98,66,13,19,41,92,69,61,5,3,23,71,54,48,3,3,17,218,180,157,16,7,38
S01012720,464,347,283,35,29,117,89,39,25,3,11,50,79,58,42,8,8,21,75,62,52,6,4,13,64,54,48,4,2,10,157,134,116,14,4,23
S01012721,538,323,279,28,16,215,189,53,43,7,3,136,121,92,74,14,4,29,70,58,50,4,4,12,63,52,47,2,3,11,95,68,65,1,2,27
S01012722,631,327,257,19,51,304,292,80,59,1,20,212,139,92,72,7,13,47,71,51,40,2,9,20,57,47,41,2,4,10,72,57,45,7,5,15
S01012723,572,329,250,41,38,243,247,84,58,15,11,163,141,100,73,10,17,41,66,54,40,8,6,12,54,41,38,2,1,13,64,50,41,6,3,14
S01012724,631,384,319,43,22,247,200,56,40,11,5,144,147,105,86,10,9,42,61,46,40,3,3,15,78,62,56,4,2,16,145,115,97,15,3,30
S01012725,767,513,428,46,39,254,157,49,41,3,5,108,160,111,84,9,18,49,112,82,67,7,8,30,95,76,64,7,5,19,243,195,172,20,3,48
S01012726,519,283,225,26,32,236,211,71,53,8,10,140,132,89,71,7,11,43,55,36,31,2,3,19,44,30,26,0,4,14,77,57,44,9,4,20
S01012727,566,335,247,25,63,231,267,101,67,8,26,166,130,95,71,5,19,35,70,53,40,7,6,17,37,34,28,2,4,3,62,52,41,3,8,10
S01012728,572,346,264,22,60,226,251,115,78,7,30,136,153,103,80,6,17,50,48,37,27,3,7,11,57,45,40,3,2,12,63,46,39,3,4,17
S01012729,671,463,391,42,30,208,192,87,68,14,5,105,156,115,94,8,13,41,101,75,64,4,7,26,77,66,59,7,0,11,145,120,106,9,5,25
S01012730,451,291,239,17,35,160,192,82,67,7,8,110,120,95,77,5,13,25,57,45,37,2,6,12,43,38,33,1,4,5,39,31,25,2,4,8
S01012731,626,381,325,24,32,245,227,87,71,8,8,140,189,136,112,11,13,53,77,61,51,4,6,16,55,38,36,0,2,17,78,59,55,1,3,19
S01012732,550,349,289,21,39,201,215,85,66,6,13,130,152,121,103,6,12,31,61,47,39,4,4,14,48,33,30,2,1,15,74,63,51,3,9,11
S01012733,764,657,547,86,24,107,88,52,32,18,2,36,171,147,112,24,11,24,133,115,95,14,6,18,125,113,98,14,1,12,247,230,210,16,4,17
S01012734,425,358,303,40,15,67,33,19,17,2,0,14,88,67,56,4,7,21,77,58,40,13,5,19,61,58,50,7,1,3,166,156,140,14,2,10
S01012735,401,231,198,10,23,170,160,57,49,3,5,103,123,83,69,4,10,40,47,33,28,0,5,14,26,19,16,2,1,7,45,39,36,1,2,6
S01012736,739,521,454,31,36,218,196,84,69,9,6,112,216,163,136,7,20,53,95,83,75,5,3,12,94,74,64,5,5,20,138,117,110,5,2,21
S01012737,634,466,403,46,17,168,145,56,41,11,4,89,167,129,107,17,5,38,102,81,73,4,4,21,71,61,55,4,2,10,149,139,127,10,2,10
S01012738,506,320,270,29,21,186,196,81,59,13,9,115,134,102,85,7,10,32,64,48,46,1,1,16,40,30,26,3,1,10,72,59,54,5,0,13
S01012739,614,527,429,72,26,87,49,27,15,10,2,22,127,94,68,21,5,33,113,102,85,8,9,11,90,85,72,8,5,5,235,219,189,25,5,16
S01012740,624,524,430,71,23,100,88,48,32,14,2,40,150,126,98,18,10,24,109,93,76,12,5,16,63,58,47,10,1,5,214,199,177,17,5,15
S01012741,489,385,335,37,13,104,88,46,36,8,2,42,102,85,73,7,5,17,87,73,63,9,1,14,85,74,70,4,0,11,127,107,93,9,5,20
S01012742,593,398,347,41,10,195,109,42,26,11,5,67,100,69,60,8,1,31,95,72,63,8,1,23,80,57,55,2,0,23,209,158,143,12,3,51
S01012743,506,334,291,32,11,172,75,24,18,6,0,51,106,79,66,10,3,27,100,71,59,7,5,29,69,54,52,2,0,15,156,106,96,7,3,50
S01012744,575,441,393,35,13,134,95,42,33,7,2,53,104,84,75,8,1,20,129,105,91,8,6,24,93,83,76,3,4,10,154,127,118,9,0,27
S01012745,602,373,319,37,17,229,141,39,32,6,1,102,129,83,68,12,3,46,73,56,48,5,3,17,68,47,43,3,1,21,191,148,128,11,9,43
S01012746,630,474,406,44,24,156,126,56,45,7,4,70,172,138,112,20,6,34,102,89,81,6,2,13,84,72,59,5,8,12,146,119,109,6,4,27
S01012747,684,432,347,33,52,252,185,73,49,6,18,112,181,126,100,11,15,55,106,73,60,7,6,33,83,69,55,6,8,14,129,91,83,3,5,38
S01012748,648,372,283,30,59,276,309,124,94,8,22,185,177,125,97,9,19,52,63,42,29,6,7,21,45,38,26,5,7,7,54,43,37,2,4,11
S01012749,685,428,307,39,82,257,266,116,78,9,29,150,215,159,108,17,34,56,63,49,40,4,5,14,68,52,40,1,11,16,73,52,41,8,3,21
S01012750,615,402,315,23,64,213,237,110,77,8,25,127,205,144,111,11,22,61,64,55,50,0,5,9,52,47,39,3,5,5,57,46,38,1,7,11
S01012751,706,379,307,28,44,327,327,87,65,9,13,240,190,144,116,8,20,46,67,53,46,1,6,14,51,42,33,5,4,9,71,53,47,5,1,18
S01012752,670,451,367,37,47,219,233,91,69,11,11,142,171,137,104,10,23,34,84,67,52,6,9,17,57,47,44,2,1,10,125,109,98,8,3,16
S01012753,386,227,182,15,30,159,167,65,54,2,9,102,106,73,56,7,10,33,51,39,28,4,7,12,28,23,21,0,2,5,34,27,23,2,2,7
S01012754,476,280,220,24,36,196,179,59,42,8,9,120,115,80,64,5,11,35,60,48,33,5,10,12,52,38,34,0,4,14,70,55,47,6,2,15
S01012755,442,217,165,9,43,225,208,51,33,1,17,157,115,74,54,2,18,41,36,27,22,2,3,9,28,21,20,1,0,7,55,44,36,3,5,11
S01012756,460,220,183,22,15,240,211,41,34,5,2,170,101,67,56,3,8,34,53,40,31,7,2,13,38,31,29,0,2,7,57,41,33,7,1,16
S01012757,400,229,193,17,19,171,196,64,50,7,7,132,99,78,67,5,6,21,36,28,23,4,1,8,36,33,29,0,4,3,33,26,24,1,1,7
S01012758,499,296,237,28,31,203,178,57,36,11,10,121,123,88,67,6,15,35,75,59,49,6,4,16,54,43,39,2,2,11,69,49,46,3,0,20
S01012759,585,345,278,24,43,240,247,84,66,6,12,163,169,130,100,8,22,39,58,46,35,6,5,12,56,46,42,1,3,10,55,39,35,3,1,16
S01012760,784,438,342,25,71,346,301,88,68,4,16,213,209,145,111,7,27,64,97,70,56,3,11,27,77,61,44,4,13,16,100,74,63,7,4,26
S01012761,654,418,341,34,43,236,250,86,60,14,12,164,173,135,109,10,16,38,84,67,58,2,7,17,64,53,44,3,6,11,83,77,70,5,2,6
S01012762,609,372,325,28,19,237,218,74,57,9,8,144,162,120,108,6,6,42,83,66,62,2,2,17,67,54,46,6,2,13,79,58,52,5,1,21
S01012763,349,210,183,11,16,139,156,63,54,5,4,93,79,62,50,3,9,17,54,41,40,0,1,13,30,24,20,3,1,6,30,20,19,0,1,10
S01012764,623,372,305,26,41,251,227,80,63,5,12,147,173,123,97,8,18,50,91,69,63,1,5,22,63,49,41,4,4,14,69,51,41,8,2,18
S01012765,586,379,319,27,33,207,199,69,51,5,13,130,141,112,92,7,13,29,89,76,67,7,2,13,67,49,46,0,3,18,90,73,63,8,2,17
S01012766,693,470,393,37,40,223,223,93,70,9,14,130,206,154,129,7,18,52,106,88,76,10,2,18,71,57,50,3,4,14,87,78,68,8,2,9
S01012767,483,323,279,30,14,160,113,47,36,10,1,66,137,99,86,9,4,38,77,57,51,2,4,20,71,56,45,7,4,15,85,64,61,2,1,21
S01012768,616,433,384,33,16,183,163,75,61,10,4,88,144,115,102,6,7,29,116,94,83,9,2,22,68,58,53,3,2,10,125,91,85,5,1,34
S01012769,358,251,209,36,6,107,67,22,19,2,1,45,91,63,53,10,0,28,71,55,42,9,4,16,41,31,28,2,1,10,88,80,67,13,0,8
S01012770,698,431,354,39,38,267,235,69,51,9,9,166,179,131,99,15,17,48,97,75,70,2,3,22,76,60,50,5,5,16,111,96,84,8,4,15
S01012771,602,372,305,30,37,230,212,70,52,8,10,142,139,95,80,6,9,44,88,69,53,9,7,19,56,49,38,4,7,7,107,89,82,3,4,18
S01012772,544,333,270,23,40,211,254,100,72,12,16,154,138,109,93,3,13,29,65,50,41,3,6,15,50,43,37,3,3,7,37,31,27,2,2,6
S01012773,731,437,358,36,43,294,280,89,69,9,11,191,181,126,94,12,20,55,93,76,67,7,2,17,71,56,46,4,6,15,106,90,82,4,4,16
S01012774,745,516,427,33,56,229,275,117,83,12,22,158,180,151,124,6,21,29,80,75,68,4,3,5,74,65,58,2,5,9,136,108,94,9,5,28
S01012775,369,227,179,24,24,142,126,40,25,7,8,86,94,68,53,11,4,26,50,36,28,3,5,14,34,28,23,1,4,6,65,55,50,2,3,10
S01012776,637,391,325,23,43,246,277,111,92,2,17,166,171,126,102,11,13,45,80,62,55,5,2,18,57,48,38,3,7,9,52,44,38,2,4,8
S01012777,710,566,485,51,30,144,139,67,49,13,5,72,210,174,142,16,16,36,127,106,94,6,6,21,108,100,89,10,1,8,126,119,111,6,2,7
S01012778,543,385,311,24,50,158,144,62,42,5,15,82,168,124,94,9,21,44,68,57,52,2,3,11,67,59,52,3,4,8,96,83,71,5,7,13
S01012779,340,244,189,21,34,96,123,69,50,7,12,54,113,86,61,6,19,27,43,34,29,3,2,9,29,27,24,2,1,2,32,28,25,3,0,4
S01012780,567,335,268,19,48,232,228,73,59,3,11,155,177,132,97,7,28,45,55,42,37,3,2,13,50,42,36,3,3,8,57,46,39,3,4,11
S01012781,554,360,300,39,21,194,146,50,36,11,3,96,132,97,76,10,11,35,75,54,45,6,3,21,70,56,50,5,1,14,131,103,93,7,3,28
S01012782,509,291,231,16,44,218,249,102,70,8,24,147,134,86,67,4,15,48,46,36,30,3,3,10,44,38,36,0,2,6,36,29,28,1,0,7
S01012783,558,351,269,22,60,207,230,97,68,8,21,133,170,129,98,6,25,41,53,41,34,1,6,12,45,36,26,5,5,9,60,48,43,2,3,12
S01012784,629,408,344,17,47,221,234,89,64,8,17,145,161,119,99,6,14,42,82,68,65,0,3,14,67,63,57,0,6,4,85,69,59,3,7,16
S01012785,617,341,260,20,61,276,301,102,70,8,24,199,159,113,87,7,19,46,66,54,46,1,7,12,41,35,26,1,8,6,50,37,31,3,3,13
S01012786,589,347,242,15,90,242,250,95,58,5,32,155,150,117,79,9,29,33,70,39,24,0,15,31,55,43,33,0,10,12,64,53,48,1,4,11
S01012787,447,332,293,24,15,115,105,42,30,7,5,63,118,87,73,6,8,31,61,50,47,3,0,11,47,43,39,3,1,4,116,110,104,5,1,6
S01012788,495,300,227,20,53,195,224,87,57,7,23,137,138,104,81,5,18,34,51,41,36,0,5,10,28,23,18,3,2,5,54,45,35,5,5,9
S01012789,619,389,317,40,32,230,175,67,46,10,11,108,142,96,79,7,10,46,88,70,60,5,5,18,65,55,47,5,3,10,149,101,85,13,3,48
S01012790,507,368,319,37,12,139,93,23,17,6,0,70,85,58,50,5,3,27,70,62,56,3,3,8,50,41,37,2,2,9,209,184,159,21,4,25
S01012791,607,332,284,36,12,275,128,25,18,5,2,103,107,60,53,6,1,47,94,59,49,7,3,35,76,58,51,6,1,18,202,130,113,12,5,72
S01012792,872,465,387,37,41,407,343,70,49,13,8,273,177,131,107,9,15,46,107,74,66,4,4,33,77,61,50,6,5,16,168,129,115,5,9,39
S01012793,690,356,264,23,69,334,271,80,61,9,10,191,149,101,70,7,24,48,110,59,38,1,20,51,62,39,27,0,12,23,98,77,68,6,3,21
S01012794,551,361,301,39,21,190,125,42,35,2,5,83,114,81,60,13,8,33,71,58,48,7,3,13,60,51,45,6,0,9,181,129,113,11,5,52
S01012795,868,494,377,41,76,374,408,154,115,9,30,254,214,161,122,11,28,53,83,63,47,7,9,20,72,53,43,5,5,19,91,63,50,9,4,28
S01012796,611,449,365,37,47,162,184,80,61,11,8,104,178,154,124,8,22,24,76,66,54,3,9,10,63,55,43,11,1,8,110,94,83,4,7,16
S01012797,548,389,317,18,54,159,215,115,71,10,34,100,132,100,84,4,12,32,61,52,45,2,5,9,53,45,42,1,2,8,87,77,75,1,1,10
S01012798,593,359,275,67,17,234,112,37,26,8,3,75,92,62,42,14,6,30,79,43,39,3,1,36,55,38,27,10,1,17,255,179,141,32,6,76
S01012799,666,388,294,83,11,278,136,32,20,11,1,104,83,49,36,10,3,34,87,51,42,7,2,36,59,46,34,10,2,13,301,210,162,45,3,91
S01012800,734,474,350,100,24,260,115,45,32,13,0,70,119,74,53,16,5,45,118,75,56,13,6,43,87,64,41,17,6,23,295,216,168,41,7,79
S01012801,390,202,150,40,12,188,94,27,18,6,3,67,60,30,24,3,3,30,53,30,24,4,2,23,32,15,12,3,0,17,151,100,72,24,4,51
S01012802,486,331,241,74,16,155,55,26,13,12,1,29,71,43,28,12,3,28,91,65,45,13,7,26,55,41,37,4,0,14,214,156,118,33,5,58
S01012803,573,383,333,33,17,190,79,34,27,6,1,45,120,70,63,2,5,50,111,81,69,7,5,30,59,46,37,4,5,13,204,152,137,14,1,52
S01012804,624,392,309,46,37,232,185,68,55,7,6,117,146,111,80,12,19,35,89,66,53,8,5,23,46,32,27,3,2,14,158,115,94,16,5,43
S01012805,742,479,395,32,52,263,253,107,89,8,10,146,191,140,108,13,19,51,93,68,58,4,6,25,68,56,48,1,7,12,137,108,92,6,10,29
S01012806,583,385,309,40,36,198,148,52,39,10,3,96,135,93,68,8,17,42,81,55,46,4,5,26,67,54,46,5,3,13,152,131,110,13,8,21
S01012807,474,329,254,68,7,145,59,21,10,10,1,38,79,58,40,17,1,21,87,51,39,9,3,36,51,38,35,3,0,13,198,161,130,29,2,37
S01012808,873,545,425,85,35,328,223,57,39,12,6,166,168,111,82,17,12,57,129,93,72,13,8,36,75,61,53,7,1,14,278,223,179,36,8,55
S01012809,531,351,292,31,28,180,91,39,30,6,3,52,115,72,49,10,13,43,63,44,37,3,4,19,55,36,33,2,1,19,207,160,143,10,7,47
S01012810,786,425,337,38,50,361,269,76,58,8,10,193,195,135,102,13,20,60,111,76,65,3,8,35,65,47,37,4,6,18,146,91,75,10,6,55
S01012811,663,388,318,37,33,275,207,59,48,6,5,148,139,94,75,6,13,45,92,66,51,7,8,26,46,34,30,3,1,12,179,135,114,15,6,44
S01012812,557,400,342,41,17,157,119,56,41,10,5,63,130,98,83,10,5,32,79,60,53,5,2,19,66,56,50,3,3,10,163,130,115,13,2,33
S01012813,768,455,378,63,14,313,126,40,27,13,0,86,119,71,56,10,5,48,105,72,63,6,3,33,89,56,51,4,1,33,329,216,181,30,5,113
S01012814,640,513,437,50,26,127,106,62,46,9,7,44,181,142,121,8,13,39,113,88,75,11,2,25,74,72,66,5,1,2,166,149,129,17,3,17
S01012815,625,539,467,48,24,86,90,59,45,11,3,31,155,135,115,12,8,20,93,85,79,2,4,8,90,82,68,9,5,8,197,178,160,14,4,19
S01012816,434,336,274,41,21,98,90,42,29,7,6,48,107,92,69,14,9,15,77,60,54,4,2,17,58,52,42,8,2,6,102,90,80,8,2,12
S01012817,383,334,290,34,10,49,25,17,12,5,0,8,121,101,86,10,5,20,61,49,41,6,2,12,48,43,38,2,3,5,128,124,113,11,0,4
S01012818,627,471,401,45,25,156,111,49,40,6,3,62,170,131,109,10,12,39,117,89,74,10,5,28,78,70,61,8,1,8,151,132,117,11,4,19
S01012819,606,327,258,16,53,279,277,91,67,6,18,186,150,90,66,5,19,60,68,52,45,1,6,16,59,48,40,3,5,11,52,46,40,1,5,6
S01012820,778,660,549,71,40,118,124,88,63,20,5,36,227,181,135,32,14,46,145,124,110,5,9,21,95,90,77,7,6,5,187,177,164,7,6,10
S01012821,553,455,367,56,32,98,93,58,39,12,7,35,163,128,96,20,12,35,76,65,55,9,1,11,66,62,48,6,8,4,155,142,129,9,4,13
S01012822,365,218,158,13,47,147,151,59,43,3,13,92,107,72,45,7,20,35,41,33,27,1,5,8,32,29,20,1,8,3,34,25,23,1,1,9
S01012823,635,525,447,46,32,110,131,76,54,16,6,55,195,165,139,13,13,30,105,93,85,4,4,12,67,61,54,2,5,6,137,130,115,11,4,7
S01012824,521,372,317,30,25,149,139,48,35,7,6,91,127,103,84,10,9,24,76,57,51,2,4,19,79,74,63,8,3,5,100,90,84,3,3,10
S01012825,420,240,204,10,26,180,183,61,46,4,11,122,91,66,55,2,9,25,44,38,35,2,1,6,47,38,33,2,3,9,55,37,35,0,2,18
S01012826,439,285,206,16,63,154,162,71,42,9,20,91,150,115,82,3,30,35,52,42,35,0,7,10,29,21,15,2,4,8,46,36,32,2,2,10
S01012827,478,403,349,37,17,75,71,49,39,7,3,22,120,98,81,10,7,22,86,70,58,8,4,16,67,61,55,4,2,6,134,125,116,8,1,9
S01012828,462,402,354,34,14,60,64,37,30,4,3,27,108,95,79,10,6,13,84,74,68,6,0,10,80,76,65,8,3,4,126,120,112,6,2,6
S01012829,653,397,306,31,60,256,303,133,101,13,19,170,188,133,100,7,26,55,62,53,42,3,8,9,47,33,25,4,4,14,53,45,38,4,3,8
S01012830,565,327,261,40,26,238,236,81,59,13,9,155,115,85,71,9,5,30,87,65,49,8,8,22,50,39,35,3,1,11,77,57,47,7,3,20
S01012831,560,263,212,23,28,297,266,60,47,7,6,206,110,66,48,7,11,44,69,50,42,2,6,19,50,39,33,3,3,11,65,48,42,4,2,17
S01012832,436,288,228,32,28,148,149,63,44,10,9,86,105,82,65,6,11,23,61,46,35,7,4,15,45,34,30,2,2,11,76,63,54,7,2,13
S01012833,572,306,247,13,46,266,265,87,68,4,15,178,168,113,87,5,21,55,40,29,23,1,5,11,43,36,31,1,4,7,56,41,38,2,1,15
S01012834,561,335,249,39,47,226,241,90,61,16,13,151,130,96,64,10,22,34,59,46,36,5,5,13,48,37,31,1,5,11,83,66,57,7,2,17
S01012835,771,429,355,39,35,342,253,66,52,7,7,187,191,110,94,4,12,81,88,68,56,6,6,20,68,55,43,6,6,13,171,130,110,16,4,41
S01012836,527,405,339,54,12,122,83,31,20,10,1,52,108,82,62,14,6,26,112,93,81,10,2,19,71,63,55,6,2,8,153,136,121,14,1,17
S01012837,579,355,236,20,99,224,216,89,53,5,31,127,197,138,92,7,39,59,73,55,40,3,12,18,58,40,30,1,9,18,35,33,21,4,8,2
S01012838,708,425,284,17,124,283,278,121,70,6,45,157,214,148,94,5,49,66,67,49,35,2,12,18,69,50,40,1,9,19,80,57,45,3,9,23
S01012839,578,424,359,49,16,154,133,55,43,9,3,78,158,128,102,22,4,30,103,86,74,8,4,17,60,51,47,3,1,9,124,104,93,7,4,20
S01012840,584,476,409,52,15,108,71,39,29,4,6,32,127,101,77,22,2,26,101,83,72,8,3,18,93,81,76,4,1,12,192,172,155,14,3,20
S01012841,497,358,299,39,20,139,108,36,27,9,0,72,103,83,69,8,6,20,87,76,62,9,5,11,56,47,42,2,3,9,143,116,99,11,6,27
S01012842,407,309,271,29,9,98,103,62,56,4,2,41,93,70,64,4,2,23,58,49,47,1,1,9,38,33,28,4,1,5,115,95,76,16,3,20
S01012843,774,511,419,72,20,263,121,37,17,19,1,84,118,76,59,13,4,42,119,85,75,5,5,34,72,51,44,5,2,21,344,262,224,30,8,82
S01012844,561,387,301,70,16,174,66,27,15,11,1,39,73,46,33,10,3,27,97,66,54,9,3,31,50,37,30,4,3,13,275,211,169,36,6,64
S01012845,554,348,269,62,17,206,96,34,21,9,4,62,88,57,37,15,5,31,92,54,44,7,3,38,55,40,28,10,2,15,223,163,139,21,3,60
S01012846,807,406,323,36,47,401,347,75,55,7,13,272,181,111,84,8,19,70,86,72,60,2,10,14,82,64,48,12,4,18,111,84,76,7,1,27
S01012847,456,288,232,34,22,168,148,46,32,10,4,102,113,78,56,10,12,35,81,61,51,7,3,20,47,42,36,4,2,5,67,61,57,3,1,6
S01012848,582,404,333,50,21,178,112,35,28,5,2,77,152,113,89,16,8,39,82,65,56,5,4,17,68,52,42,7,3,16,168,139,118,17,4,29
S01012849,564,388,333,18,37,176,145,44,32,6,6,101,153,116,90,5,21,37,67,58,53,3,2,9,83,72,69,2,1,11,116,98,89,2,7,18
S01012850,623,332,282,23,27,291,279,86,76,4,6,193,154,113,92,7,14,41,78,60,48,7,5,18,55,36,32,4,0,19,57,37,34,1,2,20
S01012851,698,398,331,39,28,300,244,82,67,10,5,162,153,88,69,11,8,65,78,61,50,4,7,17,63,45,36,6,3,18,160,122,109,8,5,38
S01012852,592,382,322,39,21,210,100,26,16,9,1,74,107,68,53,9,6,39,103,84,70,6,8,19,77,55,47,4,4,22,205,149,136,11,2,56
S01012853,688,404,337,45,22,284,207,62,49,11,2,145,143,85,75,7,3,58,83,62,52,4,6,21,90,71,59,8,4,19,165,124,102,15,7,41
S01012854,695,512,441,48,23,183,111,49,39,7,3,62,139,92,75,12,5,47,124,94,81,9,4,30,85,72,59,6,7,13,236,205,187,14,4,31
S01012855,539,425,360,38,27,114,79,31,22,4,5,48,113,83,65,10,8,30,106,94,83,6,5,12,51,45,39,3,3,6,190,172,151,15,6,18
S01012856,608,326,273,26,27,282,237,54,39,5,10,183,152,105,88,6,11,47,75,54,45,8,1,21,57,40,35,4,1,17,87,73,66,3,4,14
S01012857,765,345,293,18,34,420,366,74,62,5,7,292,166,107,82,7,18,59,85,63,56,4,3,22,58,37,31,2,4,21,90,64,62,0,2,26
S01012858,621,370,309,26,35,251,234,66,53,5,8,168,142,101,82,7,12,41,60,50,41,5,4,10,74,54,42,4,8,20,111,99,91,5,3,12
S01012859,845,565,444,58,63,280,270,106,77,17,12,164,217,170,128,12,30,47,107,82,70,6,6,25,102,77,56,9,12,25,149,130,113,14,3,19
S01012860,948,403,332,52,19,545,375,51,41,6,4,324,192,101,80,14,7,91,111,73,58,11,4,38,77,43,36,5,2,34,193,135,117,16,2,58
S01012861,592,400,327,48,25,192,145,50,35,10,5,95,113,81,60,13,8,32,84,62,51,7,4,22,71,56,48,6,2,15,179,151,133,12,6,28
S01012862,519,284,227,16,41,235,219,65,46,4,15,154,137,99,79,6,14,38,44,27,21,2,4,17,61,42,38,1,3,19,58,51,43,3,5,7
S01012863,556,357,280,11,66,199,202,72,49,3,20,130,153,113,91,4,18,40,66,53,40,2,11,13,53,45,37,0,8,8,82,74,63,2,9,8
S01012864,660,417,319,28,70,243,230,82,53,8,21,148,178,135,96,10,29,43,83,60,48,5,7,23,78,68,61,2,5,10,91,72,61,3,8,19
S01012865,670,344,290,35,19,326,292,78,64,9,5,214,145,89,73,9,7,56,67,53,46,3,4,14,67,49,39,8,2,18,99,75,68,6,1,24
S01012866,638,413,340,28,45,225,227,92,78,4,10,135,177,131,100,10,21,46,87,68,52,8,8,19,53,38,33,2,3,15,94,84,77,4,3,10
S01012867,645,299,245,15,39,346,352,101,85,5,11,251,152,103,83,6,14,49,59,40,31,1,8,19,39,25,22,0,3,14,43,30,24,3,3,13
S01012868,501,298,234,19,45,203,234,96,69,6,21,138,122,80,62,5,13,42,55,42,34,0,8,13,42,38,35,2,1,4,48,42,34,6,2,6
S01012869,424,258,185,10,63,166,197,92,63,1,28,105,134,98,71,2,25,36,35,26,19,4,3,9,30,19,15,0,4,11,28,23,17,3,3,5
S01012870,806,469,397,48,24,337,262,86,69,12,5,176,214,149,122,18,9,65,124,77,63,9,5,47,80,63,57,2,4,17,126,94,86,7,1,32
S01012871,699,424,353,42,29,275,185,61,39,15,7,124,171,114,99,4,11,57,92,70,56,5,9,22,82,52,46,5,1,30,169,127,113,13,1,42
S01012872,577,414,353,27,34,163,122,56,42,9,5,66,159,118,98,7,13,41,91,73,62,4,7,18,85,63,55,5,3,22,120,104,96,2,6,16
S01012873,655,465,398,36,31,190,177,93,75,8,10,84,183,134,107,13,14,49,109,85,77,5,3,24,61,45,42,2,1,16,125,108,97,8,3,17
S01012874,638,373,297,30,46,265,239,86,64,8,14,153,155,109,82,9,18,46,89,58,48,4,6,31,56,45,39,2,4,11,99,75,64,7,4,24
S01012875,486,311,245,26,40,175,169,68,55,6,7,101,121,86,57,11,18,35,71,53,43,4,6,18,53,43,36,2,5,10,72,61,54,3,4,11
S01012876,665,348,295,21,32,317,295,81,68,8,5,214,184,134,108,7,19,50,68,44,36,5,3,24,60,45,42,0,3,15,58,44,41,1,2,14
S01012877,631,345,295,23,27,286,300,98,81,9,8,202,157,109,91,7,11,48,74,60,50,4,6,14,56,49,47,2,0,7,44,29,26,1,2,15
S01012878,774,548,459,64,25,226,121,41,32,7,2,80,163,121,99,13,9,42,175,142,119,18,5,33,84,65,53,7,5,19,231,179,156,19,4,52
S01012879,609,381,318,37,26,228,111,36,24,6,6,75,114,65,48,9,8,49,122,84,71,4,9,38,74,53,48,4,1,21,188,143,127,14,2,45
S01012880,759,463,385,60,18,296,122,28,22,4,2,94,110,64,49,10,5,46,131,93,79,12,2,38,83,63,56,3,4,20,313,215,179,31,5,98
S01012881,774,401,323,57,21,373,195,32,24,6,2,163,133,75,56,13,6,58,105,67,53,8,6,38,73,50,39,8,3,23,268,177,151,22,4,91
S01012882,494,291,230,22,39,203,200,85,60,5,20,115,137,84,62,5,17,53,62,48,43,3,2,14,42,33,30,3,0,9,53,41,35,6,0,12
S01012883,529,247,166,21,60,282,251,64,35,9,20,187,153,91,58,8,25,62,46,34,26,1,7,12,29,20,14,2,4,9,50,38,33,1,4,12
S01012884,451,224,173,27,24,227,166,33,19,6,8,133,80,48,35,4,9,32,38,25,15,6,4,13,41,30,25,3,2,11,126,88,79,8,1,38
S01012885,391,232,179,18,35,159,186,62,43,7,12,124,118,97,79,3,15,21,28,23,17,4,2,5,30,24,22,1,1,6,29,26,18,3,5,3
S01012886,651,410,345,45,20,241,125,38,30,5,3,87,134,86,69,8,9,48,88,55,48,7,0,33,75,58,49,8,1,17,229,173,149,17,7,56
S01012887,631,372,323,38,11,259,127,31,21,6,4,96,109,57,51,4,2,52,105,82,72,9,1,23,59,41,38,3,0,18,231,161,141,16,4,70
S01012888,694,396,317,60,19,298,114,23,20,3,0,91,99,58,44,8,6,41,107,66,53,9,4,41,78,52,34,13,5,26,296,197,166,27,4,99
S01012889,661,507,430,57,20,154,132,54,40,10,4,78,160,130,102,21,7,30,106,92,81,9,2,14,70,59,49,6,4,11,193,172,158,11,3,21
S01012890,549,322,254,24,44,227,197,73,54,8,11,124,161,98,75,3,20,63,65,46,34,5,7,19,53,43,35,4,4,10,73,62,56,4,2,11
S01012891,456,265,210,33,22,191,190,63,53,5,5,127,109,77,58,9,10,32,51,40,32,5,3,11,36,29,24,5,0,7,70,56,43,9,4,14
S01012892,930,521,410,31,80,409,402,130,95,10,25,272,278,199,152,8,39,79,90,69,53,6,10,21,71,55,50,3,2,16,89,68,60,4,4,21
S01012893,598,336,275,14,47,262,274,100,78,7,15,174,178,128,105,3,20,50,66,53,47,2,4,13,40,34,28,0,6,6,40,21,17,2,2,19
S01012894,606,446,365,56,25,160,117,40,32,6,2,77,141,109,90,11,8,32,109,85,71,10,4,24,71,60,53,5,2,11,168,152,119,24,9,16
S01012895,411,322,256,52,14,89,65,36,20,13,3,29,95,77,59,15,3,18,76,61,50,8,3,15,54,44,38,5,1,10,121,104,89,11,4,17
S01012896,761,416,333,35,48,345,279,86,63,11,12,193,177,109,86,7,16,68,101,73,59,5,9,28,76,61,54,1,6,15,128,87,71,11,5,41
S01012897,473,355,299,40,16,118,93,35,26,5,4,58,105,80,66,10,4,25,66,49,41,6,2,17,68,63,54,5,4,5,141,128,112,14,2,13
S01012898,401,345,295,38,12,56,35,18,15,1,2,17,93,73,56,14,3,20,81,72,64,4,4,9,50,47,42,3,2,3,142,135,118,16,1,7
S01012899,477,280,224,18,38,197,186,65,54,4,7,121,126,91,71,4,16,35,62,42,37,3,2,20,44,35,27,1,7,9,59,47,35,6,6,12
S01012900,618,320,251,54,15,298,196,39,34,3,2,157,129,82,55,19,8,47,83,61,52,8,1,22,42,35,27,7,1,7,168,103,83,17,3,65
S01012901,569,381,309,34,38,188,138,46,30,7,9,92,146,101,77,11,13,45,112,92,77,5,10,20,72,61,53,4,4,11,101,81,72,7,2,20
S01012902,629,426,345,35,46,203,129,39,30,7,2,90,189,131,101,13,17,58,102,73,64,3,6,29,79,74,61,3,10,5,130,109,89,9,11,21
S01012903,683,443,369,32,42,240,176,62,45,10,7,114,184,119,92,11,16,65,138,105,97,4,4,33,74,68,60,1,7,6,111,89,75,6,8,22
S01012904,633,414,337,36,41,219,148,54,37,9,8,94,185,127,102,6,19,58,108,82,68,5,9,26,75,59,53,5,1,16,117,92,77,11,4,25
S01012905,490,331,267,24,40,159,106,40,31,3,6,66,158,121,89,8,24,37,83,63,54,3,6,20,81,63,53,7,3,18,62,44,40,3,1,18
S01012906,783,537,459,40,38,246,171,53,41,10,2,118,181,134,110,9,15,47,145,119,103,8,8,26,106,89,73,8,8,17,180,142,132,5,5,38
S01012907,736,430,363,33,34,306,240,45,33,5,7,195,199,156,127,15,14,43,99,72,59,5,8,27,73,62,57,3,2,11,125,95,87,5,3,30
S01012908,603,338,278,20,40,265,212,51,37,4,10,161,170,118,94,6,18,52,85,62,50,6,6,23,58,39,36,1,2,19,78,68,61,3,4,10
S01012909,512,293,250,16,27,219,176,41,29,3,9,135,118,81,66,7,8,37,80,59,54,3,2,21,58,49,43,1,5,9,80,63,58,2,3,17
S01012910,774,420,325,40,55,354,290,67,46,12,9,223,190,140,110,9,21,50,112,74,62,4,8,38,72,52,40,4,8,20,110,87,67,11,9,23
S01012911,631,365,315,27,23,266,157,40,35,4,1,117,154,99,80,12,7,55,109,81,67,3,11,28,89,63,57,3,3,26,122,82,76,5,1,40
S01012912,580,319,264,25,30,261,200,42,31,7,4,158,139,95,76,8,11,44,82,59,47,4,8,23,74,59,49,6,4,15,85,64,61,0,3,21
S01012913,732,437,378,29,30,295,206,47,38,5,4,159,190,140,112,12,16,50,122,86,78,3,5,36,78,57,51,3,3,21,136,107,99,6,2,29
S01012914,711,457,380,40,37,254,182,58,48,2,8,124,187,123,90,17,16,64,87,64,55,5,4,23,84,72,66,4,2,12,171,140,121,12,7,31
S01012915,810,600,508,49,43,210,172,65,46,11,8,107,196,146,119,10,17,50,133,115,98,12,5,18,103,89,77,5,7,14,206,185,168,11,6,21
S01012916,572,325,278,22,25,247,136,34,25,5,4,102,119,70,59,5,6,49,109,74,60,5,9,35,63,44,38,4,2,19,145,103,96,3,4,42
S01012917,587,386,327,47,12,201,83,25,21,3,1,58,129,88,75,9,4,41,134,103,88,12,3,31,69,53,47,5,1,16,172,117,96,18,3,55
S01012918,417,278,242,18,18,139,99,29,27,1,1,70,108,78,63,3,12,30,80,69,60,6,3,11,48,37,34,2,1,11,82,65,58,6,1,17
S01012919,397,225,189,15,21,172,114,27,23,1,3,87,107,85,67,3,15,22,53,35,30,4,1,18,39,20,19,0,1,19,84,58,50,7,1,26
S01012920,506,283,220,44,19,223,79,18,11,6,1,61,100,51,36,9,6,49,98,68,52,9,7,30,50,34,30,3,1,16,179,112,91,17,4,67
S01012921,594,370,318,20,32,224,193,54,47,3,4,139,162,125,101,7,17,37,96,78,68,5,5,18,56,46,42,3,1,10,87,67,60,2,5,20
S01012922,784,545,468,32,45,239,164,50,42,0,8,114,190,140,112,15,13,50,133,104,92,5,7,29,117,99,87,4,8,18,180,152,135,8,9,28
S01012923,578,395,335,33,27,183,119,42,32,6,4,77,145,97,75,9,13,48,111,87,76,7,4,24,79,63,53,4,6,16,124,106,99,7,0,18
S01012924,422,286,237,32,17,136,105,45,32,9,4,60,103,72,55,11,6,31,67,50,42,4,4,17,66,57,51,5,1,9,81,62,57,3,2,19
S01012925,413,271,235,23,13,142,57,18,11,6,1,39,100,67,58,5,4,33,68,48,39,5,4,20,53,38,34,1,3,15,135,100,93,6,1,35
S01012926,593,411,343,46,22,182,99,42,28,9,5,57,173,124,100,15,9,49,114,91,79,9,3,23,75,56,47,7,2,19,132,98,89,6,3,34
S01012927,628,408,340,36,32,220,141,33,28,2,3,108,167,111,92,9,10,56,123,98,81,7,10,25,78,63,51,6,6,15,119,103,88,12,3,16
S01012928,675,433,371,37,25,242,130,47,39,5,3,83,147,95,82,7,6,52,135,103,86,10,7,32,69,56,52,2,2,13,194,132,112,13,7,62
S01012929,641,370,325,23,22,271,158,38,32,3,3,120,141,88,75,6,7,53,130,91,79,5,7,39,73,58,52,4,2,15,139,95,87,5,3,44
S01012930,779,410,333,44,33,369,247,42,26,8,8,205,135,84,66,11,7,51,99,75,60,10,5,24,90,68,61,3,4,22,208,141,120,12,9,67
S01012931,730,445,380,36,29,285,224,64,47,9,8,160,147,92,81,4,7,55,121,99,86,7,6,22,83,67,56,6,5,16,155,123,110,10,3,32
S01012932,423,281,218,46,17,142,87,37,28,8,1,50,99,58,44,11,3,41,73,48,37,7,4,25,40,31,23,5,3,9,124,107,86,15,6,17
S01012933,675,429,364,34,31,246,204,67,56,6,5,137,164,117,89,10,18,47,101,82,70,8,4,19,69,57,50,4,3,12,137,106,99,6,1,31
S01012934,605,317,260,35,22,288,216,54,35,9,10,162,131,82,70,9,3,49,77,57,48,8,1,20,61,50,43,4,3,11,120,74,64,5,5,46
S01012935,717,466,394,31,41,251,185,50,40,0,10,135,203,148,121,16,11,55,116,92,77,7,8,24,73,60,51,4,5,13,140,116,105,4,7,24
S01012936,619,382,318,38,26,237,163,53,43,4,6,110,144,92,76,9,7,52,93,71,61,8,2,22,77,62,50,8,4,15,142,104,88,9,7,38
S01012937,581,397,323,23,51,184,147,64,48,9,7,83,136,103,84,2,17,33,89,60,48,1,11,29,76,62,51,5,6,14,133,108,92,6,10,25
S01012938,600,348,276,44,28,252,141,28,16,10,2,113,110,64,50,8,6,46,91,65,48,6,11,26,51,40,35,1,4,11,207,151,127,19,5,56
S01012939,500,360,305,37,18,140,72,30,24,6,0,42,93,65,51,5,9,28,116,94,82,9,3,22,68,49,40,6,3,19,151,122,108,11,3,29
S01012940,579,432,360,61,11,147,85,38,29,8,1,47,118,84,63,15,6,34,109,83,71,9,3,26,63,51,47,4,0,12,204,176,150,25,1,28
S01012941,600,461,382,58,21,139,50,27,17,10,0,23,117,82,64,10,8,35,134,99,82,8,9,35,61,52,46,5,1,9,238,201,173,25,3,37
S01012942,624,392,325,22,45,232,177,61,51,2,8,116,185,127,99,7,21,58,80,55,46,4,5,25,72,57,49,3,5,15,110,92,80,6,6,18
S01012943,575,411,359,33,19,164,98,41,31,8,2,57,138,89,75,9,5,49,94,71,65,2,4,23,91,74,70,3,1,17,154,136,118,11,7,18
S01012944,418,263,224,28,11,155,68,16,10,6,0,52,80,53,48,2,3,27,94,60,54,3,3,34,41,32,31,1,0,9,135,102,81,16,5,33
S01012945,568,420,346,56,18,148,67,22,16,6,0,45,98,65,53,8,4,33,120,93,73,14,6,27,58,48,38,9,1,10,225,192,166,19,7,33
S01012946,691,522,450,51,21,169,103,47,37,9,1,56,136,101,81,13,7,35,154,118,104,8,6,36,87,75,61,12,2,12,211,181,167,9,5,30
S01012947,372,273,212,49,12,99,40,19,14,3,2,21,85,54,37,15,2,31,88,67,52,8,7,21,42,35,32,3,0,7,117,98,77,20,1,19
S01012948,572,422,352,50,20,150,96,44,33,10,1,52,135,98,78,11,9,37,112,91,79,9,3,21,77,64,56,5,3,13,152,125,106,15,4,27
S01012949,595,424,361,47,16,171,110,38,30,8,0,72,115,87,73,10,4,28,135,106,88,10,8,29,65,57,51,5,1,8,170,136,119,14,3,34
S01012950,678,542,460,57,25,136,56,27,21,5,1,29,166,129,101,15,13,37,162,130,118,7,5,32,74,62,51,7,4,12,220,194,169,23,2,26
S01012951,649,563,471,72,20,86,34,23,17,3,3,11,110,83,60,17,6,27,119,100,83,12,5,19,100,92,82,9,1,8,286,265,229,31,5,21
S01012952,525,297,188,106,3,228,72,33,20,13,0,39,99,56,35,20,1,43,96,58,39,18,1,38,42,24,13,10,1,18,216,126,81,45,0,90
S01012953,568,417,367,34,16,151,84,31,21,9,1,53,139,107,96,6,5,32,120,96,84,7,5,24,72,62,58,3,1,10,153,121,108,9,4,32
S01012954,392,307,259,26,22,85,58,28,22,4,2,30,107,83,65,9,9,24,75,65,54,5,6,10,54,45,38,5,2,9,98,86,80,3,3,12
S01012955,763,528,456,48,24,235,128,49,34,10,5,79,131,86,73,8,5,45,131,99,82,12,5,32,74,52,45,3,4,22,299,242,222,15,5,57
S01012956,851,432,357,35,40,419,294,60,47,6,7,234,200,120,93,8,19,80,117,94,79,9,6,23,86,67,57,5,5,19,154,91,81,7,3,63
S01012957,540,338,278,30,30,202,163,60,45,10,5,103,146,103,83,9,11,43,84,67,58,3,6,17,49,35,30,2,3,14,98,73,62,6,5,25
S01012958,435,315,263,31,21,120,103,44,31,9,4,59,125,95,78,6,11,30,62,51,41,6,4,11,57,45,42,1,2,12,88,80,71,9,0,8
S01012959,466,373,320,33,20,93,59,32,24,5,3,27,137,102,80,15,7,35,92,79,66,6,7,13,61,54,52,2,0,7,117,106,98,5,3,11
S01012960,502,350,285,27,38,152,88,36,27,4,5,52,136,99,78,8,13,37,91,69,53,3,13,22,67,51,46,1,4,16,120,95,81,11,3,25
S01012961,416,311,260,40,11,105,66,27,19,7,1,39,99,74,60,9,5,25,95,79,68,8,3,16,52,49,40,8,1,3,104,82,73,8,1,22
S01012962,555,395,340,36,19,160,90,31,23,6,2,59,118,89,76,6,7,29,125,93,81,8,4,32,74,63,53,6,4,11,148,119,107,10,2,29
S01012963,616,488,417,48,23,128,75,40,31,6,3,35,144,115,88,16,11,29,122,92,82,6,4,30,78,65,61,3,1,13,197,176,155,17,4,21
S01012964,449,380,322,43,15,69,34,19,14,5,0,15,106,80,65,12,3,26,87,74,64,7,3,13,70,64,50,7,7,6,152,143,129,12,2,9
S01012965,563,350,295,29,26,213,123,30,24,4,2,93,138,98,77,9,12,40,110,72,58,8,6,38,68,52,48,1,3,16,124,98,88,7,3,26
S01012966,593,420,351,45,24,173,116,44,40,2,2,72,194,124,101,14,9,70,87,78,65,9,4,9,77,68,54,10,4,9,119,106,91,10,5,13
S01012967,397,285,241,22,22,112,98,57,48,4,5,41,126,99,84,6,9,27,56,40,36,1,3,16,56,39,33,4,2,17,61,50,40,7,3,11
S01012968,517,365,301,31,33,152,133,71,57,9,5,62,173,121,99,8,14,52,78,64,50,8,6,14,61,50,42,4,4,11,72,59,53,2,4,13
S01012969,570,355,296,26,33,215,199,78,62,8,8,121,143,102,83,5,14,41,73,58,51,1,6,15,70,54,48,3,3,16,85,63,52,9,2,22
S01012970,489,337,280,30,27,152,161,67,53,8,6,94,139,114,95,8,11,25,76,60,47,8,5,16,52,47,41,4,2,5,61,49,44,2,3,12
S01012971,638,433,348,28,57,205,171,73,56,7,10,98,218,155,117,6,32,63,93,78,70,3,5,15,69,54,43,4,7,15,87,73,62,8,3,14
S01012972,612,398,334,33,31,214,192,65,52,9,4,127,198,155,123,13,19,43,85,70,61,6,3,15,65,56,50,4,2,9,72,52,48,1,3,20
S01012973,647,419,364,25,30,228,215,72,59,7,6,143,179,141,118,10,13,38,89,76,70,3,3,13,83,69,62,2,5,14,81,61,55,3,3,20
S01012974,884,458,367,38,53,426,353,83,60,10,13,270,208,134,105,15,14,74,101,76,62,4,10,25,101,82,65,7,10,19,121,83,75,2,6,38
S01012975,491,294,255,15,24,197,188,58,54,1,3,130,141,115,99,5,11,26,62,49,41,4,4,13,44,30,27,1,2,14,56,42,34,4,4,14
S01012976,427,266,222,16,28,161,137,42,34,3,5,95,127,99,79,6,14,28,53,42,36,2,4,11,49,39,32,2,5,10,61,44,41,3,0,17
S01012977,559,395,322,28,45,164,124,63,51,9,3,61,207,149,113,10,26,58,90,70,56,4,10,20,69,52,47,2,3,17,69,61,55,3,3,8
S01012978,647,427,339,33,55,220,218,99,83,9,7,119,201,147,109,13,25,54,82,68,48,2,18,14,76,57,48,4,5,19,70,56,51,5,0,14
S01012979,516,349,302,30,17,167,147,59,47,7,5,88,146,110,97,7,6,36,73,55,48,4,3,18,54,50,45,4,1,4,96,75,65,8,2,21
S01012980,527,373,307,23,43,154,138,64,47,7,10,74,183,132,106,7,19,51,74,63,50,5,8,11,62,56,50,3,3,6,70,58,54,1,3,12
S01012981,622,445,378,29,38,177,133,56,51,3,2,77,185,144,113,11,20,41,131,98,87,4,7,33,73,64,58,3,3,9,100,83,69,8,6,17
S01012982,662,460,401,20,39,202,174,70,62,4,4,104,203,158,129,7,22,45,98,76,71,2,3,22,79,68,59,2,7,11,108,88,80,5,3,20
S01012983,633,396,334,33,29,237,119,42,37,2,3,77,169,110,86,10,14,59,97,70,59,7,4,27,89,71,62,4,5,18,159,103,90,10,3,56
S01012984,530,368,316,26,26,162,142,52,42,4,6,90,148,114,94,8,12,34,92,73,66,5,2,19,63,53,44,5,4,10,85,76,70,4,2,9
S01012985,659,427,362,34,31,232,182,68,57,8,3,114,185,129,106,8,15,56,101,81,67,7,7,20,69,56,48,5,3,13,122,93,84,6,3,29
S01012986,626,396,344,25,27,230,186,56,47,5,4,130,158,117,105,4,8,41,91,71,58,7,6,20,82,65,57,4,4,17,109,87,77,5,5,22
S01012987,632,385,314,38,33,247,220,55,43,5,7,165,144,112,90,12,10,32,97,78,61,10,7,19,66,56,50,4,2,10,105,84,70,7,7,21
S01012988,744,421,357,31,33,323,253,61,46,7,8,192,193,130,113,7,10,63,110,77,62,7,8,33,82,70,65,2,3,12,106,83,71,8,4,23
S01012989,809,493,415,31,47,316,231,54,43,6,5,177,210,152,119,9,24,58,137,112,97,7,8,25,94,80,73,3,4,14,137,95,83,6,6,42
S01012990,516,302,262,17,23,214,177,52,43,4,5,125,135,94,78,5,11,41,73,54,52,1,1,19,62,49,43,3,3,13,69,53,46,4,3,16
S01012991,669,410,331,37,42,259,192,47,36,6,5,145,170,121,90,10,21,49,96,77,65,5,7,19,88,71,61,6,4,17,123,94,79,10,5,29
S01012992,659,394,332,26,36,265,191,41,27,7,7,150,183,115,98,5,12,68,103,82,77,1,4,21,77,67,50,9,8,10,105,89,80,4,5,16
S01012993,585,335,284,20,31,250,178,48,39,2,7,130,157,106,87,6,13,51,88,61,52,4,5,27,65,52,47,3,2,13,97,68,59,5,4,29
S01012994,760,477,381,37,59,283,214,72,61,3,8,142,207,141,112,6,23,66,105,75,64,3,8,30,108,95,73,11,11,13,126,94,71,14,9,32
S01012995,662,504,438,34,32,158,128,49,38,7,4,79,173,132,109,9,14,41,128,114,104,4,6,14,95,84,73,6,5,11,138,125,114,8,3,13
S01012996,550,422,352,36,34,128,122,71,48,11,12,51,161,135,113,11,11,26,92,74,66,6,2,18,77,65,59,2,4,12,98,77,66,6,5,21
S01012997,392,229,201,8,20,163,112,31,23,2,6,81,114,80,67,3,10,34,50,31,27,1,3,19,47,35,34,0,1,12,69,52,50,2,0,17
S01012998,837,597,509,54,34,240,195,76,61,12,3,119,210,149,123,14,12,61,157,129,109,8,12,28,102,87,76,9,2,15,173,156,140,11,5,17
S01012999,397,255,220,18,17,142,106,39,31,5,3,67,114,83,71,4,8,31,60,45,43,2,0,15,50,39,30,4,5,11,67,49,45,3,1,18
S01013000,549,345,290,25,30,204,174,54,44,6,4,120,146,109,90,10,9,37,86,69,57,5,7,17,55,46,40,2,4,9,88,67,59,2,6,21
S01013001,321,214,134,67,13,107,52,29,14,14,1,23,54,37,26,7,4,17,38,25,18,7,0,13,26,17,10,7,0,9,151,106,66,32,8,45
S01013002,405,261,178,75,8,144,70,30,15,11,4,40,53,32,19,13,0,21,70,48,32,14,2,22,34,28,22,6,0,6,178,123,90,31,2,55
S01013003,522,302,237,55,10,220,39,17,10,6,1,22,61,29,22,6,1,32,71,46,37,7,2,25,58,39,33,3,3,19,293,171,135,33,3,122
S01013004,533,338,252,72,14,195,84,21,13,8,0,63,92,52,40,8,4,40,68,50,29,17,4,18,50,36,28,6,2,14,239,179,142,33,4,60
S01013005,575,355,245,95,15,220,71,27,17,10,0,44,82,48,27,16,5,34,90,52,39,11,2,38,50,38,25,11,2,12,282,190,137,47,6,92
S01013006,503,327,235,78,14,176,56,29,20,8,1,27,81,50,35,12,3,31,74,46,33,7,6,28,32,26,19,5,2,6,260,176,128,46,2,84
S01013007,798,428,332,73,23,370,100,25,12,7,6,75,115,58,43,12,3,57,123,67,47,17,3,56,65,37,32,4,1,28,395,241,198,33,10,154
S01013008,616,367,272,71,24,249,105,30,23,4,3,75,94,56,33,14,9,38,93,61,45,12,4,32,44,32,24,7,1,12,280,188,147,34,7,92
S01013009,526,291,228,46,17,235,98,21,14,5,2,77,103,67,48,10,9,36,90,66,55,8,3,24,62,40,33,7,0,22,173,97,78,16,3,76
S01013010,481,329,210,105,14,152,64,27,17,10,0,37,67,47,30,15,2,20,80,51,31,15,5,29,51,37,23,13,1,14,219,167,109,52,6,52
S01013011,512,364,268,77,19,148,63,34,22,9,3,29,94,56,38,13,5,38,90,63,43,15,5,27,59,46,36,9,1,13,206,165,129,31,5,41
S01013012,540,321,259,48,14,219,124,37,28,7,2,87,108,59,48,10,1,49,74,56,47,3,6,18,72,59,49,6,4,13,162,110,87,22,1,52
S01013013,566,379,275,86,18,187,88,27,16,11,0,61,103,75,50,21,4,28,82,59,43,8,8,23,67,50,36,12,2,17,226,168,130,34,4,58
S01013014,607,362,251,88,23,245,147,59,37,20,2,88,125,87,54,23,10,38,82,58,42,12,4,24,46,33,29,4,0,13,207,125,89,29,7,82
S01013015,608,417,285,113,19,191,103,57,28,24,5,46,102,67,38,24,5,35,99,76,56,18,2,23,49,42,30,9,3,7,255,175,133,38,4,80
S01013016,497,340,217,111,12,157,64,31,10,18,3,33,75,50,29,19,2,25,72,48,30,16,2,24,44,34,22,12,0,10,242,177,126,46,5,65
S01013017,659,396,303,78,15,263,128,35,26,6,3,93,135,82,60,18,4,53,88,50,39,9,2,38,55,40,35,5,0,15,253,189,143,40,6,64
S01013018,770,499,360,113,26,271,114,38,20,14,4,76,132,82,60,18,4,50,126,93,68,18,7,33,64,46,27,15,4,18,334,240,185,48,7,94
S01013019,687,483,385,76,22,204,69,25,11,13,1,44,117,75,58,9,8,42,98,75,59,10,6,23,57,48,35,10,3,9,346,260,222,34,4,86
S01013020,405,254,221,21,12,151,147,50,41,7,2,97,89,65,56,3,6,24,54,43,39,3,1,11,32,25,21,2,2,7,83,71,64,6,1,12
S01013021,376,257,217,26,14,119,96,34,30,2,2,62,111,84,63,12,9,27,69,57,50,7,0,12,30,21,18,2,1,9,70,61,56,3,2,9
S01013022,324,231,192,19,20,93,56,26,17,6,3,30,67,41,32,3,6,26,62,47,41,3,3,15,34,27,23,1,3,7,105,90,79,6,5,15
S01013023,709,414,348,54,12,295,93,22,13,5,4,71,113,58,45,10,3,55,86,60,54,5,1,26,64,40,35,3,2,24,353,234,201,31,2,119
S01013024,422,255,206,36,13,167,61,13,9,4,0,48,78,39,30,3,6,39,59,45,35,5,5,14,39,28,19,8,1,11,185,130,113,16,1,55
S01013025,478,302,182,109,11,176,115,39,16,22,1,76,102,71,40,26,5,31,60,46,31,12,3,14,47,39,21,16,2,8,154,107,74,33,0,47
S01013026,812,545,472,38,35,267,253,104,81,8,15,149,197,140,112,13,15,57,117,95,84,8,3,22,72,64,60,3,1,8,173,142,135,6,1,31
S01013027,794,464,365,28,71,330,340,141,105,9,27,199,231,157,123,5,29,74,95,75,67,4,4,20,49,38,30,2,6,11,79,53,40,8,5,26
S01013028,393,287,218,52,17,106,108,59,42,14,3,49,115,84,63,15,6,31,49,37,33,2,2,12,38,34,26,7,1,4,83,73,54,14,5,10
S01013029,490,269,241,11,17,221,228,75,66,3,6,153,141,100,90,4,6,41,58,48,44,1,3,10,21,18,16,0,2,3,42,28,25,3,0,14
S01013030,481,315,247,27,41,166,203,97,79,9,9,106,142,112,77,9,26,30,54,43,39,1,3,11,34,25,22,2,1,9,48,38,30,6,2,10
S01013031,505,337,283,19,35,168,223,106,90,8,8,117,153,123,97,7,19,30,55,47,43,1,3,8,31,27,24,2,1,4,43,34,29,1,4,9
S01013032,571,478,409,52,17,93,95,56,43,11,2,39,177,145,123,16,6,32,95,89,75,10,4,6,66,61,54,4,3,5,138,127,114,11,2,11
S01013033,512,395,340,33,22,117,115,60,52,4,4,55,180,145,120,14,11,35,73,64,50,9,5,9,56,51,47,3,1,5,88,75,71,3,1,13
S01013034,576,365,316,19,30,211,259,107,91,6,10,152,158,128,109,4,15,30,59,50,46,2,2,9,42,36,32,3,1,6,58,44,38,4,2,14
S01013035,548,336,277,16,43,212,238,102,88,1,13,136,184,143,114,5,24,41,58,44,34,5,5,14,29,20,17,2,1,9,39,27,24,3,0,12
S01013036,605,413,317,27,69,192,247,137,105,11,21,110,212,163,124,7,32,49,52,40,29,2,9,12,46,40,34,4,2,6,48,33,25,3,5,15
S01013037,654,424,353,44,27,230,155,34,27,4,3,121,167,120,94,17,9,47,110,89,74,6,9,21,62,53,47,3,3,9,160,128,111,14,3,32
S01013038,811,512,427,36,49,299,261,89,68,9,12,172,230,159,132,10,17,71,116,93,79,5,9,23,61,54,45,3,6,7,143,117,103,9,5,26
S01013039,427,340,299,25,16,87,45,20,19,1,0,25,119,85,71,11,3,34,93,86,76,6,4,7,41,36,32,1,3,5,129,113,101,6,6,16
S01013040,544,305,255,32,18,239,181,53,42,6,5,128,149,96,82,10,4,53,70,51,39,9,3,19,60,41,37,1,3,19,84,64,55,6,3,20
S01013041,485,350,297,29,24,135,143,63,51,5,7,80,126,102,81,10,11,24,68,60,54,4,2,8,45,41,36,2,3,4,103,84,75,8,1,19
S01013042,650,475,391,57,27,175,154,63,41,15,7,91,159,125,104,11,10,34,115,95,78,12,5,20,71,55,46,6,3,16,151,137,122,13,2,14
S01013043,558,342,270,27,45,216,219,82,59,7,16,137,167,124,99,8,17,43,62,53,44,4,5,9,49,40,32,4,4,9,61,43,36,4,3,18
S01013044,649,405,336,27,42,244,230,95,68,15,12,135,208,142,121,5,16,66,86,65,56,2,7,21,56,52,44,3,5,4,69,51,47,2,2,18
S01013045,541,374,318,32,24,167,149,62,52,5,5,87,142,97,79,9,9,45,72,56,45,8,3,16,55,48,43,2,3,7,123,111,99,8,4,12
S01013046,421,250,220,14,16,171,157,59,56,1,2,98,126,86,71,7,8,40,47,32,29,1,2,15,38,33,26,4,3,5,53,40,38,1,1,13
S01013047,703,557,485,54,18,146,89,41,30,10,1,48,167,126,106,12,8,41,129,109,92,12,5,20,105,98,91,6,1,7,213,183,166,14,3,30
S01013048,684,539,486,26,27,145,124,53,48,4,1,71,172,142,122,5,15,30,130,114,102,8,4,16,67,61,58,2,1,6,191,169,156,7,6,22
S01013049,685,465,400,41,24,220,105,35,26,8,1,70,173,122,103,9,10,51,108,78,62,10,6,30,72,53,50,2,1,19,227,177,159,12,6,50
S01013050,649,364,293,35,36,285,188,54,34,10,10,134,169,95,71,10,14,74,89,65,58,3,4,24,71,57,49,3,5,14,132,93,81,9,3,39
S01013051,763,462,386,33,43,301,249,77,58,6,13,172,240,179,145,17,17,61,94,75,67,2,6,19,63,47,44,2,1,16,117,84,72,6,6,33
S01013052,637,348,298,23,27,289,232,65,52,7,6,167,164,108,86,8,14,56,79,62,58,2,2,17,51,37,31,2,4,14,111,76,71,4,1,35
S01013053,526,296,232,31,33,230,202,61,45,10,6,141,153,97,73,10,14,56,47,37,30,1,6,10,41,36,30,2,4,5,83,65,54,8,3,18
S01013054,577,358,300,32,26,219,165,64,49,8,7,101,155,109,92,6,11,46,70,49,41,4,4,21,51,40,37,2,1,11,136,96,81,12,3,40
S01013055,581,337,269,38,30,244,190,67,52,8,7,123,171,111,83,14,14,60,71,52,42,5,5,19,42,33,28,2,3,9,107,74,64,9,1,33
S01013056,774,461,371,54,36,313,293,103,83,10,10,190,215,155,123,17,15,60,86,67,54,8,5,19,71,52,45,5,2,19,109,84,66,14,4,25
S01013057,641,387,282,32,73,254,227,87,54,7,26,140,205,135,95,9,31,70,66,52,43,3,6,14,48,38,34,0,4,10,95,75,56,13,6,20
S01013058,420,355,305,33,17,65,33,18,16,2,0,15,75,62,50,5,7,13,80,67,52,10,5,13,49,41,37,2,2,8,183,167,150,14,3,16
S01013059,669,327,267,43,17,342,129,26,18,8,0,103,110,50,35,9,6,60,86,49,35,9,5,37,58,36,33,2,1,22,286,166,146,15,5,120
S01013060,449,251,196,41,14,198,70,19,13,4,2,51,72,31,18,7,6,41,52,37,34,2,1,15,38,22,17,4,1,16,217,142,114,24,4,75
S01013061,683,351,303,40,8,332,79,18,10,8,0,61,93,38,32,5,1,55,94,62,58,3,1,32,64,40,35,5,0,24,353,193,168,19,6,160
S01013062,746,388,297,79,12,358,83,14,11,2,1,69,106,46,32,14,0,60,78,42,28,11,3,36,53,36,25,8,3,17,426,250,201,44,5,176
S01013063,678,391,293,77,21,287,73,18,5,12,1,55,70,35,25,6,4,35,88,52,38,6,8,36,49,29,23,4,2,20,398,257,202,49,6,141
S01013064,714,412,340,39,33,302,255,66,56,5,5,189,188,136,105,13,18,52,104,83,72,5,6,21,55,42,35,6,1,13,112,85,72,10,3,27
S01013065,731,430,359,33,38,301,207,49,42,1,6,158,189,127,98,12,17,62,112,78,66,5,7,34,72,53,46,5,2,19,151,123,107,10,6,28
S01013066,614,411,323,43,45,203,181,65,43,8,14,116,136,99,72,13,14,37,80,56,40,6,10,24,63,53,46,2,5,10,154,138,122,14,2,16
S01013067,774,498,392,32,74,276,44,19,7,4,8,25,97,60,47,5,8,37,262,183,143,7,33,79,77,54,44,4,6,23,294,182,151,12,19,112
S01013068,659,418,311,29,78,241,116,38,24,2,12,78,125,79,50,2,27,46,134,86,62,7,17,48,68,47,38,2,7,21,216,168,137,16,15,48
S01013069,670,426,329,28,69,244,85,34,26,2,6,51,108,78,53,4,21,30,200,123,98,2,23,77,43,34,26,4,4,9,234,157,126,16,15,77
S01013070,561,312,249,16,47,249,93,43,31,6,6,50,88,52,38,3,11,36,132,82,66,3,13,50,70,41,36,2,3,29,178,94,78,2,14,84
S01013071,924,569,446,22,101,355,52,22,13,3,6,30,121,77,51,4,22,44,366,235,172,7,56,131,71,48,44,0,4,23,314,187,166,8,13,127
S01013072,433,237,195,9,33,196,240,103,83,3,17,137,106,71,56,2,13,35,34,26,23,1,2,8,17,13,12,1,0,4,36,24,21,2,1,12
S01013073,639,400,328,18,54,239,227,85,59,6,20,142,153,100,81,3,16,53,75,58,52,0,6,17,37,29,26,1,2,8,147,128,110,8,10,19
S01013074,526,307,216,33,58,219,243,116,79,6,31,127,144,99,70,10,19,45,58,38,30,4,4,20,34,29,19,6,4,5,47,25,18,7,0,22
S01013075,750,362,261,35,66,388,358,120,84,10,26,238,173,100,64,12,24,73,79,49,39,4,6,30,48,29,21,1,7,19,92,64,53,8,3,28
S01013076,652,381,281,40,60,271,60,27,19,2,6,33,111,65,39,12,14,46,192,127,93,10,24,65,44,29,25,3,1,15,245,133,105,13,15,112
S01013077,544,305,249,11,45,239,215,82,65,2,15,133,161,101,80,4,17,60,45,32,28,1,3,13,45,33,31,1,1,12,78,57,45,3,9,21
S01013078,436,264,203,18,43,172,154,74,56,4,14,80,142,103,80,5,18,39,37,22,18,2,2,15,37,26,19,2,5,11,66,39,30,5,4,27
S01013079,1086,644,524,75,45,442,249,48,33,6,9,201,230,120,93,15,12,110,169,118,84,16,18,51,86,72,66,5,1,14,352,286,248,33,5,66
S01013080,738,436,345,65,26,302,131,36,25,9,2,95,109,64,47,14,3,45,119,69,50,9,10,50,70,47,38,8,1,23,309,220,185,25,10,89
S01013081,548,346,282,46,18,202,78,22,15,4,3,56,95,54,37,12,5,41,84,63,55,5,3,21,69,54,42,9,3,15,222,153,133,16,4,69
S01013082,736,449,392,45,12,287,125,33,22,7,4,92,151,89,80,7,2,62,123,88,83,5,0,35,99,70,61,6,3,29,238,169,146,20,3,69
S01013083,2207,1093,686,40,367,1114,81,21,13,4,4,60,246,85,54,8,23,161,1315,685,397,13,275,630,198,109,69,5,35,89,367,193,153,10,30,174
S01013084,624,369,298,56,15,255,80,24,20,4,0,56,86,47,34,7,6,39,101,77,68,5,4,24,64,48,41,7,0,16,293,173,135,33,5,120
S01013085,596,233,177,28,28,363,169,26,21,3,2,143,97,50,38,7,5,47,50,33,27,6,0,17,31,25,22,0,3,6,249,99,69,12,18,150
S01013086,760,474,381,64,29,286,95,32,22,6,4,63,81,59,43,12,4,22,124,84,63,11,10,40,63,40,34,3,3,23,397,259,219,32,8,138
S01013087,689,374,260,92,22,315,68,14,7,6,1,54,65,26,18,4,4,39,85,48,30,13,5,37,39,23,13,9,1,16,432,263,192,60,11,169
S01013088,773,446,326,102,18,327,73,25,13,11,1,48,87,42,27,13,2,45,104,62,43,15,4,42,67,39,28,9,2,28,442,278,215,54,9,164
S01013089,633,364,307,33,24,269,151,46,39,3,4,105,123,83,63,12,8,40,89,55,44,8,3,34,48,37,35,1,1,11,222,143,126,9,8,79
S01013090,688,460,376,51,33,228,78,30,19,9,2,48,94,53,38,7,8,41,134,88,79,3,6,46,44,32,27,2,3,12,338,257,213,30,14,81
S01013091,462,302,263,22,17,160,26,5,4,0,1,21,63,39,34,4,1,24,107,66,53,5,8,41,38,27,23,2,2,11,228,165,149,11,5,63
S01013092,741,480,391,52,37,261,124,36,28,4,4,88,148,95,79,10,6,53,132,94,71,11,12,38,61,43,33,6,4,18,276,212,180,21,11,64
S01013093,410,240,168,65,7,170,50,14,10,4,0,36,84,44,28,15,1,40,58,40,29,8,3,18,31,20,16,4,0,11,187,122,85,34,3,65
S01013094,477,287,237,38,12,190,23,7,5,1,1,16,78,33,19,11,3,45,65,40,40,0,0,25,43,29,25,1,3,14,268,178,148,25,5,90
S01013095,632,422,358,57,7,210,33,13,10,3,0,20,67,26,17,7,2,41,88,60,54,4,2,28,38,28,24,4,0,10,406,295,253,39,3,111
S01013096,448,256,219,21,16,192,103,41,33,7,1,62,122,59,48,5,6,63,84,47,36,5,6,37,34,25,23,1,1,9,105,84,79,3,2,21
S01013097,494,358,261,88,9,136,56,27,16,11,0,29,63,38,23,12,3,25,73,56,40,13,3,17,40,28,20,7,1,12,262,209,162,45,2,53
S01013098,421,330,281,42,7,91,11,5,3,2,0,6,53,29,23,5,1,24,38,25,22,2,1,13,44,39,34,5,0,5,275,232,199,28,5,43
S01013099,791,446,349,72,25,345,132,25,16,7,2,107,118,62,41,12,9,56,84,59,49,8,2,25,66,49,35,11,3,17,391,251,208,34,9,140
S01013100,495,243,182,54,7,252,57,12,7,4,1,45,49,13,8,5,0,36,45,21,16,2,3,24,30,14,4,8,2,16,314,183,147,35,1,131
S01013101,835,482,377,55,50,353,259,75,50,15,10,184,170,119,87,13,19,51,109,79,63,7,9,30,73,55,45,5,5,18,224,154,132,15,7,70
S01013102,501,265,228,27,10,236,93,13,11,2,0,80,67,30,25,3,2,37,59,44,39,2,3,15,42,26,23,2,1,16,240,152,130,18,4,88
S01013103,619,458,376,58,24,161,37,15,10,5,0,22,100,70,47,15,8,30,98,72,58,9,5,26,64,50,43,4,3,14,320,251,218,25,8,69
S01013104,795,503,400,77,26,292,90,30,22,7,1,60,127,79,60,12,7,48,128,91,70,14,7,37,69,51,45,5,1,18,381,252,203,39,10,129
S01013105,732,438,344,76,18,294,82,16,12,4,0,66,103,51,38,6,7,52,107,63,50,8,5,44,59,44,34,9,1,15,381,264,210,49,5,117
S01013106,659,427,333,75,19,232,145,40,27,10,3,105,146,105,79,19,7,41,88,72,53,17,2,16,68,50,40,9,1,18,212,160,134,20,6,52
S01013107,556,352,263,80,9,204,75,38,20,17,1,37,92,49,36,11,2,43,77,49,36,10,3,28,60,41,30,11,0,19,252,175,141,31,3,77
S01013108,478,280,214,46,20,198,101,45,34,5,6,56,96,50,38,4,8,46,68,45,37,7,1,23,60,41,32,6,3,19,153,99,73,24,2,54
S01013109,888,600,425,152,23,288,199,86,54,27,5,113,161,107,75,29,3,54,117,83,50,30,3,34,63,51,35,13,3,12,348,273,211,53,9,75
S01013110,488,316,197,109,10,172,103,50,26,23,1,53,78,48,29,16,3,30,72,54,36,18,0,18,47,36,21,13,2,11,188,128,85,39,4,60
S01013111,376,236,155,75,6,140,63,28,19,9,0,35,55,24,11,10,3,31,51,27,15,12,0,24,28,23,13,8,2,5,179,134,97,36,1,45
S01013112,489,330,265,46,19,159,90,36,24,6,6,54,115,75,56,12,7,40,74,58,47,9,2,16,57,45,39,5,1,12,153,116,99,14,3,37
S01013113,680,380,295,60,25,300,238,78,58,14,6,160,187,124,96,22,6,63,80,56,43,9,4,24,42,34,29,1,4,8,133,88,69,14,5,45
S01013114,676,442,320,101,21,234,129,42,21,15,6,87,159,119,96,19,4,40,92,67,47,16,4,25,58,47,31,14,2,11,238,167,125,37,5,71
S01013115,574,327,241,66,20,247,141,39,32,6,1,102,125,87,60,15,12,38,92,66,51,12,3,26,47,36,24,11,1,11,169,99,74,22,3,70
S01013116,682,354,261,81,12,328,107,30,19,10,1,77,102,52,38,10,4,50,97,53,40,12,1,44,72,47,36,9,2,25,304,172,128,40,4,132
S01013117,510,373,297,63,13,137,107,53,41,11,1,54,117,94,69,18,7,23,88,65,54,10,1,23,38,32,27,5,0,6,160,129,106,19,4,31
S01013118,454,326,240,74,12,128,59,20,9,10,1,39,102,87,70,12,5,15,66,46,35,11,0,20,34,29,22,6,1,5,193,144,104,35,5,49
S01013119,668,413,249,150,14,255,143,70,40,28,2,73,131,81,53,24,4,50,78,51,30,16,5,27,54,35,18,17,0,19,262,176,108,65,3,86
S01013120,832,556,389,146,21,276,209,95,68,23,4,114,165,116,82,27,7,49,119,93,71,15,7,26,89,60,45,14,1,29,250,192,123,67,2,58
S01013121,332,250,162,66,22,82,84,46,33,8,5,38,84,72,43,21,8,12,45,40,28,9,3,5,25,24,17,4,3,1,94,68,41,24,3,26
S01013122,481,286,206,12,68,195,206,78,48,4,26,128,118,85,61,1,23,33,50,35,22,2,11,15,42,37,29,2,6,5,65,51,46,3,2,14
S01013123,614,389,314,17,58,225,197,71,48,3,20,126,150,108,81,3,24,42,104,83,70,4,9,21,67,53,47,1,5,14,96,74,68,6,0,22
S01013124,597,360,316,17,27,237,220,67,60,3,4,153,149,113,90,6,17,36,80,56,49,3,4,24,64,55,50,3,2,9,84,69,67,2,0,15
S01013125,688,360,283,41,36,328,236,57,42,10,5,179,162,115,91,9,15,47,94,62,49,4,9,32,80,59,44,10,5,21,116,67,57,8,2,49
S01013126,580,340,247,17,76,240,229,78,61,2,15,151,172,118,77,7,34,54,71,51,39,1,11,20,59,55,42,4,9,4,49,38,28,3,7,11
S01013127,625,345,253,19,73,280,264,96,66,6,24,168,180,116,83,2,31,64,61,44,38,1,5,17,60,42,29,5,8,18,60,47,37,5,5,13
S01013128,559,375,313,9,53,184,174,67,54,1,12,107,156,113,90,1,22,43,80,64,52,3,9,16,70,61,51,4,6,9,79,70,66,0,4,9
S01013129,972,576,483,32,61,396,320,84,63,11,10,236,223,159,125,7,27,64,133,105,91,6,8,28,134,97,86,3,8,37,162,131,118,5,8,31
S01013130,541,339,248,21,70,202,184,61,40,2,19,123,160,107,67,7,33,53,61,48,35,4,9,13,63,59,48,5,6,4,73,64,58,3,3,9
S01013131,507,350,290,14,46,157,139,55,41,3,11,84,175,143,115,4,24,32,69,51,45,1,5,18,53,45,38,2,5,8,71,56,51,4,1,15
S01013132,481,289,218,21,50,192,165,58,38,5,15,107,139,90,64,7,19,49,64,46,35,2,9,18,46,39,35,0,4,7,67,56,46,7,3,11
S01013133,774,380,310,19,51,394,358,75,55,5,15,283,158,111,87,7,17,47,97,72,61,1,10,25,79,65,54,4,7,14,82,57,53,2,2,25
S01013134,669,410,339,43,28,259,220,74,53,13,8,146,156,115,90,14,11,41,94,76,67,6,3,18,64,51,44,2,5,13,135,94,85,8,1,41
S01013135,604,348,269,20,59,256,243,94,68,5,21,149,181,117,86,9,22,64,68,53,42,3,8,15,66,50,42,1,7,16,46,34,31,2,1,12
S01013136,787,435,368,22,45,352,332,98,82,5,11,234,217,160,133,8,19,57,92,62,51,4,7,30,72,59,51,1,7,13,74,56,51,4,1,18
S01013137,627,340,280,24,36,287,273,94,73,9,12,179,164,102,81,6,15,62,75,61,55,3,3,14,62,41,36,2,3,21,53,42,35,4,3,11
S01013138,517,320,233,17,70,197,203,93,64,5,24,110,152,103,71,4,28,49,62,48,36,2,10,14,47,34,26,3,5,13,53,42,36,3,3,11
S01013139,710,370,279,22,69,340,295,87,59,5,23,208,176,118,80,11,27,58,80,55,46,1,8,25,68,53,45,2,6,15,91,57,49,3,5,34
S01013140,672,350,278,24,48,322,298,88,69,3,16,210,185,121,93,7,21,64,75,57,46,5,6,18,53,37,31,2,4,16,61,47,39,7,1,14
S01013141,539,294,233,17,44,245,214,62,43,3,16,152,134,93,69,8,16,41,63,46,35,4,7,17,47,36,34,1,1,11,81,57,52,1,4,24
S01013142,750,311,236,21,54,439,382,80,58,6,16,302,181,114,84,7,23,67,59,38,28,3,7,21,58,37,30,3,4,21,70,42,36,2,4,28
S01013143,728,423,358,27,38,305,269,79,68,5,6,190,182,136,112,9,15,46,95,72,58,4,10,23,88,64,57,3,4,24,94,72,63,6,3,22
S01013144,782,423,354,25,44,359,308,85,75,3,7,223,182,123,92,7,24,59,107,74,68,4,2,33,69,56,48,3,5,13,116,85,71,8,6,31
S01013145,608,326,275,22,29,282,229,59,48,9,2,170,129,81,65,4,12,48,97,59,50,2,7,38,59,50,44,1,5,9,94,77,68,6,3,17
S01013146,369,211,170,22,19,158,141,33,23,5,5,108,93,68,49,12,7,25,54,43,36,2,5,11,39,31,28,1,2,8,42,36,34,2,0,6
S01013147,595,360,304,37,19,235,173,47,37,9,1,126,153,106,84,13,9,47,93,62,51,5,6,31,67,56,51,3,2,11,109,89,81,7,1,20
S01013148,649,410,359,26,25,239,201,58,50,4,4,143,129,99,84,8,7,30,114,82,71,6,5,32,88,77,71,1,5,11,117,94,83,7,4,23
S01013149,692,445,394,20,31,247,210,77,66,3,8,133,186,121,104,6,11,65,101,82,71,4,7,19,73,60,54,4,2,13,122,105,99,3,3,17
S01013150,729,408,351,26,31,321,252,67,58,5,4,185,176,109,90,7,12,67,87,65,57,4,4,22,100,77,69,5,3,23,114,90,77,5,8,24
S01013151,476,314,268,31,15,162,102,27,22,5,0,75,120,84,63,15,6,36,86,60,55,2,3,26,65,54,45,4,5,11,103,89,83,5,1,14
S01013152,736,462,385,41,36,274,250,90,67,10,13,160,152,113,94,8,11,39,134,104,89,7,8,30,73,61,52,6,3,12,127,94,83,10,1,33
S01013153,677,375,289,22,64,302,247,80,59,7,14,167,226,152,110,5,37,74,76,48,41,3,4,28,70,51,44,2,5,19,58,44,35,5,4,14
S01013154,783,508,408,20,80,275,279,107,78,6,23,172,207,152,118,7,27,55,105,80,73,1,6,25,95,83,63,1,19,12,97,86,76,5,5,11
S01013155,666,438,340,22,76,228,215,101,70,6,25,114,200,139,98,7,34,61,99,66,57,2,7,33,73,59,52,1,6,14,79,73,63,6,4,6
S01013156,647,401,323,13,65,246,207,85,63,4,18,122,218,143,112,3,28,75,88,70,60,2,8,18,69,52,43,0,9,17,65,51,45,4,2,14
S01013157,740,451,353,19,79,289,264,103,66,8,29,161,231,161,128,4,29,70,91,64,58,2,4,27,66,54,47,0,7,12,88,69,54,5,10,19
S01013158,495,310,253,42,15,185,132,40,26,12,2,92,105,72,57,10,5,33,91,70,57,10,3,21,62,50,42,6,2,12,105,78,71,4,3,27
S01013159,604,388,331,37,20,216,162,57,40,12,5,105,139,99,81,12,6,40,89,67,58,6,3,22,71,63,59,2,2,8,143,102,93,5,4,41
S01013160,581,412,350,46,16,169,96,45,32,12,1,51,160,114,90,16,8,46,111,87,77,8,2,24,89,67,56,7,4,22,125,99,95,3,1,26
S01013161,836,548,469,37,42,288,249,84,61,9,14,165,228,165,141,12,12,63,142,112,97,9,6,30,102,91,80,5,6,11,115,96,90,2,4,19
S01013162,704,385,308,32,45,319,291,84,56,9,19,207,176,115,91,10,14,61,80,61,51,4,6,19,61,49,45,1,3,12,96,76,65,8,3,20
S01013163,577,425,377,26,22,152,122,62,54,6,2,60,156,112,97,8,7,44,127,108,96,5,7,19,49,42,39,1,2,7,123,101,91,6,4,22
S01013164,858,504,390,62,52,354,254,83,57,12,14,171,195,121,94,16,11,74,133,95,72,9,14,38,102,76,64,7,5,26,174,129,103,18,8,45
S01013165,772,437,361,45,31,335,255,71,55,8,8,184,169,116,87,17,12,53,119,87,76,5,6,32,73,55,52,3,0,18,156,108,91,12,5,48
S01013166,531,309,230,17,62,222,194,78,59,5,14,116,173,118,76,9,33,55,76,54,44,2,8,22,51,31,27,0,4,20,37,28,24,1,3,9
S01013167,529,351,234,19,98,178,162,78,40,2,36,84,165,117,78,4,35,48,76,54,39,5,10,22,63,50,37,4,9,13,63,52,40,4,8,11
S01013168,760,403,323,21,59,357,318,105,75,11,19,213,212,134,106,7,21,78,88,60,52,1,7,28,71,54,45,1,8,17,71,50,45,1,4,21
S01013169,723,358,291,31,36,365,341,95,70,9,16,246,149,105,85,9,11,44,82,47,38,4,5,35,67,48,39,5,4,19,84,63,59,4,0,21
S01013170,437,252,185,15,52,185,184,56,41,4,11,128,132,99,65,5,29,33,48,39,35,2,2,9,38,33,22,4,7,5,35,25,22,0,3,10
S01013171,523,366,306,30,30,157,107,39,30,7,2,68,164,119,95,6,18,45,83,65,53,7,5,18,60,53,49,2,2,7,109,90,79,8,3,19
S01013172,613,388,332,17,39,225,205,70,52,5,13,135,159,118,102,4,12,41,83,64,56,4,4,19,74,63,54,2,7,11,92,73,68,2,3,19
S01013173,658,466,411,25,30,192,163,65,51,10,4,98,188,141,121,7,13,47,103,88,79,2,7,15,77,65,62,2,1,12,127,107,98,4,5,20
S01013174,625,491,420,40,31,134,83,45,38,5,2,38,161,127,102,12,13,34,122,96,80,7,9,26,89,78,70,4,4,11,170,145,130,12,3,25
S01013175,659,475,420,34,21,184,127,35,30,3,2,92,148,110,96,6,8,38,106,84,68,10,6,22,90,77,69,4,4,13,188,169,157,11,1,19
S01013176,702,405,342,33,30,297,222,56,45,4,7,166,146,99,75,9,15,47,101,75,72,2,1,26,77,64,58,2,4,13,156,111,92,16,3,45
S01013177,532,357,316,23,18,175,123,35,29,6,0,88,126,89,75,7,7,37,75,55,48,2,5,20,73,64,55,4,5,9,135,114,109,4,1,21
S01013178,623,402,351,29,22,221,129,36,28,5,3,93,163,101,83,8,10,62,102,75,69,5,1,27,89,74,68,3,3,15,140,116,103,8,5,24
S01013179,706,439,362,48,29,267,171,65,51,9,5,106,185,120,98,8,14,65,119,85,72,10,3,34,83,64,52,8,4,19,148,105,89,13,3,43
S01013180,360,273,233,20,20,87,59,27,20,1,6,32,79,65,52,9,4,14,75,61,54,1,6,14,64,53,48,3,2,11,83,67,59,6,2,16
S01013181,611,384,339,24,21,227,186,54,47,6,1,132,123,90,77,4,9,33,113,89,78,8,3,24,82,68,63,2,3,14,107,83,74,4,5,24
S01013182,633,341,296,17,28,292,266,68,55,6,7,198,131,98,80,7,11,33,84,64,55,2,7,20,63,45,43,1,1,18,89,66,63,1,2,23
S01013183,706,483,428,31,24,223,160,60,47,5,8,100,135,93,80,8,5,42,123,99,90,5,4,24,96,83,77,3,3,13,192,148,134,10,4,44
S01013184,439,270,201,12,57,169,163,73,50,4,19,90,152,107,83,2,22,45,54,35,24,2,9,19,39,33,30,2,1,6,31,22,14,2,6,9
S01013185,618,386,309,15,62,232,226,77,58,6,13,149,180,129,98,6,25,51,93,81,64,2,15,12,64,50,44,0,6,14,55,49,45,1,3,6
S01013186,522,354,276,17,61,168,180,91,69,4,18,89,175,131,103,7,21,44,74,60,44,5,11,14,54,42,34,0,8,12,39,30,26,1,3,9
S01013187,659,411,332,20,59,248,201,63,47,4,12,138,214,153,115,8,30,61,83,63,55,1,7,20,56,49,44,0,5,7,105,83,71,7,5,22
S01013188,733,500,445,25,30,233,190,70,56,9,5,120,178,142,121,5,16,36,134,96,91,0,5,38,90,79,73,5,1,11,141,113,104,6,3,28
S01013189,524,340,296,26,18,184,135,48,39,5,4,87,107,75,63,7,5,32,85,65,59,3,3,20,62,50,46,2,2,12,135,102,89,9,4,33
S01013190,652,408,355,25,28,244,197,59,48,2,9,138,150,115,96,9,10,35,101,73,64,7,2,28,62,50,45,4,1,12,142,111,102,3,6,31
S01013191,834,619,542,46,31,215,127,47,38,8,1,80,185,140,117,15,8,45,179,135,119,3,13,44,116,97,86,7,4,19,227,200,182,13,5,27
S01013192,819,477,414,34,29,342,213,32,28,1,3,181,158,108,96,8,4,50,147,117,95,10,12,30,83,62,54,3,5,21,218,158,141,12,5,60
S01013193,557,389,335,29,25,168,146,57,47,7,3,89,136,100,83,7,10,36,86,68,57,6,5,18,74,64,58,4,2,10,115,100,90,5,5,15
S01013194,495,355,301,27,27,140,116,46,36,5,5,70,107,89,70,8,11,18,92,69,62,3,4,23,84,73,63,6,4,11,96,78,70,5,3,18
S01013195,891,569,489,38,42,322,272,67,51,4,12,205,181,128,108,12,8,53,133,112,98,6,8,21,125,105,93,5,7,20,180,157,139,11,7,23
S01013196,563,415,362,29,24,148,138,55,39,10,6,83,117,91,76,7,8,26,89,80,70,4,6,9,75,68,61,6,1,7,144,121,116,2,3,23
S01013197,502,270,231,24,15,232,141,30,23,4,3,111,93,54,46,5,3,39,71,51,46,4,1,20,58,47,41,5,1,11,139,88,75,6,7,51
S01013198,701,383,299,41,43,318,277,64,45,11,8,213,148,115,89,9,17,33,86,62,50,4,8,24,72,56,40,13,3,16,118,86,75,4,7,32
S01013199,816,442,346,65,31,374,290,70,49,16,5,220,123,74,51,14,9,49,104,72,59,6,7,32,74,57,50,5,2,17,225,169,137,24,8,56
S01013200,597,342,278,28,36,255,199,55,40,8,7,144,106,63,46,2,15,43,89,66,53,5,8,23,74,59,51,4,4,15,129,99,88,9,2,30
S01013201,600,337,247,16,74,263,287,104,68,5,31,183,151,100,69,5,26,51,57,42,34,0,8,15,50,41,31,4,6,9,55,50,45,2,3,5
S01013202,466,269,193,12,64,197,152,65,41,4,20,87,128,83,51,4,28,45,70,47,41,1,5,23,46,31,22,1,8,15,70,43,38,2,3,27
S01013203,576,353,283,16,54,223,221,80,59,3,18,141,158,115,83,7,25,43,72,50,43,2,5,22,48,42,36,1,5,6,77,66,62,3,1,11
S01013204,633,467,404,19,44,166,170,77,65,4,8,93,148,114,95,4,15,34,93,78,70,1,7,15,91,82,72,4,6,9,131,116,102,6,8,15
S01013205,463,278,204,12,62,185,211,93,65,4,24,118,132,95,64,3,28,37,48,32,27,0,5,16,34,26,22,2,2,8,38,32,26,3,3,6
S01013206,519,300,242,13,45,219,207,73,56,5,12,134,142,97,75,2,20,45,63,45,39,3,3,18,50,38,31,1,6,12,57,47,41,2,4,10
S01013207,664,392,305,48,39,272,253,89,64,14,11,164,164,110,76,16,18,54,81,66,56,6,4,15,62,55,47,6,2,7,104,72,62,6,4,32
S01013208,741,447,364,27,56,294,290,109,76,9,24,181,200,145,117,9,19,55,86,61,53,1,7,25,75,60,54,4,2,15,90,72,64,4,4,18
S01013209,708,421,351,36,34,287,266,76,58,9,9,190,135,98,77,12,9,37,107,85,74,5,6,22,80,73,65,4,4,7,120,89,77,6,6,31
S01013210,512,339,279,38,22,173,103,36,27,6,3,67,111,88,70,11,7,23,101,81,67,8,6,20,57,41,33,6,2,16,140,93,82,7,4,47
S01013211,733,497,433,29,35,236,213,82,67,8,7,131,193,148,125,7,16,45,114,87,77,3,7,27,95,80,74,5,1,15,118,100,90,6,4,18
S01013212,473,397,349,31,17,76,72,53,40,11,2,19,125,103,84,10,9,22,92,74,69,3,2,18,67,64,59,4,1,3,117,103,97,3,3,14
S01013213,459,359,295,44,20,100,68,39,30,7,2,29,128,95,67,15,13,33,91,79,69,8,2,12,71,60,52,6,2,11,101,86,77,8,1,15
S01013214,348,284,251,23,10,64,60,31,24,4,3,29,99,83,73,7,3,16,65,53,49,3,1,12,45,42,37,4,1,3,79,75,68,5,2,4
S01013215,650,481,413,26,42,169,170,89,72,9,8,81,185,138,113,9,16,47,107,90,76,1,13,17,83,72,65,4,3,11,105,92,87,3,2,13
S01013216,451,305,249,16,40,146,154,72,55,6,11,82,148,110,85,7,18,38,54,36,33,1,2,18,49,47,41,2,4,2,46,40,35,0,5,6
S01013217,542,365,315,18,32,177,176,84,66,8,10,92,176,124,104,3,17,52,68,57,53,2,2,11,65,58,51,4,3,7,57,42,41,1,0,15
S01013218,455,281,221,18,42,174,165,62,50,2,10,103,162,117,91,7,19,45,48,33,26,3,4,15,41,36,30,1,5,5,39,33,24,5,4,6
S01013219,424,275,219,12,44,149,156,75,60,2,13,81,117,90,67,4,19,27,56,34,28,2,4,22,45,37,31,0,6,8,50,39,33,4,2,11
S01013220,524,297,230,18,49,227,200,47,35,2,10,153,146,98,73,2,23,48,70,62,51,7,4,8,52,44,37,4,3,8,56,46,34,3,9,10
S01013221,721,447,351,46,50,274,268,107,83,15,9,161,195,147,104,17,26,48,96,72,60,6,6,24,85,64,56,3,5,21,77,57,48,5,4,20
S01013222,477,249,198,18,33,228,203,51,36,3,12,152,127,84,67,5,12,43,49,37,34,1,2,12,44,31,23,3,5,13,54,46,38,6,2,8
S01013223,938,519,399,46,74,419,360,69,40,11,18,291,207,148,99,14,35,59,132,109,89,8,12,23,96,75,67,3,5,21,143,118,104,10,4,25
S01013224,674,458,382,33,43,216,202,75,59,3,13,127,172,136,112,9,15,36,107,89,77,6,6,18,80,71,56,10,5,9,113,87,78,5,4,26
S01013225,620,382,310,20,52,238,267,116,86,9,21,151,153,103,81,2,20,50,68,48,42,2,4,20,64,53,47,0,6,11,68,62,54,7,1,6
S01013226,402,312,265,22,25,90,76,42,34,7,1,34,100,77,59,8,10,23,69,54,46,2,6,15,56,51,47,1,3,5,101,88,79,4,5,13
S01013227,564,293,241,17,35,271,209,52,44,4,4,157,165,103,75,5,23,62,68,49,44,2,3,19,59,43,36,4,3,16,63,46,42,2,2,17
S01013228,606,409,318,39,52,197,209,82,53,10,19,127,140,99,76,3,20,41,75,68,54,10,4,7,69,58,47,7,4,11,113,102,88,9,5,11
S01013229,620,381,322,15,44,239,230,79,67,6,6,151,160,118,94,2,22,42,85,65,57,1,7,20,79,66,53,5,8,13,66,53,51,1,1,13
S01013230,563,297,269,14,14,266,213,56,48,5,3,157,130,82,70,6,6,48,76,53,50,2,1,23,55,49,48,0,1,6,89,57,53,1,3,32
S01013231,622,374,331,20,23,248,232,72,56,9,7,160,159,107,94,4,9,52,82,70,61,4,5,12,57,47,43,3,1,10,92,78,77,0,1,14
S01013232,603,320,275,20,25,283,248,65,56,5,4,183,150,103,83,7,13,47,68,52,47,1,4,16,68,55,49,3,3,13,69,45,40,4,1,24
S01013233,510,308,267,25,16,202,163,54,44,10,0,109,120,78,64,5,9,42,70,54,52,1,1,16,51,41,39,0,2,10,106,81,68,9,4,25
S01013234,311,241,208,28,5,70,37,19,8,11,0,18,67,53,46,6,1,14,61,49,41,4,4,12,36,27,26,1,0,9,110,93,87,6,0,17
S01013235,681,421,359,38,24,260,211,65,52,9,4,146,163,116,95,9,12,47,106,85,77,5,3,21,84,68,58,6,4,16,117,87,77,9,1,30
S01013236,763,425,334,65,26,338,188,57,42,11,4,131,161,103,76,16,11,58,125,85,66,13,6,40,103,69,57,10,2,34,186,111,93,15,3,75
S01013237,648,460,391,41,28,188,147,59,46,6,7,88,141,107,89,11,7,34,117,98,86,8,4,19,93,68,60,4,4,25,150,128,110,12,6,22
S01013238,627,329,244,18,67,298,264,75,50,5,20,189,176,114,80,4,30,62,71,52,44,3,5,19,49,37,25,2,10,12,67,51,45,4,2,16
S01013239,709,403,322,16,65,306,268,89,70,5,14,179,199,132,101,5,26,67,107,75,59,3,13,32,60,48,42,0,6,12,75,59,50,3,6,16
S01013240,433,249,189,15,45,184,175,66,50,3,13,109,125,83,58,3,22,42,41,33,23,3,7,8,32,25,22,2,1,7,60,42,36,4,2,18
S01013241,727,473,409,50,14,254,149,50,41,9,0,99,148,98,81,12,5,50,127,92,82,6,4,35,92,73,62,9,2,19,211,160,143,14,3,51
S01013242,509,321,216,92,13,188,115,53,26,26,1,62,97,69,48,18,3,28,81,54,37,11,6,27,52,38,27,10,1,14,164,107,78,27,2,57
S01013243,600,380,297,33,50,220,229,98,79,7,12,131,180,129,93,13,23,51,75,58,51,1,6,17,47,39,27,4,8,8,69,56,47,8,1,13
S01013244,617,319,255,29,35,298,287,89,67,8,14,198,146,100,76,8,16,46,76,52,46,3,3,24,49,36,30,4,2,13,59,42,36,6,0,17
S01013245,797,547,451,57,39,250,243,88,67,14,7,155,246,193,159,15,19,53,102,84,72,6,6,18,82,72,63,6,3,10,124,110,90,16,4,14
S01013246,366,252,212,30,10,114,122,47,36,9,2,75,107,84,73,8,3,23,57,50,44,3,3,7,32,30,24,5,1,2,48,41,35,5,1,7
S01013247,629,372,292,28,52,257,254,81,66,3,12,173,189,141,104,14,23,48,73,55,43,5,7,18,58,50,41,3,6,8,55,45,38,3,4,10
S01013248,511,314,249,16,49,197,225,98,75,2,21,127,150,109,82,7,20,41,63,51,44,4,3,12,38,32,26,3,3,6,35,24,22,0,2,11
S01013249,375,244,209,17,18,131,162,69,59,2,8,93,109,85,71,7,7,24,42,32,27,4,1,10,24,23,18,3,2,1,38,35,34,1,0,3
S01013250,705,503,359,113,31,202,176,77,48,19,10,99,179,137,97,27,13,42,95,73,54,15,4,22,56,47,34,11,2,9,199,169,126,41,2,30
S01013251,558,335,272,19,44,223,198,67,56,2,9,131,180,131,106,3,22,49,65,45,33,4,8,20,46,36,30,4,2,10,69,56,47,6,3,13
S01013252,546,349,277,37,35,197,175,72,56,8,8,103,174,119,96,13,10,55,79,66,50,6,10,13,44,38,32,4,2,6,74,54,43,6,5,20
S01013253,585,376,316,28,32,209,204,82,64,4,14,122,160,117,99,9,9,43,81,69,60,5,4,12,53,41,34,4,3,12,87,67,59,6,2,20
S01013254,499,295,237,26,32,204,214,75,62,5,8,139,159,122,100,8,14,37,54,40,26,7,7,14,29,25,21,3,1,4,43,33,28,3,2,10
S01013255,1200,497,403,51,43,703,462,98,75,14,9,364,393,170,141,11,18,223,125,72,57,10,5,53,84,64,52,6,6,20,136,93,78,10,5,43
S01013256,604,374,306,47,21,230,197,56,39,14,3,141,143,111,91,11,9,32,81,64,50,8,6,17,48,40,35,4,1,8,135,103,91,10,2,32
S01013257,696,392,324,41,27,304,212,38,28,5,5,174,182,122,99,15,8,60,105,76,63,7,6,29,65,50,46,3,1,15,132,106,88,11,7,26
S01013258,638,408,350,43,15,230,140,42,29,9,4,98,158,111,94,12,5,47,97,78,67,8,3,19,73,56,50,6,0,17,170,121,110,8,3,49
S01013259,678,444,365,35,44,234,206,80,58,12,10,126,228,164,139,7,18,64,97,82,73,2,7,15,55,39,30,6,3,16,92,79,65,8,6,13
S01013260,677,442,371,17,54,235,252,103,82,6,15,149,224,171,143,4,24,53,80,69,60,4,5,11,52,43,37,0,6,9,69,56,49,3,4,13
S01013261,622,399,331,25,43,223,248,113,90,9,14,135,197,141,115,6,20,56,89,76,66,5,5,13,44,37,30,4,3,7,44,32,30,1,1,12
S01013262,529,324,257,33,34,205,200,76,61,8,7,124,164,124,91,11,22,40,64,50,43,6,1,14,45,34,29,3,2,11,56,40,33,5,2,16
S01013263,407,293,243,40,10,114,47,15,10,5,0,32,79,55,46,6,3,24,77,51,34,13,4,26,41,32,28,3,1,9,163,140,125,13,2,23
S01013264,381,304,263,30,11,77,34,17,11,4,2,17,92,67,54,9,4,25,80,71,64,5,2,9,39,31,29,2,0,8,136,118,105,10,3,18
S01013265,485,399,326,55,18,86,37,17,8,9,0,20,87,64,50,7,7,23,98,74,67,3,4,24,60,56,47,8,1,4,203,188,154,28,6,15
S01013266,425,349,298,35,16,76,47,24,17,4,3,23,98,75,65,6,4,23,76,69,61,4,4,7,54,48,42,4,2,6,150,133,113,17,3,17
S01013267,462,277,222,24,31,185,148,43,31,4,8,105,128,92,69,8,15,36,65,50,39,8,3,15,45,37,32,2,3,8,76,55,51,2,2,21
S01013268,657,455,389,34,32,202,153,61,49,7,5,92,213,158,134,6,18,55,90,73,63,6,4,17,85,70,61,7,2,15,116,93,82,8,3,23
S01013269,748,598,511,60,27,150,98,49,39,9,1,49,172,135,106,20,9,37,130,109,88,12,9,21,94,86,78,6,2,8,254,219,200,13,6,35
S01013270,611,483,411,57,15,128,52,26,16,9,1,26,144,100,86,10,4,44,116,95,80,10,5,21,57,50,45,4,1,7,242,212,184,24,4,30
S01013271,501,308,246,50,12,193,55,11,8,3,0,44,86,50,36,9,5,36,65,46,36,7,3,19,54,36,28,7,1,18,241,165,138,24,3,76
S01013272,565,442,375,46,21,123,45,20,15,4,1,25,103,70,56,7,7,33,88,63,51,7,5,25,80,69,59,6,4,11,249,220,194,22,4,29
S01013273,641,553,462,76,15,88,49,30,19,10,1,19,142,115,96,13,6,27,102,89,81,6,2,13,73,67,55,9,3,6,275,252,211,38,3,23
S01013274,686,474,409,41,24,212,119,48,36,10,2,71,167,112,96,5,11,55,130,103,88,8,7,27,93,74,68,4,2,19,177,137,121,14,2,40
S01013275,569,382,309,60,13,187,121,48,28,18,2,73,160,116,99,13,4,44,80,57,50,6,1,23,52,43,30,10,3,9,156,118,102,13,3,38
S01013276,501,403,348,31,24,98,83,58,47,8,3,25,156,125,105,8,12,31,94,79,67,7,5,15,64,53,48,2,3,11,104,88,81,6,1,16
S01013277,719,477,425,26,26,242,213,91,81,5,5,122,239,171,154,6,11,68,97,82,76,5,1,15,65,51,43,5,3,14,105,82,71,5,6,23
S01013278,704,416,324,29,63,288,252,95,71,6,18,157,217,159,121,11,27,58,78,58,44,6,8,20,65,50,41,2,7,15,92,54,47,4,3,38
S01013279,550,352,294,17,41,198,159,65,54,5,6,94,208,143,116,5,22,65,68,47,40,3,4,21,54,49,44,0,5,5,61,48,40,4,4,13
S01013280,456,295,251,21,23,161,109,34,27,4,3,75,142,110,93,6,11,32,69,46,39,2,5,23,47,36,34,1,1,11,89,69,58,8,3,20
S01013281,741,471,383,34,54,270,251,98,78,7,13,153,229,161,125,14,22,68,82,65,50,4,11,17,73,57,49,3,5,16,106,90,81,6,3,16
S01013282,629,449,367,17,65,180,168,80,66,4,10,88,251,193,145,3,45,58,74,61,56,3,2,13,69,59,52,1,6,10,67,56,48,6,2,11
S01013283,535,413,364,23,26,122,106,51,41,5,5,55,152,120,100,9,11,32,53,43,39,0,4,10,74,67,62,5,0,7,150,132,122,4,6,18
S01013284,538,429,387,33,9,109,82,39,36,2,1,43,153,126,117,6,3,27,99,86,78,5,3,13,64,58,48,10,0,6,140,120,108,10,2,20
S01013285,542,409,377,18,14,133,86,43,39,2,2,43,139,99,90,6,3,40,113,88,83,2,3,25,72,63,55,5,3,9,132,116,110,3,3,16
S01013286,556,419,373,35,11,137,91,45,37,7,1,46,155,113,94,15,4,42,99,81,71,6,4,18,63,55,54,1,0,8,148,125,117,6,2,23
S01013287,634,504,442,51,11,130,66,35,27,8,0,31,123,91,76,11,4,32,140,115,100,10,5,25,99,87,79,7,1,12,206,176,160,15,1,30
S01013288,544,338,275,38,25,206,141,45,35,6,4,96,135,87,67,7,13,48,70,54,45,6,3,16,56,40,33,4,3,16,142,112,95,15,2,30
S01013289,594,412,313,84,15,182,86,38,28,9,1,48,138,90,67,19,4,48,99,66,53,11,2,33,49,38,29,7,2,11,222,180,136,38,6,42
S01013290,692,525,447,44,34,167,144,68,55,7,6,76,214,168,140,12,16,46,94,75,61,9,5,19,70,66,60,6,0,4,170,148,131,10,7,22
S01013291,527,441,372,47,22,86,109,73,66,4,3,36,171,141,116,13,12,30,84,74,65,6,3,10,52,48,36,9,3,4,111,105,89,15,1,6
S01013292,620,475,402,37,36,145,115,62,48,9,5,53,187,144,118,10,16,43,128,112,94,11,7,16,63,52,46,2,4,11,127,105,96,5,4,22
S01013293,582,429,361,51,17,153,89,45,36,7,2,44,154,109,88,15,6,45,124,100,83,9,8,24,58,48,42,5,1,10,157,127,112,15,0,30
S01013294,599,444,383,36,25,155,118,51,39,9,3,67,164,133,110,14,9,31,101,79,69,4,6,22,74,64,60,2,2,10,142,117,105,7,5,25
S01013295,627,482,419,42,21,145,100,50,40,8,2,50,193,151,125,16,10,42,120,90,85,3,2,30,70,66,55,6,5,4,144,125,114,9,2,19
S01013296,597,362,294,28,40,235,233,90,76,4,10,143,167,110,82,8,20,57,71,61,54,3,4,10,43,37,30,5,2,6,83,64,52,8,4,19
S01013297,575,375,313,35,27,200,158,61,45,8,8,97,196,136,116,11,9,60,83,65,56,6,3,18,44,35,29,2,4,9,94,78,67,8,3,16
S01013298,581,347,273,51,23,234,207,58,44,10,4,149,131,93,76,9,8,38,93,69,50,14,5,24,36,30,26,2,2,6,114,97,77,16,4,17
S01013299,822,569,485,38,46,253,238,91,81,4,6,147,228,180,141,15,24,48,126,100,91,4,5,26,85,75,66,3,6,10,145,123,106,12,5,22
S01013300,485,297,244,27,26,188,167,52,45,3,4,115,139,105,84,6,15,34,65,50,41,7,2,15,41,34,28,3,3,7,73,56,46,8,2,17
S01013301,409,263,213,22,28,146,150,54,44,5,5,96,130,105,84,4,17,25,44,35,31,3,1,9,33,26,23,2,1,7,52,43,31,8,4,9
S01013302,515,353,284,49,20,162,120,50,34,13,3,70,139,96,76,14,6,43,82,67,51,11,5,15,56,41,38,1,2,15,118,99,85,10,4,19
S01013303,761,459,393,37,29,302,206,65,55,8,2,141,236,163,137,12,14,73,93,70,59,5,6,23,67,49,42,5,2,18,159,112,100,7,5,47
S01013304,747,502,413,21,68,245,221,98,79,2,17,123,251,195,155,6,34,56,109,84,68,8,8,25,67,50,44,1,5,17,99,75,67,4,4,24
S01013305,790,511,450,24,37,279,302,112,100,3,9,190,214,164,141,7,16,50,85,76,67,5,4,9,81,71,64,3,4,10,108,88,78,6,4,20
S01013306,756,473,357,20,96,283,267,114,87,5,22,153,287,205,144,9,52,82,94,69,57,1,11,25,50,42,33,3,6,8,58,43,36,2,5,15
S01013307,815,554,435,27,92,261,284,148,118,8,22,136,288,216,151,7,58,72,69,47,37,6,4,22,80,69,62,2,5,11,94,74,67,4,3,20
S01013308,709,460,347,20,93,249,231,88,68,3,17,143,254,199,142,6,51,55,87,63,47,4,12,24,69,57,45,2,10,12,68,53,45,5,3,15
S01013309,493,369,319,31,19,124,92,39,30,7,2,53,135,102,83,10,9,33,80,69,60,2,7,11,49,41,36,5,0,8,137,118,110,7,1,19
S01013310,506,356,302,17,37,150,137,67,60,4,3,70,171,132,99,6,27,39,62,51,48,1,2,11,61,50,45,3,2,11,75,56,50,3,3,19
S01013311,619,419,343,29,47,200,193,96,76,6,14,97,216,163,129,12,22,53,67,52,44,3,5,15,56,44,38,1,5,12,87,64,56,7,1,23
S01013312,833,531,432,40,59,302,232,93,72,9,12,139,284,196,158,14,24,88,109,89,71,6,12,20,100,76,64,8,4,24,108,77,67,3,7,31
S01013313,538,343,287,20,36,195,159,64,54,3,7,95,166,127,100,8,19,39,76,51,44,3,4,25,66,58,50,2,6,8,71,43,39,4,0,28
S01013314,537,328,287,21,20,209,165,48,43,5,0,117,152,104,85,6,13,48,72,55,49,3,3,17,59,49,45,2,2,10,89,72,65,5,2,17
S01013315,382,319,270,39,10,63,32,15,11,4,0,17,81,62,50,8,4,19,80,72,64,5,3,8,44,39,32,6,1,5,145,131,113,16,2,14
S01013316,548,331,279,40,12,217,94,29,26,1,2,65,126,70,56,11,3,56,95,67,57,6,4,28,51,34,27,5,2,17,182,131,113,17,1,51
S01013317,459,311,273,25,13,148,112,41,34,5,2,71,98,70,60,5,5,28,79,69,65,2,2,10,62,47,44,2,1,15,108,84,70,11,3,24
S01013318,480,375,334,22,19,105,80,41,36,3,2,39,125,94,81,7,6,31,68,59,50,1,8,9,53,46,44,1,1,7,154,135,123,10,2,19
S01013319,430,330,281,29,20,100,73,29,23,4,2,44,127,101,80,9,12,26,66,53,46,4,3,13,56,50,45,5,0,6,108,97,87,7,3,11
S01013320,733,632,551,53,28,101,80,52,47,2,3,28,170,137,110,18,9,33,146,126,109,9,8,20,97,89,76,9,4,8,240,228,209,15,4,12
S01013321,368,231,193,10,28,137,119,31,24,1,6,88,105,77,61,4,12,28,41,37,31,3,3,4,49,41,38,0,3,8,54,45,39,2,4,9
S01013322,642,412,362,26,24,230,199,67,60,5,2,132,184,140,122,9,9,44,84,64,53,5,6,20,65,59,52,3,4,6,110,82,75,4,3,28
S01013323,770,516,426,31,59,254,224,82,66,8,8,142,266,206,170,9,27,60,101,77,64,4,9,24,89,71,54,4,13,18,90,80,72,6,2,10
S01013324,500,332,263,17,52,168,160,83,64,5,14,77,172,114,86,4,24,58,55,42,35,1,6,13,46,39,32,2,5,7,67,54,46,5,3,13
S01013325,662,399,321,24,54,263,210,69,56,3,10,141,216,146,111,6,29,70,72,53,43,3,7,19,78,62,52,6,4,16,86,69,59,6,4,17
S01013326,429,281,223,17,41,148,142,69,51,6,12,73,152,109,83,6,20,43,50,37,31,2,4,13,37,31,28,1,2,6,48,35,30,2,3,13
S01013327,542,382,300,30,52,160,167,83,64,3,16,84,188,156,124,8,24,32,63,50,41,5,4,13,59,43,35,5,3,16,65,50,36,9,5,15
S01013328,480,319,269,18,32,161,149,73,54,5,14,76,186,134,112,8,14,52,54,38,37,0,1,16,43,34,30,2,2,9,48,40,36,3,1,8
S01013329,435,268,230,14,24,167,143,56,49,2,5,87,154,113,90,7,16,41,43,30,28,2,0,13,39,32,29,1,2,7,56,37,34,2,1,19
S01013330,819,688,621,44,23,131,101,63,49,11,3,38,208,172,155,9,8,36,138,116,106,6,4,22,104,98,94,3,1,6,268,239,217,15,7,29
S01013331,481,403,340,34,29,78,54,28,21,2,5,26,143,119,97,13,9,24,83,77,68,4,5,6,54,50,42,4,4,4,147,129,112,11,6,18
S01013332,536,364,302,27,35,172,155,59,52,4,3,96,172,126,101,11,14,46,81,68,57,2,9,13,52,47,40,3,4,5,76,64,52,7,5,12
S01013333,643,472,410,36,26,171,122,51,43,6,2,71,186,142,121,9,12,44,101,84,78,3,3,17,102,82,68,7,7,20,132,113,100,11,2,19
S01013334,570,397,324,26,47,173,176,83,62,10,11,93,206,148,113,2,33,58,53,46,41,5,0,7,60,55,52,1,2,5,75,65,56,8,1,10
S01013335,571,383,294,25,64,188,176,92,67,6,19,84,214,153,111,11,31,61,70,51,40,4,7,19,49,40,33,4,3,9,62,47,43,0,4,15
S01013336,660,435,342,30,63,225,220,104,78,9,17,116,224,164,121,12,31,60,78,57,49,5,3,21,43,32,24,2,6,11,95,78,70,2,6,17
S01013337,784,527,447,49,31,257,170,63,50,7,6,107,212,163,134,16,13,49,123,94,81,7,6,29,87,69,61,6,2,18,192,138,121,13,4,54
S01013338,388,313,262,36,15,75,30,19,12,5,2,11,104,78,63,12,3,26,72,58,51,3,4,14,44,38,30,5,3,6,138,120,106,11,3,18
S01013339,473,347,302,30,15,126,75,31,24,4,3,44,117,90,68,13,9,27,80,61,60,1,0,19,59,51,47,3,1,8,142,114,103,9,2,28
S01013340,695,471,400,53,18,224,119,58,49,7,2,61,172,115,93,13,9,57,112,83,68,11,4,29,93,68,60,6,2,25,199,147,130,16,1,52
S01013341,726,549,449,67,33,177,99,51,28,17,6,48,169,120,99,11,10,49,79,58,45,7,6,21,76,63,50,11,2,13,303,257,227,21,9,46
S01013342,516,330,281,13,36,186,182,64,54,3,7,118,162,121,91,7,23,41,69,59,55,0,4,10,43,39,39,0,0,4,60,47,42,3,2,13
S01013343,526,375,326,23,26,151,136,59,50,5,4,77,168,125,110,6,9,43,84,75,63,3,9,9,66,59,54,3,2,7,72,57,49,6,2,15
S01013344,654,336,289,22,25,318,249,70,61,3,6,179,216,131,108,11,12,85,77,60,50,6,4,17,52,33,32,0,1,19,60,42,38,2,2,18
S01013345,575,399,348,18,33,176,176,92,79,3,10,84,187,139,125,4,10,48,75,58,49,4,5,17,60,47,41,3,3,13,77,63,54,4,5,14
S01013346,621,501,440,31,30,120,67,33,27,2,4,34,161,123,108,6,9,38,111,94,84,3,7,17,87,79,65,8,6,8,195,172,156,12,4,23
S01013347,575,451,390,31,30,124,104,55,46,4,5,49,143,120,93,11,16,23,106,88,78,7,3,18,75,61,59,1,1,14,147,127,114,8,5,20
S01013348,343,282,241,33,8,61,31,12,7,4,1,19,97,85,70,12,3,12,62,51,45,6,0,11,49,44,38,4,2,5,104,90,81,7,2,14
S01013349,615,509,450,25,34,106,75,48,44,4,0,27,164,121,99,8,14,43,82,73,66,4,3,9,71,66,60,2,4,5,223,201,181,7,13,22
S01013350,551,395,329,28,38,156,152,69,56,5,8,83,220,180,146,11,23,40,65,56,50,2,4,9,50,40,35,4,1,10,64,50,42,6,2,14
S01013351,631,439,391,24,24,192,126,46,37,6,3,80,183,137,118,8,11,46,101,79,72,2,5,22,73,60,56,3,1,13,148,117,108,5,4,31
S01013352,715,496,432,35,29,219,199,102,87,7,8,97,230,166,144,11,11,64,117,90,79,6,5,27,72,62,53,6,3,10,97,76,69,5,2,21
S01013353,510,341,281,30,30,169,155,69,56,7,6,86,179,126,105,5,16,53,67,53,41,10,2,14,51,45,36,4,5,6,58,48,43,4,1,10
S01013354,589,419,366,36,17,170,166,74,58,13,3,92,178,134,117,10,7,44,67,57,52,1,4,10,71,60,55,5,0,11,107,94,84,7,3,13
S01013355,522,345,285,35,25,177,167,67,51,10,6,100,162,121,97,12,12,41,51,36,28,6,2,15,48,41,36,2,3,7,94,80,73,5,2,14
S01013356,583,393,295,32,66,190,212,95,76,6,13,117,193,158,112,12,34,35,68,51,30,6,15,17,43,35,31,4,0,8,67,54,46,4,4,13
S01013357,658,455,389,38,28,203,151,54,40,7,7,97,212,167,136,13,18,45,96,76,71,3,2,20,58,41,36,5,0,17,141,117,106,10,1,24
S01013358,677,428,360,39,29,249,259,83,63,11,9,176,195,149,123,11,15,46,76,65,55,8,2,11,61,56,51,3,2,5,86,75,68,6,1,11
S01013359,503,294,241,26,27,209,216,85,68,10,7,131,145,103,82,3,18,42,61,46,40,6,0,15,35,28,24,2,2,7,46,32,27,5,0,14
S01013360,573,341,272,23,46,232,241,83,63,4,16,158,186,141,110,8,23,45,54,40,32,5,3,14,49,40,36,2,2,9,43,37,31,4,2,6
S01013361,482,287,245,10,32,195,199,58,49,2,7,141,135,106,87,4,15,29,59,47,45,0,2,12,44,36,31,2,3,8,45,40,33,2,5,5
S01013362,389,221,185,15,21,168,164,53,45,3,5,111,132,95,79,3,13,37,27,21,18,1,2,6,37,29,23,5,1,8,29,23,20,3,0,6
S01013363,610,362,279,20,63,248,236,86,65,7,14,150,216,162,113,8,41,54,72,49,43,3,3,23,49,42,36,1,5,7,37,23,22,1,0,14
S01013364,719,487,424,37,26,232,236,97,81,8,8,139,198,153,131,11,11,45,96,83,74,5,4,13,73,59,52,4,3,14,116,95,86,9,0,21
S01013365,668,480,392,58,30,188,155,71,49,15,7,84,159,122,98,14,10,37,132,102,79,13,10,30,75,60,56,3,1,15,147,125,110,13,2,22
S01013366,699,530,463,45,22,169,134,53,39,7,7,81,205,158,139,16,3,47,139,120,106,6,8,19,92,84,73,8,3,8,129,115,106,8,1,14
S01013367,470,362,305,43,14,108,91,38,28,10,0,53,131,101,81,13,7,30,80,69,58,9,2,11,62,61,56,3,2,1,106,93,82,8,3,13
S01013368,639,402,317,52,33,237,226,73,55,11,7,153,179,135,99,23,13,44,87,68,54,5,9,19,61,53,43,7,3,8,86,73,66,6,1,13
S01013369,711,392,326,21,45,319,279,90,72,5,13,189,235,153,128,6,19,82,72,47,40,3,4,25,60,46,42,1,3,14,65,56,44,6,6,9
S01013370,499,276,221,13,42,223,205,69,52,5,12,136,154,103,79,4,20,51,54,39,30,3,6,15,47,38,34,1,3,9,39,27,26,0,1,12
S01013371,558,265,228,19,18,293,241,68,60,6,2,173,149,92,78,4,10,57,50,34,29,2,3,16,48,36,31,2,3,12,70,35,30,5,0,35
S01013372,843,520,396,23,101,323,329,131,96,5,30,198,303,223,158,9,56,80,85,66,56,3,7,19,54,42,33,5,4,12,72,58,53,1,4,14
S01013373,757,436,352,30,54,321,320,116,90,10,16,204,222,146,113,10,23,76,76,65,52,5,8,11,60,47,42,1,4,13,79,62,55,4,3,17
S01013374,747,415,308,24,83,332,339,116,81,5,30,223,240,177,131,10,36,63,68,53,41,2,10,15,50,39,32,1,6,11,50,30,23,6,1,20
S01013375,467,297,249,15,33,170,183,77,65,4,8,106,135,103,79,5,19,32,52,45,36,6,3,7,46,37,36,0,1,9,51,35,33,0,2,16
S01013376,480,279,228,20,31,201,205,82,72,5,5,123,144,94,69,7,18,50,51,42,33,7,2,9,33,26,21,1,4,7,47,35,33,0,2,12
S01013377,654,358,292,17,49,296,278,86,68,5,13,192,182,128,97,4,27,54,69,53,44,5,4,16,60,44,38,2,4,16,65,47,45,1,1,18
S01013378,788,540,428,34,78,248,242,120,89,11,20,122,251,185,140,9,36,66,107,85,72,3,10,22,71,60,49,4,7,11,117,90,78,7,5,27
S01013379,705,467,401,34,32,238,223,100,77,13,10,123,217,155,133,10,12,62,91,72,64,3,5,19,58,43,38,2,3,15,116,97,89,6,2,19
S01013380,126,54,38,15,1,72,51,6,2,4,0,45,33,17,12,4,1,16,15,12,10,2,0,3,9,6,5,1,0,3,18,13,9,4,0,5
S01013381,403,257,197,30,30,146,171,75,60,7,8,96,120,86,66,10,10,34,35,33,23,5,5,2,33,28,26,1,1,5,44,35,22,7,6,9
S01013382,446,320,273,31,16,126,148,70,57,7,6,78,140,115,100,7,8,25,56,48,44,4,0,8,45,39,33,5,1,6,57,48,39,8,1,9
S01013383,581,318,266,17,35,263,238,68,57,5,6,170,183,137,106,6,25,46,62,44,41,1,2,18,43,30,28,2,0,13,55,39,34,3,2,16
S01013384,619,355,300,30,25,264,216,58,45,5,8,158,194,142,124,8,10,52,71,52,41,9,2,19,51,44,39,2,3,7,87,59,51,6,2,28
S01013385,407,277,241,20,16,130,104,34,26,3,5,70,108,87,76,7,4,21,61,53,46,4,3,8,58,48,42,4,2,10,76,55,51,2,2,21
S01013386,689,481,422,42,17,208,145,63,51,9,3,82,206,151,134,10,7,55,107,90,82,5,3,17,91,72,68,4,0,19,140,105,87,14,4,35
S01013387,471,270,221,13,36,201,178,62,46,4,12,116,161,110,90,5,15,51,55,35,30,3,2,20,35,29,27,0,2,6,42,34,28,1,5,8
S01013388,639,348,284,37,27,291,262,74,57,10,7,188,175,126,99,14,13,49,68,52,47,4,1,16,58,37,30,4,3,21,76,59,51,5,3,17
S01013389,623,443,385,27,31,180,177,81,72,4,5,96,203,164,136,11,17,39,98,83,74,4,5,15,62,48,41,5,2,14,83,67,62,3,2,16
S01013390,382,251,210,19,22,131,151,62,52,4,6,89,127,104,86,7,11,23,39,33,26,4,3,6,29,22,20,0,2,7,36,30,26,4,0,6
S01013391,356,231,179,33,19,125,113,40,32,3,5,73,98,75,63,10,2,23,49,42,30,7,5,7,33,30,20,7,3,3,63,44,34,6,4,19
S01013392,549,490,425,50,15,59,54,34,22,9,3,20,168,146,125,17,4,22,88,81,69,9,3,7,68,64,54,8,2,4,171,165,155,7,3,6
S01013393,563,343,276,33,34,220,183,54,41,3,10,129,194,142,107,16,19,52,72,57,46,8,3,15,44,38,33,3,2,6,70,52,49,3,0,18
S01013394,534,313,255,23,35,221,186,67,55,3,9,119,162,113,82,10,21,49,64,48,42,6,0,16,51,32,27,1,4,19,71,53,49,3,1,18
S01013395,518,309,221,17,71,209,192,65,47,2,16,127,205,147,98,4,45,58,58,44,35,4,5,14,27,21,16,2,3,6,36,32,25,5,2,4
S01013396,501,455,386,53,16,46,43,29,20,7,2,14,147,134,112,15,7,13,89,84,72,9,3,5,73,69,59,10,0,4,149,139,123,12,4,10
S01013397,705,481,399,47,35,224,223,92,70,10,12,131,219,167,136,14,17,52,72,66,56,6,4,6,68,59,52,6,1,9,123,97,85,11,1,26
S01013398,446,372,326,24,22,74,54,33,26,3,4,21,132,106,92,6,8,26,76,64,56,3,5,12,60,52,42,8,2,8,124,117,110,4,3,7
S01013399,839,622,560,39,23,217,192,70,59,4,7,122,221,180,158,17,5,41,122,106,96,7,3,16,116,96,85,7,4,20,188,170,162,4,4,18
S01013400,537,379,319,27,33,158,136,51,41,3,7,85,156,124,103,5,16,32,98,80,66,8,6,18,58,47,42,4,1,11,89,77,67,7,3,12
S01013401,616,530,455,49,26,86,51,29,19,5,5,22,164,137,116,14,7,27,104,87,73,10,4,17,81,74,62,5,7,7,216,203,185,15,3,13
S01013402,769,688,625,43,20,81,51,29,22,4,3,22,145,125,107,12,6,20,121,106,98,4,4,15,115,110,102,6,2,5,337,318,296,17,5,19
S01013403,622,544,490,35,19,78,47,33,29,4,0,14,158,132,111,8,13,26,110,95,83,8,4,15,85,74,70,4,0,11,222,210,197,11,2,12
S01013404,422,337,297,20,20,85,53,27,23,2,2,26,104,74,61,2,11,30,71,61,53,4,4,10,61,54,51,1,2,7,133,121,109,11,1,12
S01013405,571,341,278,26,37,230,167,52,37,3,12,115,170,123,104,8,11,47,57,45,34,7,4,12,57,45,40,2,3,12,120,76,63,6,7,44
S01013406,505,313,254,13,46,192,193,78,68,5,5,115,167,115,88,2,25,52,40,31,23,1,7,9,51,41,37,2,2,10,54,48,38,3,7,6
S01013407,436,265,226,15,24,171,154,58,43,2,13,96,142,95,84,5,6,47,39,25,20,3,2,14,38,33,30,1,2,5,63,54,49,4,1,9
S01013408,519,310,241,18,51,209,183,69,53,4,12,114,178,124,91,6,27,54,46,35,26,4,5,11,43,27,26,0,1,16,69,55,45,4,6,14
S01013409,834,605,490,64,51,229,180,93,72,10,11,87,254,195,144,24,27,59,125,92,79,7,6,33,81,73,63,8,2,8,194,152,132,15,5,42
S01013410,486,336,260,15,61,150,137,66,43,5,18,71,188,142,113,4,25,46,58,42,32,1,9,16,48,37,29,3,5,11,55,49,43,2,4,6
S01013411,604,420,354,39,27,184,129,50,43,5,2,79,174,130,104,10,16,44,84,63,58,3,2,21,60,51,44,4,3,9,157,126,105,17,4,31
S01013412,661,445,368,29,48,216,133,40,34,3,3,93,194,132,97,7,28,62,113,91,79,5,7,22,79,66,56,6,4,13,142,116,102,8,6,26
S01013413,636,408,358,34,16,228,122,27,22,2,3,95,107,77,64,7,6,30,100,74,66,5,3,26,82,63,57,5,1,19,225,167,149,15,3,58
S01013414,766,415,343,33,39,351,276,51,39,8,4,225,191,133,107,12,14,58,79,59,51,2,6,20,66,55,48,0,7,11,154,117,98,11,8,37
S01013415,566,289,223,25,41,277,243,70,48,5,17,173,146,98,76,9,13,48,68,47,38,3,6,21,44,34,28,2,4,10,65,40,33,6,1,25
S01013416,491,306,247,22,37,185,173,68,57,6,5,105,132,89,60,6,23,43,63,52,44,3,5,11,64,52,45,3,4,12,59,45,41,4,0,14
S01013417,730,479,406,26,47,251,187,72,53,7,12,115,195,139,115,6,18,56,110,89,74,5,10,21,77,59,53,3,3,18,161,120,111,5,4,41
S01013418,510,343,276,37,30,167,149,64,45,9,10,85,108,74,55,5,14,34,79,60,54,3,3,19,57,51,45,4,2,6,117,94,77,16,1,23
S01013419,387,272,230,27,15,115,49,21,15,6,0,28,99,74,65,7,2,25,77,57,44,3,10,20,47,37,32,4,1,10,115,83,74,7,2,32
S01013420,468,331,296,15,20,137,106,32,26,3,3,74,133,97,83,4,10,36,86,77,70,5,2,9,63,55,50,2,3,8,80,70,67,1,2,10
S01013421,565,484,427,38,19,81,79,44,37,5,2,35,150,128,103,13,12,22,96,83,76,6,1,13,74,70,65,5,0,4,166,159,146,9,4,7
S01013422,591,395,339,30,26,196,168,59,51,4,4,109,177,131,113,6,12,46,87,78,69,6,3,9,76,62,53,4,5,14,83,65,53,10,2,18
S01013423,668,449,384,38,27,219,158,61,51,3,7,97,190,137,112,12,13,53,116,89,79,6,4,27,68,50,43,5,2,18,136,112,99,12,1,24
S01013424,386,283,248,26,9,103,63,19,15,4,0,44,122,96,81,11,4,26,53,48,42,3,3,5,36,27,24,2,1,9,112,93,86,6,1,19
S01013425,358,235,196,22,17,123,80,33,24,5,4,47,78,51,41,2,8,27,57,47,38,8,1,10,68,48,40,4,4,20,75,56,53,3,0,19
S01013426,671,409,332,33,44,262,243,86,71,4,11,157,180,123,93,13,17,57,75,61,51,4,6,14,87,71,61,3,7,16,86,68,56,9,3,18
S01013427,348,284,234,40,10,64,41,21,11,9,1,20,66,49,39,6,4,17,62,58,51,5,2,4,40,35,29,5,1,5,139,121,104,15,2,18
S01013428,739,491,389,39,63,248,216,93,64,10,19,123,237,169,135,6,28,68,87,68,54,5,9,19,86,70,57,8,5,16,113,91,79,10,2,22
S01013429,549,384,316,35,33,165,157,58,45,8,5,99,169,142,115,11,16,27,79,68,60,5,3,11,56,45,34,6,5,11,88,71,62,5,4,17
S01013430,552,401,329,41,31,151,161,76,57,12,7,85,175,144,115,15,14,31,62,53,42,5,6,9,63,54,48,4,2,9,91,74,67,5,2,17
S01013431,563,356,272,44,40,207,213,78,59,9,10,135,151,119,88,10,21,32,74,57,44,7,6,17,52,44,35,7,2,8,73,58,46,11,1,15
S01013432,591,392,306,59,27,199,172,66,47,15,4,106,147,109,87,11,11,38,74,59,44,8,7,15,60,53,41,9,3,7,138,105,87,16,2,33
S01013433,601,391,319,56,16,210,107,33,27,5,1,74,133,93,75,11,7,40,79,55,44,8,3,24,53,40,31,7,2,13,229,170,142,25,3,59
S01013434,421,311,213,89,9,110,49,20,10,10,0,29,81,49,25,21,3,32,53,40,28,10,2,13,45,42,29,13,0,3,193,160,121,35,4,33
S01013435,488,373,316,52,5,115,24,5,4,1,0,19,54,34,25,7,2,20,77,53,46,6,1,24,46,39,29,9,1,7,287,242,212,29,1,45
S01013436,662,458,392,41,25,204,171,69,59,3,7,102,172,128,105,13,10,44,82,58,51,6,1,24,61,49,44,3,2,12,176,154,133,16,5,22
S01013437,561,392,343,31,18,169,110,35,29,4,2,75,134,98,80,11,7,36,85,64,61,1,2,21,60,52,47,2,3,8,172,143,126,13,4,29
S01013438,469,287,225,36,26,182,106,33,29,3,1,73,124,90,73,4,13,34,54,35,24,8,3,19,54,39,33,3,3,15,131,90,66,18,6,41
S01013439,738,436,363,53,20,302,50,15,11,4,0,35,112,57,43,9,5,55,94,61,54,2,5,33,74,41,32,6,3,33,408,262,223,32,7,146
S01013440,827,502,427,61,14,325,60,16,10,5,1,44,110,53,41,10,2,57,111,65,55,6,4,46,65,36,32,4,0,29,481,332,289,36,7,149
S01013441,639,402,331,60,11,237,74,21,10,5,6,53,94,47,41,5,1,47,69,40,33,5,2,29,44,35,29,6,0,9,358,259,218,39,2,99
S01013442,633,450,392,46,12,183,87,35,30,4,1,52,127,83,69,7,7,44,112,86,77,8,1,26,67,57,49,7,1,10,240,189,167,20,2,51
S01013443,509,339,283,42,14,170,80,20,15,5,0,60,103,65,52,10,3,38,52,35,28,6,1,17,45,36,28,5,3,9,229,183,160,16,7,46
S01013444,814,510,402,69,39,304,195,42,30,2,10,153,160,106,81,11,14,54,80,57,42,8,7,23,76,65,51,9,5,11,303,240,198,39,3,63
S01013445,580,298,247,44,7,282,128,12,7,5,0,116,77,41,33,6,2,36,72,46,40,6,0,26,66,28,25,2,1,38,237,171,142,25,4,66
S01013446,578,363,304,28,31,215,186,72,59,6,7,114,165,121,96,11,14,44,68,52,46,3,3,16,53,43,36,3,4,10,106,75,67,5,3,31
S01013447,421,351,302,38,11,70,11,4,2,2,0,7,54,33,26,5,2,21,53,42,40,1,1,11,43,40,36,3,1,3,260,232,198,27,7,28
S01013448,688,389,321,50,18,299,83,16,11,2,3,67,113,58,45,8,5,55,100,57,41,11,5,43,62,43,39,4,0,19,330,215,185,25,5,115
S01013449,524,380,334,39,7,144,52,20,15,4,1,32,102,67,58,5,4,35,81,60,52,7,1,21,67,53,49,4,0,14,222,180,160,19,1,42
S01013450,470,356,324,23,9,114,39,18,15,2,1,21,92,62,56,3,3,30,67,51,48,2,1,16,66,55,45,9,1,11,206,170,160,7,3,36
S01013451,668,522,446,53,23,146,46,22,18,3,1,24,101,67,53,8,6,34,135,98,84,7,7,37,66,57,52,4,1,9,320,278,239,31,8,42
S01013452,606,436,360,59,17,170,48,18,12,3,3,30,100,72,59,5,8,28,108,77,64,11,2,31,57,43,34,8,1,14,293,226,191,32,3,67
S01013453,599,368,295,24,49,231,224,90,74,2,14,134,188,131,95,10,26,57,66,57,51,2,4,9,36,26,23,1,2,10,85,64,52,9,3,21
S01013454,600,425,350,60,15,175,112,48,34,9,5,64,142,101,88,10,3,41,80,61,48,10,3,19,61,46,36,9,1,15,205,169,144,22,3,36
S01013455,467,308,244,44,20,159,96,36,28,7,1,60,113,81,61,7,13,32,69,53,45,7,1,16,39,28,18,8,2,11,150,110,92,15,3,40
S01013456,649,406,336,29,41,243,213,64,52,4,8,149,163,124,94,8,22,39,99,76,64,6,6,23,58,44,39,1,4,14,116,98,87,10,1,18
S01013457,728,448,380,25,43,280,282,121,101,9,11,161,238,168,140,6,22,70,86,59,54,2,3,27,52,40,38,2,0,12,70,60,47,6,7,10
S01013458,588,418,335,45,38,170,125,68,54,4,10,57,185,138,105,14,19,47,85,70,62,5,3,15,64,49,40,5,4,15,129,93,74,17,2,36
S01013459,723,422,359,35,28,301,272,82,60,13,9,190,187,133,117,6,10,54,83,63,58,3,2,20,60,45,38,7,0,15,121,99,86,6,7,22
S01013460,653,413,342,33,38,240,242,101,86,5,10,141,188,129,103,10,16,59,79,61,49,6,6,18,59,53,42,8,3,6,85,69,62,4,3,16
S01013461,829,620,534,41,45,209,186,89,75,6,8,97,267,205,169,17,19,62,120,100,90,2,8,20,85,74,66,6,2,11,171,152,134,10,8,19
S01013462,681,539,474,42,23,142,123,56,43,10,3,67,190,154,132,13,9,36,124,108,100,3,5,16,82,77,69,6,2,5,162,144,130,10,4,18
S01013463,404,308,253,20,35,96,83,45,36,6,3,38,141,113,89,5,19,28,43,33,27,1,5,10,53,43,37,4,2,10,84,74,64,4,6,10
S01013464,620,374,326,37,11,246,147,37,30,5,2,110,168,127,110,9,8,41,84,59,56,3,0,25,52,44,39,4,1,8,169,107,91,16,0,62
S01013465,587,335,290,28,17,252,158,40,35,3,2,118,168,106,91,8,7,62,92,69,62,5,2,23,47,39,30,6,3,8,122,81,72,6,3,41
S01013466,401,203,140,35,28,198,49,22,9,8,5,27,136,62,41,7,14,74,70,32,21,6,5,38,51,27,20,4,3,24,95,60,49,10,1,35
S01013467,721,519,462,44,13,202,125,49,39,9,1,76,187,130,116,11,3,57,98,79,70,5,4,19,86,67,56,9,2,19,225,194,181,10,3,31
S01013468,586,334,274,35,25,252,192,43,29,9,5,149,121,79,60,10,9,42,89,73,65,5,3,16,46,32,23,4,5,14,138,107,97,7,3,31
S01013469,645,400,340,47,13,245,151,51,43,7,1,100,173,110,92,10,8,63,100,71,61,9,1,29,74,55,49,5,1,19,147,113,95,16,2,34
S01013470,577,381,318,26,37,196,195,86,66,9,11,109,193,149,127,7,15,44,66,57,44,5,8,9,41,34,31,2,1,7,82,55,50,3,2,27
S01013471,743,502,424,33,45,241,207,87,66,9,12,120,243,188,161,9,18,55,105,80,69,6,5,25,79,67,58,3,6,12,109,80,70,6,4,29
S01013472,469,374,313,43,18,95,67,30,22,5,3,37,135,108,83,20,5,27,75,61,51,4,6,14,48,41,39,1,1,7,144,134,118,13,3,10
S01013473,469,395,343,38,14,74,43,20,13,7,0,23,106,89,69,13,7,17,81,67,58,6,3,14,55,50,43,6,1,5,184,169,160,6,3,15
S01013474,465,362,314,35,13,103,80,38,34,4,0,42,119,94,72,16,6,25,80,64,56,8,0,16,52,47,40,3,4,5,134,119,112,4,3,15
S01013475,511,348,286,37,25,163,118,51,40,8,3,67,155,102,83,9,10,53,85,73,61,7,5,12,52,44,37,6,1,8,101,78,65,7,6,23
S01013476,538,341,295,24,22,197,141,52,45,5,2,89,163,110,91,8,11,53,94,77,69,2,6,17,33,23,20,2,1,10,107,79,70,7,2,28
S01013477,512,316,257,31,28,196,174,60,46,4,10,114,121,91,70,8,13,30,77,59,49,7,3,18,52,40,35,4,1,12,88,66,57,8,1,22
S01013478,671,502,414,47,41,169,137,59,48,6,5,78,208,163,121,20,22,45,118,96,84,5,7,22,59,53,48,2,3,6,149,131,113,14,4,18
S01013479,683,407,341,27,39,276,272,90,72,3,15,182,179,130,111,7,12,49,82,70,59,7,4,12,54,45,36,4,5,9,96,72,63,6,3,24
S01013480,566,322,274,21,27,244,245,86,71,7,8,159,157,118,98,9,11,39,64,41,37,1,3,23,36,28,23,2,3,8,64,49,45,2,2,15
S01013481,393,242,196,30,16,151,98,36,27,4,5,62,108,74,59,9,6,34,58,34,26,6,2,24,49,38,32,4,2,11,80,60,52,7,1,20
