,All people in households,1. Higher managerial administrative and professional occupations,1. Higher managerial administrative and professional occupations: 1.1 Large employers and higher managerial and administrative occupations,1. Higher managerial administrative and professional occupations: 1.2 Higher professional occupations,2. Lower managerial administrative and professional occupations,3. Intermediate occupations,4. Small employers and own account workers,5. Lower supervisory and technical occupations,6. Semi-routine occupations,7. Routine occupations,8. Never worked and long-term unemployed,8. Never worked and long-term unemployed: L14.1 Never worked,8. Never worked and long-term unemployed: L14.2 Long-term unemployed,L15 Full-time students
S92000003,5196386,609599,127981,481618,1145517,564970,526729,542524,736243,745556,195576,110654,84922,129672
S01006506,852,182,20,162,225,79,87,83,86,83,17,13,4,10
S01006507,836,128,20,108,182,68,88,106,115,130,9,8,1,10
S01006508,643,125,20,105,168,112,62,76,46,43,3,2,1,8
S01006509,580,77,22,55,127,53,62,77,100,80,3,2,1,1
S01006510,577,104,27,77,137,53,51,75,82,56,15,11,4,4
S01006511,749,212,71,141,221,77,87,57,43,40,9,5,4,3
S01006512,496,180,33,147,143,13,82,23,30,18,3,0,3,4
S01006513,568,176,41,135,180,60,46,55,32,18,1,1,0,0
S01006514,940,397,87,310,279,92,78,42,17,29,5,5,0,1
S01006515,762,308,51,257,206,49,82,27,41,24,9,9,0,16
S01006516,467,179,46,133,140,23,76,18,14,7,0,0,0,10
S01006517,1014,399,92,307,260,66,110,75,57,24,17,17,0,6
S01006518,627,274,87,187,172,41,77,26,28,0,4,2,2,5
S01006519,807,311,57,254,219,84,88,29,42,24,3,0,3,7
S01006520,729,401,86,315,188,26,33,34,26,7,14,0,14,0
S01006521,663,304,90,214,184,26,86,34,24,4,1,0,1,0
S01006522,574,284,45,239,163,35,40,24,18,7,0,0,0,3
S01006523,941,388,101,287,274,71,68,69,29,20,6,3,3,16
S01006524,711,292,84,208,174,50,88,35,32,25,13,6,7,2
S01006525,798,319,79,240,191,67,79,48,45,27,4,4,0,18
S01006526,902,64,13,51,165,111,42,123,157,112,24,11,13,104
S01006527,674,43,7,36,84,76,31,125,121,152,12,7,5,30
S01006528,981,88,6,82,164,79,52,152,149,163,24,20,4,110
S01006529,892,98,10,88,184,88,62,93,132,99,14,11,3,122
S01006530,748,49,8,41,126,96,48,110,96,137,32,28,4,54
S01006531,955,71,5,66,151,91,35,87,186,221,29,9,20,84
S01006532,703,179,26,153,219,78,82,32,43,28,6,6,0,36
S01006533,694,259,50,209,231,41,50,34,42,16,2,2,0,19
S01006534,910,331,89,242,279,73,78,62,43,19,7,3,4,18
S01006535,1038,227,40,187,335,109,61,85,90,58,7,3,4,66
S01006536,1013,240,38,202,354,99,49,78,76,54,10,2,8,53
S01006537,754,235,40,195,199,109,79,54,56,15,5,5,0,2
S01006538,569,188,43,145,166,50,50,73,27,10,3,1,2,2
S01006539,713,209,37,172,224,83,54,65,30,34,4,4,0,10
S01006540,960,289,51,238,282,131,61,74,54,39,6,6,0,24
S01006541,801,230,55,175,247,86,48,74,77,28,9,5,4,2
S01006542,1000,324,59,265,325,117,63,57,54,45,9,9,0,6
S01006543,797,185,39,146,265,102,69,79,56,30,5,2,3,6
S01006544,1020,406,76,330,267,53,133,74,43,19,3,1,2,22
S01006545,1065,280,55,225,314,154,88,59,87,50,13,10,3,20
S01006546,626,197,34,163,256,59,33,32,14,24,9,5,4,2
S01006547,907,209,68,141,241,103,65,69,105,82,15,12,3,18
S01006548,721,207,41,166,279,69,70,24,44,15,9,8,1,4
S01006549,811,270,56,214,225,59,102,55,49,42,4,1,3,5
S01006550,909,314,60,254,263,87,79,73,50,27,4,2,2,12
S01006551,690,117,11,106,120,83,74,69,90,125,8,5,3,4
S01006552,870,224,36,188,277,112,85,68,65,33,5,3,2,1
S01006553,826,144,22,122,175,104,116,88,113,70,11,7,4,5
S01006554,692,106,8,98,195,73,55,68,83,89,14,7,7,9
S01006555,763,53,8,45,152,95,41,102,137,156,17,11,6,10
S01006556,838,33,9,24,149,90,73,105,136,217,23,13,10,12
S01006557,701,51,14,37,109,87,38,115,154,124,15,9,6,8
S01006558,622,213,23,190,185,56,34,52,26,30,3,3,0,23
S01006559,607,283,37,246,179,36,21,24,12,9,4,3,1,39
S01006560,985,373,46,327,284,96,75,49,53,28,6,6,0,21
S01006561,766,290,58,232,233,52,74,41,39,15,4,1,3,18
S01006562,703,211,24,187,183,65,51,48,90,45,6,5,1,4
S01006563,824,310,31,279,203,57,45,80,48,63,3,0,3,15
S01006564,980,131,10,121,234,80,65,95,138,102,45,28,17,90
S01006565,850,118,8,110,188,86,35,105,97,89,15,9,6,117
S01006566,748,171,10,161,200,99,26,61,56,38,6,4,2,91
S01006567,835,97,9,88,171,78,23,95,101,98,28,12,16,144
S01006568,923,245,8,237,268,81,28,66,69,40,11,2,9,115
S01006569,566,192,27,165,112,45,36,42,51,43,5,4,1,40
S01006570,783,258,54,204,232,56,56,66,46,20,8,1,7,41
S01006571,886,322,39,283,282,61,52,39,43,30,11,6,5,46
S01006572,901,419,113,306,247,38,101,46,35,8,3,1,2,4
S01006573,724,383,97,286,176,21,53,38,22,4,7,1,6,20
S01006574,977,452,99,353,266,45,68,47,58,10,10,1,9,21
S01006575,909,322,52,270,257,70,66,107,48,12,7,1,6,20
S01006576,714,266,48,218,196,71,47,42,32,22,2,2,0,36
S01006577,769,215,26,189,221,73,66,70,48,29,5,2,3,42
S01006578,1032,217,11,206,303,117,26,88,95,77,15,5,10,94
S01006579,964,190,15,175,263,119,16,82,107,58,7,5,2,122
S01006580,712,210,19,191,218,75,35,64,52,30,1,1,0,27
S01006581,889,363,89,274,222,54,99,66,54,22,5,5,0,4
S01006582,797,181,5,176,185,79,41,45,118,41,7,2,5,100
S01006583,712,145,6,139,158,71,13,63,80,31,6,1,5,145
S01006584,628,161,12,149,180,43,27,48,37,27,0,0,0,105
S01006585,795,74,1,73,139,75,57,91,114,131,29,16,13,85
S01006586,1017,139,8,131,190,101,39,94,136,117,12,10,2,189
S01006587,535,86,4,82,95,60,38,53,69,41,7,3,4,86
S01006588,586,85,2,83,126,55,12,56,67,41,5,2,3,139
S01006589,682,72,2,70,97,53,26,64,69,105,19,6,13,177
S01006590,633,148,9,139,156,68,30,46,63,40,8,7,1,74
S01006591,705,182,15,167,184,74,25,47,85,47,4,2,2,57
S01006592,680,171,18,153,203,72,42,62,57,28,0,0,0,45
S01006593,742,224,30,194,210,64,21,64,32,44,3,3,0,80
S01006594,539,115,25,90,105,112,33,53,30,45,1,0,1,45
S01006595,916,225,22,203,255,123,33,70,77,47,12,8,4,74
S01006596,678,194,12,182,201,59,51,58,54,30,4,2,2,27
S01006597,513,89,6,83,143,52,23,51,49,38,6,4,2,62
S01006598,957,357,61,296,263,81,79,84,37,35,2,1,1,19
S01006599,805,105,10,95,175,96,48,78,121,93,16,7,9,73
S01006600,1058,249,34,215,236,122,81,84,140,92,12,11,1,42
S01006601,1002,217,37,180,253,130,71,90,103,80,15,8,7,43
S01006602,851,313,72,241,216,70,75,49,69,34,1,0,1,24
S01006603,820,61,22,39,91,72,27,154,137,241,24,16,8,13
S01006604,675,35,0,35,122,73,80,81,123,154,5,0,5,2
S01006605,802,50,5,45,104,83,44,93,192,189,39,19,20,8
S01006606,818,118,21,97,220,92,86,85,98,98,13,6,7,8
S01006607,932,72,9,63,140,114,72,152,162,183,21,12,9,16
S01006608,732,123,15,108,163,72,124,98,52,74,7,0,7,19
S01006609,1063,54,3,51,139,131,74,199,196,231,24,8,16,15
S01006610,449,29,14,15,69,56,16,79,93,98,9,9,0,0
S01006611,919,46,5,41,179,101,56,137,147,217,28,6,22,8
S01006612,861,95,9,86,223,111,76,65,123,146,18,13,5,4
S01006613,612,96,20,76,165,103,56,74,59,58,1,0,1,0
S01006614,678,129,23,106,223,78,44,82,64,46,6,0,6,6
S01006615,796,208,61,147,225,66,92,102,45,43,0,0,0,15
S01006616,788,113,23,90,191,92,58,128,96,90,4,1,3,16
S01006617,681,54,9,45,137,116,87,76,94,109,0,0,0,8
S01006618,514,89,27,62,107,70,37,83,73,55,0,0,0,0
S01006619,881,107,20,87,190,70,98,160,95,148,8,8,0,5
S01006620,848,95,17,78,196,119,55,106,114,146,10,6,4,7
S01006621,520,34,7,27,122,55,43,108,72,79,3,0,3,4
S01006622,669,94,18,76,174,117,89,75,60,58,1,1,0,1
S01006623,705,66,6,60,116,101,38,129,108,134,2,0,2,11
S01006624,806,61,6,55,135,91,41,117,126,160,20,11,9,55
S01006625,623,34,5,29,94,74,49,89,111,155,11,2,9,6
S01006626,718,17,6,11,76,60,35,95,164,226,15,9,6,30
S01006627,843,64,15,49,165,100,31,99,126,213,20,8,12,25
S01006628,1097,84,5,79,152,98,43,175,184,260,23,11,12,78
S01006629,724,31,12,19,84,52,42,98,157,201,29,13,16,30
S01006630,627,16,4,12,45,70,38,104,127,195,23,17,6,9
S01006631,904,46,10,36,129,82,29,123,211,242,30,26,4,12
S01006632,812,43,2,41,93,74,35,82,194,218,47,28,19,26
S01006633,699,25,9,16,56,56,33,81,142,247,39,26,13,20
S01006634,634,29,10,19,56,38,15,91,98,213,84,51,33,10
S01006635,658,40,0,40,84,50,25,106,127,195,15,8,7,16
S01006636,870,18,2,16,78,49,31,125,229,259,50,32,18,31
S01006637,706,113,14,99,129,67,34,59,97,113,19,13,6,75
S01006638,834,93,13,80,158,88,18,62,140,113,15,6,9,147
S01006639,945,80,18,62,153,77,36,96,134,159,34,23,11,176
S01006640,723,160,27,133,169,49,17,67,44,36,2,1,1,179
S01006641,1000,143,9,134,186,82,35,94,130,99,23,15,8,208
S01006642,830,100,10,90,143,71,24,65,69,79,10,8,2,269
S01006643,730,92,10,82,116,68,27,41,62,45,10,5,5,269
S01006644,963,134,11,123,152,80,27,78,115,94,7,4,3,276
S01006645,687,52,11,41,125,57,19,86,130,143,22,13,9,53
S01006646,550,54,3,51,118,47,5,53,82,47,7,5,2,137
S01006647,648,44,2,42,122,74,31,67,106,106,16,5,11,82
S01006648,1078,96,7,89,209,104,34,154,140,119,21,6,15,201
S01006649,961,126,2,124,163,114,28,94,143,117,28,13,15,148
S01006650,859,90,6,84,181,56,48,77,106,78,13,7,6,210
S01006651,635,65,0,65,91,69,14,84,57,76,16,8,8,163
S01006652,545,72,1,71,105,46,29,50,48,49,14,5,9,132
S01006653,564,132,10,122,127,39,29,48,47,38,1,0,1,103
S01006654,904,77,6,71,138,109,48,89,162,183,28,17,11,70
S01006655,624,164,19,145,161,51,33,38,50,40,2,1,1,85
S01006656,954,159,4,155,201,121,28,84,114,88,26,4,22,133
S01006657,536,80,9,71,94,66,11,50,74,62,2,1,1,97
S01006658,1019,75,1,74,129,80,39,143,146,153,32,13,19,222
S01006659,632,103,9,94,102,43,25,61,48,24,3,3,0,223
S01006660,527,27,1,26,44,26,36,65,81,96,29,16,13,123
S01006661,622,105,17,88,106,60,19,57,43,43,3,0,3,186
S01006662,600,22,2,20,85,45,27,68,106,78,21,16,5,148
S01006663,562,71,4,67,57,43,32,26,29,25,13,8,5,266
S01006664,503,78,1,77,74,11,10,44,62,23,6,5,1,195
S01006665,584,70,4,66,100,44,22,40,45,45,7,5,2,211
S01006666,877,29,0,29,86,69,67,120,181,222,61,37,24,42
S01006667,737,29,5,24,81,40,28,101,143,184,59,38,21,72
S01006668,723,84,5,79,147,73,20,47,81,36,7,3,4,228
S01006669,730,113,3,110,81,47,29,76,127,139,15,9,6,103
S01006670,530,44,6,38,106,74,21,47,80,85,5,1,4,68
S01006671,465,80,22,58,73,47,15,51,46,45,9,6,3,99
S01006672,752,53,0,53,107,45,26,76,142,179,33,22,11,91
S01006673,719,82,1,81,91,59,46,75,141,110,16,8,8,99
S01006674,928,48,7,41,97,105,66,137,161,232,38,18,20,44
S01006675,712,15,2,13,92,41,39,79,166,204,37,18,19,39
S01006676,747,70,0,70,66,51,30,77,137,227,38,16,22,51
S01006677,723,28,1,27,95,52,26,89,131,185,25,8,17,92
S01006678,1148,37,7,30,137,57,50,152,250,332,60,32,28,73
S01006679,654,52,9,43,166,79,37,89,101,99,5,1,4,26
S01006680,851,15,3,12,93,54,47,113,134,313,59,24,35,23
S01006681,734,34,8,26,168,68,30,121,140,142,15,4,11,16
S01006682,853,37,5,32,110,37,72,84,161,260,44,22,22,48
S01006683,872,62,3,59,125,80,30,90,173,201,21,6,15,90
S01006684,684,55,13,42,76,58,35,99,144,149,21,7,14,47
S01006685,740,43,4,39,162,79,27,70,115,185,31,7,24,28
S01006686,622,60,7,53,108,53,39,71,136,128,13,6,7,14
S01006687,833,65,6,59,147,88,35,128,171,147,20,13,7,32
S01006688,948,111,29,82,194,76,91,113,152,160,16,16,0,35
S01006689,629,156,21,135,184,61,64,37,38,20,0,0,0,69
S01006690,594,93,6,87,135,60,32,64,70,51,11,3,8,78
S01006691,559,132,6,126,99,33,41,43,65,39,4,3,1,103
S01006692,737,154,33,121,191,63,49,71,62,52,0,0,0,95
S01006693,1001,127,14,113,206,112,55,124,96,185,22,15,7,74
S01006694,865,13,6,7,122,111,44,134,191,216,19,13,6,15
S01006695,712,95,21,74,106,46,65,92,106,180,12,9,3,10
S01006696,849,73,11,62,112,123,35,112,168,147,23,17,6,56
S01006697,926,56,4,52,135,94,69,160,171,194,13,6,7,34
S01006698,691,38,0,38,112,75,20,66,127,196,22,16,6,35
S01006699,471,54,15,39,97,41,36,37,66,111,2,0,2,27
S01006700,830,111,13,98,155,84,66,105,118,131,15,7,8,45
S01006701,728,19,3,16,101,79,42,130,161,162,29,16,13,5
S01006702,761,27,2,25,81,92,58,119,164,203,13,5,8,4
S01006703,675,35,4,31,100,58,35,72,186,165,14,7,7,10
S01006704,605,13,10,3,78,64,17,76,130,173,41,22,19,13
S01006705,739,47,15,32,94,71,55,115,146,195,11,4,7,5
S01006706,619,32,6,26,99,86,41,81,133,124,19,12,7,4
S01006707,685,37,6,31,101,55,38,92,157,155,34,13,21,16
S01006708,790,36,9,27,131,99,50,104,146,199,15,15,0,10
S01006709,878,45,14,31,121,95,92,122,155,196,29,18,11,23
S01006710,853,19,4,15,188,122,59,134,123,182,23,13,10,3
S01006711,927,48,18,30,161,127,81,115,150,214,23,15,8,8
S01006712,524,22,16,6,95,70,28,96,70,134,7,4,3,2
S01006713,937,47,11,36,137,104,54,125,171,286,7,7,0,6
S01006714,682,30,7,23,85,96,36,103,115,188,7,6,1,22
S01006715,623,23,0,23,78,39,34,85,109,188,45,29,16,22
S01006716,606,22,3,19,109,72,62,70,112,125,13,10,3,21
S01006717,974,30,7,23,124,117,64,132,175,275,43,27,16,14
S01006718,627,33,6,27,77,57,57,95,98,171,29,14,15,10
S01006719,916,55,8,47,153,81,63,133,150,243,21,12,9,17
S01006720,587,28,6,22,83,68,28,69,125,170,11,8,3,5
S01006721,888,23,2,21,171,70,59,105,153,251,46,22,24,10
S01006722,774,39,5,34,100,63,36,120,188,197,23,8,15,8
S01006723,645,34,7,27,117,76,46,92,109,155,15,11,4,1
S01006724,1005,30,10,20,122,56,67,115,226,298,67,41,26,24
S01006725,664,31,16,15,76,54,43,94,134,197,22,11,11,13
S01006726,1391,28,2,26,126,98,61,192,239,455,156,79,77,36
S01006727,956,28,3,25,101,72,44,131,212,282,62,41,21,24
S01006728,754,54,9,45,137,76,36,91,168,146,29,20,9,17
S01006729,831,19,2,17,101,67,26,96,180,272,63,34,29,7
S01006730,704,42,4,38,131,86,36,90,143,160,8,5,3,8
S01006731,577,10,0,10,83,56,44,79,95,181,24,13,11,5
S01006732,933,268,71,197,250,76,156,76,43,38,17,16,1,9
S01006733,900,302,56,246,270,104,86,46,52,25,0,0,0,15
S01006734,910,318,58,260,255,57,97,71,45,58,4,0,4,5
S01006735,618,233,56,177,190,54,45,31,27,31,2,2,0,5
S01006736,1079,297,52,245,318,107,102,122,49,63,11,3,8,10
S01006737,669,175,57,118,164,63,93,79,39,51,0,0,0,5
S01006738,827,74,11,63,187,145,56,140,100,101,12,7,5,12
S01006739,607,68,14,54,180,70,38,62,88,81,10,4,6,10
S01006740,737,40,12,28,162,78,35,111,138,159,8,3,5,6
S01006741,666,43,6,37,97,95,42,98,133,153,5,5,0,0
S01006742,460,25,6,19,72,57,32,84,85,100,4,2,2,1
S01006743,531,48,6,42,103,86,41,70,77,86,1,1,0,19
S01006744,608,59,22,37,131,71,58,98,103,70,12,8,4,6
S01006745,822,51,12,39,143,111,55,98,154,192,11,10,1,7
S01006746,806,54,15,39,143,102,52,145,149,144,8,6,2,9
S01006747,816,124,17,107,246,107,45,101,101,76,6,4,2,10
S01006748,906,151,44,107,237,95,81,113,91,129,9,8,1,0
S01006749,909,79,10,69,212,90,50,119,175,172,12,10,2,0
S01006750,641,48,14,34,129,75,46,108,105,119,7,7,0,4
S01006751,509,50,23,27,105,32,46,90,93,80,11,11,0,2
S01006752,712,64,11,53,123,87,17,142,126,139,9,7,2,5
S01006753,913,175,44,131,207,94,85,138,95,106,5,4,1,8
S01006754,892,171,37,134,235,102,74,127,89,82,10,4,6,2
S01006755,731,129,17,112,208,79,90,72,75,57,10,0,10,11
S01006756,658,204,47,157,213,62,40,47,61,15,5,1,4,11
S01006757,737,95,19,76,242,107,65,100,47,71,6,1,5,4
S01006758,694,159,37,122,191,65,44,80,89,56,2,0,2,8
S01006759,595,117,33,84,170,60,48,80,40,75,3,3,0,2
S01006760,493,74,17,57,142,79,31,69,37,58,1,0,1,2
S01006761,697,121,35,86,190,86,66,65,70,97,2,0,2,0
S01006762,805,108,17,91,221,80,97,102,90,104,3,3,0,0
S01006763,865,141,25,116,269,89,79,119,73,69,5,2,3,21
S01006764,790,109,33,76,236,90,46,125,66,107,4,2,2,7
S01006765,586,91,13,78,172,74,45,79,56,60,7,3,4,2
S01006766,608,149,40,109,169,82,58,51,47,42,7,7,0,3
S01006767,689,103,22,81,154,85,47,111,101,86,2,1,1,0
S01006768,599,179,61,118,187,52,57,46,32,42,1,1,0,3
S01006769,959,132,29,103,210,118,76,169,140,106,6,6,0,2
S01006770,655,91,31,60,176,90,49,90,84,65,7,5,2,3
S01006771,465,102,21,81,139,28,44,50,61,30,0,0,0,11
S01006772,839,132,30,102,219,95,100,93,110,89,1,0,1,0
S01006773,672,82,12,70,197,94,100,95,66,29,0,0,0,9
S01006774,651,122,44,78,192,59,70,98,72,38,0,0,0,0
S01006775,618,58,14,44,137,89,42,69,115,97,5,1,4,6
S01006776,496,34,14,20,77,56,22,76,108,111,8,7,1,4
S01006777,649,86,17,69,195,90,70,82,52,63,0,0,0,11
S01006778,634,102,25,77,108,89,53,65,101,103,11,4,7,2
S01006779,615,43,6,37,94,68,43,71,131,132,13,7,6,20
S01006780,576,53,11,42,143,64,79,81,70,78,4,2,2,4
S01006781,691,116,34,82,158,112,80,82,61,77,5,3,2,0
S01006782,744,124,41,83,204,71,75,93,77,70,4,4,0,26
S01006783,672,76,10,66,162,99,48,105,78,97,7,3,4,0
S01006784,599,80,15,65,184,69,57,66,62,51,1,0,1,29
S01006785,611,125,40,85,190,67,61,81,62,22,0,0,0,3
S01006786,832,181,30,151,249,84,77,91,71,58,6,4,2,15
S01006787,650,107,24,83,144,93,51,83,79,80,2,2,0,11
S01006788,746,177,44,133,167,53,104,90,80,59,1,0,1,15
S01006789,596,97,23,74,115,41,101,90,81,62,8,3,5,1
S01006790,889,118,35,83,181,72,97,131,167,112,4,0,4,7
S01006791,529,60,13,47,115,27,107,100,57,53,10,4,6,0
S01006792,482,73,14,59,97,41,88,65,55,60,0,0,0,3
S01006793,506,56,24,32,117,26,81,88,54,76,1,1,0,7
S01006794,560,85,19,66,121,38,71,66,86,85,8,5,3,0
S01006795,733,223,50,173,157,60,91,77,63,49,6,0,6,7
S01006796,575,113,31,82,130,52,87,63,72,38,15,12,3,5
S01006797,613,145,53,92,169,27,115,54,48,43,9,2,7,3
S01006798,625,106,33,73,133,63,178,79,30,29,3,3,0,4
S01006799,875,111,19,92,213,91,105,142,98,106,8,7,1,1
S01006800,853,307,71,236,193,36,116,78,56,56,4,4,0,7
S01006801,875,178,41,137,200,78,155,101,80,76,7,4,3,0
S01006802,675,92,24,68,124,45,124,85,93,108,4,2,2,0
S01006803,687,56,16,40,151,73,48,121,93,130,9,7,2,6
S01006804,748,132,47,85,191,53,67,115,95,88,2,1,1,5
S01006805,1122,152,43,109,266,77,181,130,160,143,10,4,6,3
S01006806,1031,168,30,138,259,66,218,120,94,98,4,4,0,4
S01006807,620,62,9,53,133,57,113,77,79,84,13,1,12,2
S01006808,626,142,31,111,199,43,87,77,37,34,2,0,2,5
S01006809,813,76,37,39,186,42,115,124,112,132,19,8,11,7
S01006810,877,157,38,119,188,71,174,99,71,97,14,6,8,6
S01006811,1090,229,60,169,272,100,152,119,97,96,24,14,10,1
S01006812,735,132,19,113,185,63,116,83,75,75,4,1,3,2
S01006813,789,104,21,83,171,53,118,124,92,111,15,3,12,1
S01006814,782,193,49,144,250,65,78,79,67,48,1,1,0,1
S01006815,577,51,17,34,98,48,51,83,105,120,18,7,11,3
S01006816,703,128,51,77,174,71,95,93,74,62,6,6,0,0
S01006817,650,114,20,94,138,65,82,69,79,92,4,1,3,7
S01006818,719,126,32,94,166,36,173,78,82,47,11,7,4,0
S01006819,836,209,50,159,236,40,172,57,59,48,8,6,2,7
S01006820,444,103,31,72,143,47,45,51,29,26,0,0,0,0
S01006821,582,129,30,99,137,47,126,48,42,42,6,3,3,5
S01006822,759,186,56,130,166,53,181,57,62,52,2,1,1,0
S01006823,676,187,30,157,200,77,34,92,49,33,4,3,1,0
S01006824,813,26,10,16,142,65,73,82,179,200,38,19,19,8
S01006825,807,80,14,66,189,79,53,155,121,120,7,5,2,3
S01006826,884,239,85,154,236,47,107,97,65,84,3,3,0,6
S01006827,884,130,28,102,202,106,47,104,147,125,20,8,12,3
S01006828,914,128,40,88,236,112,90,114,134,84,13,8,5,3
S01006829,428,151,35,116,110,34,45,45,22,21,0,0,0,0
S01006830,729,103,16,87,174,91,108,94,84,60,14,9,5,1
S01006831,538,111,29,82,189,47,39,63,62,27,0,0,0,0
S01006832,1003,289,105,184,291,60,96,101,75,83,7,7,0,1
S01006833,438,132,31,101,144,30,69,25,27,9,2,2,0,0
S01006834,532,166,51,115,181,49,50,35,25,23,3,2,1,0
S01006835,841,129,35,94,219,76,110,118,113,64,9,9,0,3
S01006836,514,162,35,127,165,36,34,44,40,30,2,0,2,1
S01006837,599,132,27,105,186,54,86,69,32,36,4,4,0,0
S01006838,648,156,31,125,188,53,72,65,39,73,1,1,0,1
S01006839,1040,148,30,118,286,127,91,120,114,138,10,3,7,6
S01006840,1020,236,46,190,286,109,98,109,96,78,3,1,2,5
S01006841,922,170,19,151,311,110,73,108,64,73,6,0,6,7
S01006842,809,109,34,75,253,117,79,89,92,70,0,0,0,0
S01006843,835,130,32,98,214,156,70,114,87,61,0,0,0,3
S01006844,671,84,6,78,178,97,70,94,77,65,4,3,1,2
S01006845,942,170,47,123,321,91,75,126,103,49,7,3,4,0
S01006846,551,61,19,42,130,86,48,84,71,69,2,2,0,0
S01006847,659,123,29,94,199,82,74,84,48,45,4,0,4,0
S01006848,916,256,62,194,182,45,159,94,67,96,8,1,7,9
S01006849,971,192,43,149,244,147,85,96,87,97,9,7,2,14
S01006850,959,91,26,65,258,129,73,128,136,129,11,2,9,4
S01006851,805,79,37,42,181,90,79,108,128,120,18,15,3,2
S01006852,595,117,38,79,160,55,92,69,62,37,3,2,1,0
S01006853,842,309,93,216,199,24,148,65,24,64,4,1,3,5
S01006854,853,178,56,122,221,77,120,86,73,85,13,3,10,0
S01006855,790,263,68,195,215,38,171,40,27,31,4,4,0,1
S01006856,678,170,35,135,205,33,82,67,54,60,0,0,0,7
S01006857,997,206,45,161,247,42,260,77,64,87,13,7,6,1
S01006858,642,177,17,160,151,25,165,26,55,38,5,5,0,0
S01006859,1084,355,108,247,320,72,116,68,110,36,1,1,0,6
S01006860,542,63,11,52,102,34,70,55,85,115,11,10,1,7
S01006861,604,253,48,205,182,56,42,49,14,3,0,0,0,5
S01006862,681,137,23,114,142,72,67,97,80,76,8,2,6,2
S01006863,687,82,24,58,155,69,95,114,78,89,5,5,0,0
S01006864,447,78,24,54,113,52,33,58,60,44,7,2,5,2
S01006865,902,241,60,181,224,63,114,87,81,84,4,4,0,4
S01006866,549,191,37,154,173,50,34,55,23,15,1,1,0,7
S01006867,723,273,70,203,197,37,92,48,49,19,2,2,0,6
S01006868,879,182,41,141,197,80,63,115,119,108,7,4,3,8
S01006869,490,106,18,88,92,39,81,56,59,54,3,0,3,0
S01006870,483,108,12,96,128,40,78,52,22,42,6,3,3,7
S01006871,711,170,55,115,213,63,66,50,76,56,13,3,10,4
S01006872,714,249,72,177,189,24,102,85,34,27,0,0,0,4
S01006873,955,273,51,222,228,54,181,73,74,54,14,10,4,4
S01006874,566,162,45,117,127,26,109,57,49,35,1,1,0,0
S01006875,694,86,15,71,141,41,135,86,99,92,5,1,4,9
S01006876,992,146,39,107,182,80,275,126,75,93,15,9,6,0
S01006877,928,194,38,156,240,71,246,67,59,42,6,4,2,3
S01006878,704,72,12,60,127,69,211,71,82,65,7,3,4,0
S01006879,740,143,37,106,130,28,193,112,47,68,12,4,8,7
S01006880,600,164,35,129,192,37,82,59,32,27,2,2,0,5
S01006881,578,138,47,91,104,29,130,63,58,48,8,3,5,0
S01006882,398,26,8,18,67,37,36,66,68,84,12,12,0,2
S01006883,458,72,14,58,122,44,65,46,51,53,5,1,4,0
S01006884,888,117,32,85,220,83,112,111,111,116,13,7,6,5
S01006885,518,124,30,94,149,37,81,54,30,43,0,0,0,0
S01006886,733,185,35,150,171,43,111,80,68,68,7,3,4,0
S01006887,587,158,38,120,134,37,107,61,31,55,2,1,1,2
S01006888,800,149,27,122,209,55,181,76,65,58,7,4,3,0
S01006889,826,60,21,39,166,53,40,139,137,196,16,5,11,19
S01006890,665,144,18,126,195,55,78,90,46,53,4,1,3,0
S01006891,913,170,31,139,236,65,94,129,105,107,7,3,4,0
S01006892,612,48,6,42,122,38,60,127,89,103,12,9,3,13
S01006893,543,45,15,30,121,55,54,87,72,94,8,8,0,7
S01006894,934,125,20,105,256,90,66,132,97,146,19,17,2,3
S01006895,534,51,8,43,100,59,39,82,92,91,15,11,4,5
S01006896,768,104,31,73,167,85,44,126,82,136,13,7,6,11
S01006897,708,123,36,87,162,65,52,129,96,81,0,0,0,0
S01006898,751,92,20,72,168,70,62,109,106,130,8,8,0,6
S01006899,609,143,48,95,197,78,32,75,22,58,4,4,0,0
S01006900,579,98,31,67,141,55,54,80,59,83,8,8,0,1
S01006901,595,38,12,26,140,64,42,74,89,136,6,5,1,6
S01006902,693,89,25,64,187,66,42,81,112,106,10,5,5,0
S01006903,778,70,17,53,142,81,53,88,135,182,18,15,3,9
S01006904,694,88,18,70,159,68,47,95,110,117,4,3,1,6
S01006905,878,168,49,119,217,76,100,87,115,104,9,9,0,2
S01006906,843,48,11,37,150,92,78,105,161,177,26,16,10,6
S01006907,594,43,9,34,157,59,64,71,57,127,14,12,2,2
S01006908,803,67,12,55,172,88,63,105,110,172,22,10,12,4
S01006909,768,199,59,140,243,82,84,78,48,30,4,4,0,0
S01006910,852,220,50,170,208,72,153,75,39,68,6,2,4,11
S01006911,671,202,34,168,208,67,24,67,59,40,4,0,4,0
S01006912,423,90,16,74,116,23,81,28,46,39,0,0,0,0
S01006913,546,141,39,102,178,47,41,48,43,41,0,0,0,7
S01006914,743,207,38,169,165,43,121,92,25,88,0,0,0,2
S01006915,826,168,31,137,190,63,139,120,67,72,6,6,0,1
S01006916,562,101,23,78,128,65,38,89,75,54,7,5,2,5
S01006917,996,314,58,256,308,91,94,87,56,34,4,0,4,8
S01006918,493,122,22,100,110,53,51,61,49,42,5,1,4,0
S01006919,485,109,21,88,122,50,68,55,36,41,1,0,1,3
S01006920,502,82,24,58,148,44,51,56,68,49,4,4,0,0
S01006921,829,180,35,145,295,73,61,116,55,42,7,4,3,0
S01006922,506,125,38,87,118,19,94,30,63,45,5,2,3,7
S01006923,775,183,45,138,163,60,133,86,86,51,13,9,4,0
S01006924,556,160,52,108,142,34,124,42,33,19,0,0,0,2
S01006925,499,88,24,64,148,60,41,51,38,63,3,3,0,7
S01006926,737,192,48,144,242,54,73,87,56,24,5,0,5,4
S01006927,1002,253,35,218,312,140,82,103,56,46,6,0,6,4
S01006928,1033,179,14,165,305,93,107,160,88,83,9,4,5,9
S01006929,836,374,112,262,227,89,60,30,33,19,3,1,2,1
S01006930,889,248,60,188,337,77,68,78,38,37,6,5,1,0
S01006931,392,105,15,90,103,42,74,29,20,19,0,0,0,0
S01006932,614,164,54,110,184,73,62,51,38,26,3,3,0,13
S01006933,580,156,9,147,178,65,36,55,36,54,0,0,0,0
S01006934,558,124,27,97,111,42,88,71,50,63,6,4,2,3
S01006935,699,171,43,128,215,73,64,61,61,46,2,2,0,6
S01006936,643,106,34,72,236,76,58,66,54,42,5,4,1,0
S01006937,730,141,27,114,259,79,57,70,75,33,9,3,6,7
S01006938,537,96,18,78,133,74,42,65,60,62,4,3,1,1
S01006939,615,166,52,114,171,81,38,45,61,49,1,1,0,3
S01006940,939,221,56,165,323,92,79,113,70,32,3,3,0,6
S01006941,626,99,18,81,189,83,35,85,67,64,4,2,2,0
S01006942,1082,242,68,174,342,111,136,118,79,45,1,1,0,8
S01006943,682,247,49,198,247,43,54,39,32,17,3,0,3,0
S01006944,874,190,44,146,265,125,61,94,74,52,5,0,5,8
S01006945,508,139,39,100,155,53,46,50,44,19,2,0,2,0
S01006946,800,180,44,136,244,61,94,80,58,67,3,1,2,13
S01006947,861,200,27,173,222,119,62,112,48,84,7,5,2,7
S01006948,871,161,47,114,253,81,111,115,57,82,3,2,1,8
S01006949,655,182,39,143,180,53,96,70,39,25,4,4,0,6
S01006950,548,119,18,101,136,45,48,88,54,57,0,0,0,1
S01006951,470,75,16,59,105,58,45,95,36,49,7,5,2,0
S01006952,827,175,51,124,143,76,143,93,84,111,2,2,0,0
S01006953,793,210,72,138,221,63,113,93,47,46,0,0,0,0
S01006954,829,155,34,121,228,84,99,116,78,60,5,1,4,4
S01006955,622,74,20,54,153,88,48,104,80,65,5,4,1,5
S01006956,1105,223,48,175,376,94,92,157,77,70,10,2,8,6
S01006957,1053,214,42,172,288,74,196,154,70,46,2,2,0,9
S01006958,876,160,33,127,283,82,89,85,90,79,3,1,2,5
S01006959,680,92,17,75,126,68,60,78,99,138,16,11,5,3
S01006960,976,304,103,201,272,59,98,126,59,44,5,2,3,9
S01006961,984,198,39,159,350,97,79,123,70,58,2,2,0,7
S01006962,871,127,18,109,233,72,75,144,114,100,6,5,1,0
S01006963,663,110,35,75,220,53,62,101,42,58,10,8,2,7
S01006964,741,97,28,69,196,74,52,121,93,102,4,0,4,2
S01006965,488,109,26,83,129,40,53,58,39,54,6,2,4,0
S01006966,602,44,4,40,144,77,49,70,86,108,17,4,13,7
S01006967,629,108,22,86,209,44,38,115,49,61,1,0,1,4
S01006968,514,44,8,36,117,54,46,72,86,89,2,1,1,4
S01006969,889,131,44,87,242,100,69,108,99,129,6,4,2,5
S01006970,712,148,47,101,227,102,39,125,55,11,0,0,0,5
S01006971,510,51,14,37,100,36,45,63,95,106,9,8,1,5
S01006972,522,112,31,81,121,47,122,44,46,30,0,0,0,0
S01006973,522,118,31,87,146,51,78,41,50,34,3,3,0,1
S01006974,1037,257,59,198,306,103,97,143,83,43,5,3,2,0
S01006975,951,187,49,138,195,77,205,103,99,81,1,1,0,3
S01006976,446,82,31,51,132,19,98,42,29,32,4,0,4,8
S01006977,823,189,41,148,168,42,206,80,72,57,0,0,0,9
S01006978,855,174,33,141,205,54,123,112,83,81,14,8,6,9
S01006979,842,163,59,104,176,56,145,91,105,92,6,4,2,8
S01006980,843,181,52,129,226,54,119,83,85,67,19,10,9,9
S01006981,798,156,55,101,179,71,131,73,101,79,7,5,2,1
S01006982,910,158,54,104,205,81,132,113,105,105,9,7,2,2
S01006983,743,153,52,101,196,68,127,85,53,50,11,2,9,0
S01006984,702,210,14,196,178,44,113,58,53,36,6,3,3,4
S01006985,1006,157,27,130,242,75,123,133,97,171,7,7,0,1
S01006986,646,139,28,111,159,59,51,94,51,73,8,8,0,12
S01006987,665,114,22,92,177,66,47,72,81,82,25,12,13,1
S01006988,612,114,33,81,154,64,103,56,59,48,5,2,3,9
S01006989,1026,319,75,244,246,85,154,87,60,65,2,2,0,8
S01006990,905,240,56,184,265,61,123,107,57,44,8,0,8,0
S01006991,443,57,11,46,86,26,68,57,80,69,0,0,0,0
S01006992,608,108,31,77,184,34,127,59,43,45,2,2,0,6
S01006993,535,52,11,41,130,29,127,79,59,53,3,3,0,3
S01006994,559,109,20,89,129,31,113,72,31,72,2,2,0,0
S01006995,859,150,45,105,212,46,178,107,73,83,10,1,9,0
S01006996,782,98,33,65,171,34,130,113,81,145,4,3,1,6
S01006997,786,248,63,185,195,42,110,82,42,60,7,3,4,0
S01006998,1091,162,42,120,290,81,201,140,99,101,10,5,5,7
S01006999,848,88,21,67,159,30,257,129,76,89,7,5,2,13
S01007000,927,149,33,116,227,85,138,121,76,116,12,8,4,3
S01007001,906,171,36,135,240,69,118,120,79,102,7,5,2,0
S01007002,605,74,16,58,121,55,97,62,78,105,13,11,2,0
S01007003,524,65,8,57,89,38,185,41,31,68,7,2,5,0
S01007004,718,112,18,94,128,67,201,67,55,77,1,1,0,10
S01007005,904,169,31,138,236,55,190,94,57,100,2,0,2,1
S01007006,898,126,30,96,161,46,161,101,140,155,5,2,3,3
S01007007,848,79,20,59,149,38,258,140,80,97,7,2,5,0
S01007008,991,111,34,77,136,61,108,168,179,201,25,20,5,2
S01007009,1011,65,13,52,222,91,132,132,161,190,16,8,8,2
S01007010,781,101,21,80,190,66,102,77,117,119,6,4,2,3
S01007011,857,37,15,22,117,64,102,110,182,194,38,22,16,13
S01007012,707,19,11,8,75,58,33,101,150,212,49,23,26,10
S01007013,565,52,5,47,101,19,211,66,43,65,5,2,3,3
S01007014,996,114,34,80,222,72,217,177,117,66,3,1,2,8
S01007015,625,56,21,35,106,30,218,90,37,77,5,3,2,6
S01007016,592,78,13,65,112,34,132,80,71,78,7,1,6,0
S01007017,986,77,11,66,119,89,87,155,203,223,29,19,10,4
S01007018,990,89,26,63,194,88,134,167,153,154,11,9,2,0
S01007019,665,32,3,29,113,53,74,97,107,162,14,5,9,13
S01007020,768,58,25,33,133,51,86,156,117,127,35,23,12,5
S01007021,879,60,25,35,159,75,74,107,179,207,10,10,0,8
S01007022,498,38,14,24,88,22,71,75,84,104,14,9,5,2
S01007023,494,18,2,16,106,25,149,62,83,48,3,3,0,0
S01007024,1014,52,8,44,204,45,296,120,142,125,20,14,6,10
S01007025,854,40,16,24,118,56,81,144,131,268,16,8,8,0
S01007026,860,48,16,32,167,66,156,126,133,150,11,10,1,3
S01007027,1085,81,29,52,207,37,212,169,143,202,25,22,3,9
S01007028,734,59,13,46,148,56,191,78,96,86,15,12,3,5
S01007029,560,46,6,40,95,28,223,40,44,75,9,3,6,0
S01007030,820,32,14,18,153,39,142,110,131,204,9,7,2,0
S01007031,630,36,8,28,127,23,100,83,136,109,14,6,8,2
S01007032,966,67,12,55,193,76,88,109,209,184,34,19,15,6
S01007033,740,28,4,24,116,69,32,111,157,207,16,13,3,4
S01007034,592,42,16,26,127,45,49,80,104,120,18,8,10,7
S01007035,786,27,17,10,76,44,76,87,211,246,15,8,7,4
S01007036,919,96,33,63,223,54,163,133,117,104,13,13,0,16
S01007037,1020,40,17,23,142,108,104,147,173,274,28,12,16,4
S01007038,755,25,9,16,128,62,90,95,159,173,16,5,11,7
S01007039,860,36,22,14,136,49,110,145,136,212,23,13,10,13
S01007040,647,43,18,25,71,53,73,84,139,158,17,9,8,9
S01007041,713,47,12,35,154,38,117,122,116,91,27,21,6,1
S01007042,737,69,11,58,106,59,118,120,96,144,25,14,11,0
S01007043,964,115,28,87,167,55,288,137,108,84,10,3,7,0
S01007044,667,48,11,37,108,39,194,94,86,81,7,5,2,10
S01007045,799,83,13,70,149,47,249,94,83,78,16,12,4,0
S01007046,574,23,0,23,117,25,121,89,90,103,6,6,0,0
S01007047,665,36,9,27,138,50,169,100,71,92,9,6,3,0
S01007048,879,80,22,58,142,53,241,117,105,118,19,18,1,4
S01007049,945,41,14,27,168,72,104,145,175,211,28,15,13,1
S01007050,641,74,25,49,94,34,134,90,89,112,13,13,0,1
S01007051,768,83,23,60,127,64,108,142,90,130,21,17,4,3
S01007052,573,51,18,33,87,53,85,109,72,107,7,4,3,2
S01007053,494,69,22,47,104,44,93,94,37,52,0,0,0,1
S01007054,957,75,21,54,148,57,119,174,143,208,27,12,15,6
S01007055,515,51,15,36,90,27,187,48,50,55,2,1,1,5
S01007056,614,73,14,59,129,41,185,51,72,40,11,10,1,12
S01007057,520,33,8,25,121,75,58,83,63,82,5,5,0,0
S01007058,576,32,5,27,93,70,66,102,85,111,11,10,1,6
S01007059,1020,114,39,75,195,99,127,154,145,166,18,11,7,2
S01007060,604,25,6,19,81,50,35,119,102,150,34,13,21,8
S01007061,930,146,34,112,261,84,173,120,80,57,9,2,7,0
S01007062,665,121,36,85,122,35,192,84,54,53,2,2,0,2
S01007063,670,61,8,53,159,40,112,94,75,115,9,9,0,5
S01007064,627,82,9,73,119,56,155,74,56,76,7,7,0,2
S01007065,578,91,25,66,187,56,79,63,40,53,6,6,0,3
S01007066,648,87,25,62,149,25,129,95,52,91,5,2,3,15
S01007067,553,67,24,43,146,66,49,109,50,54,6,2,4,6
S01007068,708,112,37,75,138,70,103,114,75,67,21,14,7,8
S01007069,845,59,27,32,167,100,87,123,142,124,21,12,9,22
S01007070,500,17,4,13,95,49,50,83,92,98,15,8,7,1
S01007071,821,98,24,74,205,65,69,130,110,124,16,4,12,4
S01007072,641,61,33,28,149,66,89,109,84,72,6,1,5,5
S01007073,913,75,17,58,210,102,141,144,116,119,2,2,0,4
S01007074,661,40,11,29,101,58,66,105,139,132,17,5,12,3
S01007075,727,36,6,30,97,83,29,117,126,219,11,7,4,9
S01007076,759,44,10,34,128,61,72,145,127,165,12,12,0,5
S01007077,674,37,12,25,123,58,50,131,146,118,6,4,2,5
S01007078,843,68,35,33,105,82,95,156,111,179,36,15,21,11
S01007079,978,57,13,44,183,73,91,158,192,194,23,17,6,7
S01007080,790,38,22,16,133,86,67,134,152,137,30,5,25,13
S01007081,951,39,22,17,127,42,115,151,162,286,27,17,10,2
S01007082,551,20,0,20,88,17,54,121,104,131,13,6,7,3
S01007083,904,24,9,15,94,56,51,129,204,285,38,27,11,23
S01007084,559,37,14,23,120,66,63,89,103,77,2,2,0,2
S01007085,770,74,22,52,141,51,59,132,136,139,30,6,24,8
S01007086,1118,34,8,26,134,59,64,134,248,349,62,24,38,34
S01007087,868,47,6,41,73,46,70,119,182,273,46,34,12,12
S01007088,535,16,2,14,43,24,33,84,129,163,35,16,19,8
S01007089,529,74,41,33,126,40,81,102,56,47,3,1,2,0
S01007090,540,33,14,19,146,61,52,84,90,71,3,1,2,0
S01007091,829,70,25,45,140,66,56,162,123,182,19,8,11,11
S01007092,624,22,11,11,99,53,44,115,112,157,14,9,5,8
S01007093,952,107,26,81,210,104,104,183,120,116,5,3,2,3
S01007094,893,71,19,52,222,57,165,146,98,127,4,3,1,3
S01007095,551,87,24,63,113,27,133,74,56,52,9,7,2,0
S01007096,837,120,29,91,190,49,137,148,70,107,7,5,2,9
S01007097,484,72,22,50,83,20,116,75,53,61,4,3,1,0
S01007098,807,103,49,54,216,30,191,121,83,57,2,2,0,4
S01007099,883,61,26,35,219,55,203,131,101,103,10,6,4,0
S01007100,722,56,17,39,174,55,108,124,80,100,9,3,6,16
S01007101,800,32,5,27,125,36,61,116,176,226,26,16,10,2
S01007102,697,54,23,31,127,35,140,133,91,97,13,10,3,7
S01007103,832,68,23,45,157,38,165,153,113,130,6,6,0,2
S01007104,486,55,11,44,62,50,145,34,81,52,7,7,0,0
S01007105,543,45,6,39,121,33,88,91,68,89,7,5,2,1
S01007106,713,39,8,31,150,45,122,106,112,107,29,15,14,3
S01007107,685,72,34,38,164,41,164,102,48,77,2,1,1,15
S01007108,577,48,15,33,108,19,190,79,66,59,7,3,4,1
S01007109,824,25,15,10,116,49,103,107,131,256,26,16,10,11
S01007110,796,60,37,23,127,63,97,142,124,160,23,5,18,0
S01007111,525,25,10,15,94,34,76,100,81,94,14,9,5,7
S01007112,540,52,15,37,105,28,122,90,53,74,13,9,4,3
S01007113,496,73,22,51,120,21,94,74,64,45,5,4,1,0
S01007114,888,55,9,46,140,90,111,169,128,185,5,5,0,5
S01007115,641,67,30,37,152,36,75,129,72,90,10,10,0,10
S01007116,1006,138,44,94,236,58,208,182,106,60,12,4,8,6
S01007117,471,64,39,25,116,18,97,79,43,50,1,1,0,3
S01007118,679,11,2,9,77,44,62,108,149,184,39,20,19,5
S01007119,812,23,11,12,97,35,65,165,135,239,30,12,18,23
S01007120,1078,31,13,18,149,34,67,209,241,286,56,18,38,5
S01007121,533,18,4,14,66,46,59,57,120,145,14,8,6,8
S01007122,594,47,16,31,135,39,87,99,76,95,11,10,1,5
S01007123,644,25,16,9,92,53,41,97,97,215,11,8,3,13
S01007124,913,55,22,33,153,54,114,190,136,191,14,7,7,6
S01007125,867,53,9,44,106,43,75,106,191,261,18,12,6,14
S01007126,919,11,0,11,81,29,74,147,188,289,75,39,36,25
S01007127,1007,45,24,21,82,48,74,146,227,323,47,10,37,15
S01007128,847,9,0,9,100,51,56,177,158,240,41,16,25,15
S01007129,956,294,46,248,322,94,103,47,47,40,9,6,3,0
S01007130,612,92,13,79,158,69,65,85,74,63,3,2,1,3
S01007131,775,102,36,66,241,104,76,95,67,78,7,4,3,5
S01007132,700,129,13,116,193,96,74,81,63,62,2,1,1,0
S01007133,674,123,17,106,164,68,142,63,49,62,2,2,0,1
S01007134,743,118,23,95,156,65,126,94,70,109,4,4,0,1
S01007135,558,124,27,97,158,58,117,25,38,35,1,1,0,2
S01007136,533,162,28,134,125,43,126,33,16,16,4,0,4,8
S01007137,751,192,47,145,265,46,105,71,46,24,2,0,2,0
S01007138,597,90,16,74,188,54,105,65,44,36,8,3,5,7
S01007139,776,93,33,60,163,84,126,106,114,82,8,1,7,0
S01007140,1022,153,36,117,340,79,194,84,60,96,4,1,3,12
S01007141,684,117,40,77,166,64,129,62,72,64,5,5,0,5
S01007142,566,162,41,121,213,64,50,30,24,23,0,0,0,0
S01007143,671,124,37,87,231,65,63,101,46,40,1,0,1,0
S01007144,589,68,10,58,179,42,151,35,56,46,12,9,3,0
S01007145,892,124,34,90,247,147,115,66,90,82,18,15,3,3
S01007146,759,111,21,90,225,111,66,76,79,73,6,3,3,12
S01007147,711,76,18,58,250,88,57,76,80,57,20,12,8,7
S01007148,538,101,17,84,142,78,54,47,64,44,8,0,8,0
S01007149,542,61,14,47,177,86,40,76,46,53,3,3,0,0
S01007150,700,125,37,88,243,103,77,57,56,33,1,1,0,5
S01007151,859,164,40,124,276,112,84,93,90,36,4,2,2,0
S01007152,543,95,39,56,187,80,54,50,44,28,2,2,0,3
S01007153,633,74,25,49,206,109,56,70,53,56,3,3,0,6
S01007154,776,65,14,51,265,129,39,56,117,77,15,12,3,13
S01007155,640,82,17,65,204,97,56,63,75,52,8,7,1,3
S01007156,722,49,9,40,185,75,73,89,126,107,11,9,2,7
S01007157,648,23,4,19,137,97,57,111,109,98,8,5,3,8
S01007158,939,86,23,63,272,126,67,154,111,88,23,8,15,12
S01007159,840,36,13,23,184,110,74,84,140,183,19,5,14,10
S01007160,826,42,11,31,181,79,69,140,135,155,22,11,11,3
S01007161,701,68,20,48,182,98,67,86,94,84,20,15,5,2
S01007162,523,55,16,39,141,70,36,60,72,64,14,8,6,11
S01007163,865,112,27,85,224,142,77,88,106,101,10,10,0,5
S01007164,558,63,8,55,177,59,50,51,69,78,5,4,1,6
S01007165,788,138,32,106,264,71,99,61,71,49,20,14,6,15
S01007166,707,112,33,79,198,88,66,92,54,80,13,7,6,4
S01007167,795,123,38,85,260,86,89,74,67,73,8,4,4,15
S01007168,965,176,30,146,303,137,98,88,84,76,1,1,0,2
S01007169,758,123,23,100,224,88,61,91,78,75,13,7,6,5
S01007170,648,71,26,45,125,54,171,79,67,53,22,12,10,6
S01007171,799,85,20,65,149,51,190,76,143,88,12,4,8,5
S01007172,792,153,39,114,214,36,148,74,106,56,3,1,2,2
S01007173,881,69,13,56,256,151,93,106,118,72,8,5,3,8
S01007174,851,84,27,57,205,101,99,110,131,81,36,24,12,4
S01007175,665,69,36,33,162,65,51,58,137,115,2,2,0,6
S01007176,708,60,23,37,189,99,68,90,117,62,18,2,16,5
S01007177,631,32,8,24,112,71,38,75,138,127,29,9,20,9
S01007178,1047,37,7,30,159,112,96,135,237,204,61,26,35,6
S01007179,914,129,34,95,285,91,100,106,85,115,0,0,0,3
S01007180,750,92,40,52,252,111,85,50,84,65,8,7,1,3
S01007181,739,114,31,83,223,83,135,70,45,44,17,7,10,8
S01007182,1024,136,39,97,242,111,102,114,138,144,27,15,12,10
S01007183,1078,93,37,56,229,92,113,141,197,178,24,16,8,11
S01007184,1039,42,2,40,256,82,79,162,187,172,38,20,18,21
S01007185,820,38,8,30,124,97,78,85,117,208,61,36,25,12
S01007186,593,26,3,23,71,61,45,69,116,127,64,33,31,14
S01007187,804,49,15,34,152,73,69,101,142,181,19,7,12,18
S01007188,602,27,3,24,101,45,91,97,100,97,32,14,18,12
S01007189,768,30,6,24,147,89,65,91,156,133,48,33,15,9
S01007190,815,51,25,26,179,79,124,100,127,139,11,10,1,5
S01007191,616,27,0,27,89,52,57,69,140,147,23,6,17,12
S01007192,612,27,13,14,53,43,48,88,161,154,31,23,8,7
S01007193,769,25,11,14,97,37,102,93,166,213,34,15,19,2
S01007194,641,10,2,8,54,69,41,78,165,138,83,44,39,3
S01007195,580,28,8,20,95,30,54,61,128,138,41,21,20,5
S01007196,768,23,5,18,125,87,58,122,191,133,23,8,15,6
S01007197,637,16,2,14,83,39,43,102,142,147,56,22,34,9
S01007198,532,14,8,6,76,42,45,84,91,113,57,26,31,10
S01007199,804,33,14,19,70,57,34,115,185,178,104,55,49,28
S01007200,849,24,5,19,158,59,54,126,179,208,36,18,18,5
S01007201,738,56,14,42,157,65,60,104,97,173,21,6,15,5
S01007202,735,35,3,32,117,62,59,101,157,150,49,22,27,5
S01007203,643,28,6,22,131,55,54,115,106,134,13,4,9,7
S01007204,956,88,25,63,269,61,159,133,88,132,14,12,2,12
S01007205,672,86,19,67,164,46,130,64,92,83,2,2,0,5
S01007206,392,18,2,16,90,18,37,55,78,77,13,7,6,6
S01007207,898,70,22,48,212,75,101,148,138,129,17,5,12,8
S01007208,990,60,21,39,173,123,49,143,162,188,66,22,44,26
S01007209,702,45,7,38,188,84,90,60,87,110,32,19,13,6
S01007210,779,23,2,21,125,63,50,145,145,176,47,35,12,5
S01007211,967,33,15,18,209,77,79,142,191,173,46,26,20,17
S01007212,546,35,9,26,142,47,61,79,81,78,19,7,12,4
S01007213,873,94,12,82,261,89,91,108,120,86,16,12,4,8
S01007214,726,44,3,41,139,76,61,71,152,145,30,18,12,8
S01007215,770,57,6,51,145,77,53,120,114,148,36,20,16,20
S01007216,694,90,20,70,163,82,58,99,87,92,20,15,5,3
S01007217,943,70,26,44,167,68,76,138,187,186,41,18,23,10
S01007218,876,145,45,100,244,87,91,97,120,79,9,4,5,4
S01007219,808,35,20,15,165,60,91,111,128,185,30,16,14,3
S01007220,701,26,7,19,87,81,64,137,124,157,23,18,5,2
S01007221,699,108,22,86,191,65,84,101,59,68,10,10,0,13
S01007222,806,68,29,39,153,52,73,129,162,139,27,13,14,3
S01007223,516,106,36,70,133,43,51,74,50,48,11,7,4,0
S01007224,615,100,28,72,144,57,78,85,58,85,6,3,3,2
S01007225,873,132,39,93,212,66,170,113,85,75,15,11,4,5
S01007226,797,109,23,86,191,27,214,84,112,49,11,4,7,0
S01007227,962,110,30,80,205,75,130,129,137,150,18,12,6,8
S01007228,648,57,15,42,159,38,188,64,83,49,7,6,1,3
S01007229,1102,109,37,72,265,81,245,129,119,126,27,16,11,1
S01007230,742,20,11,9,73,50,55,113,194,195,29,13,16,13
S01007231,701,27,8,19,85,61,37,97,164,168,53,26,27,9
S01007232,726,23,6,17,82,55,47,101,167,161,75,36,39,15
S01007233,788,69,10,59,155,65,97,111,105,154,29,19,10,3
S01007234,613,31,14,17,122,48,50,60,136,147,18,1,17,1
S01007235,774,52,20,32,159,54,75,106,129,166,28,8,20,5
S01007236,619,66,27,39,111,68,68,95,93,93,10,2,8,15
S01007237,719,64,26,38,168,76,86,103,121,84,12,1,11,5
S01007238,915,51,16,35,193,95,73,144,157,176,17,3,14,9
S01007239,810,160,58,102,206,89,109,103,62,71,6,5,1,4
S01007240,539,58,14,44,132,31,132,51,79,52,1,1,0,3
S01007241,614,103,31,72,98,64,149,78,68,50,4,0,4,0
S01007242,999,90,17,73,272,100,133,131,113,123,30,17,13,7
S01007243,585,70,21,49,185,56,94,65,38,62,13,5,8,2
S01007244,717,81,26,55,183,56,137,83,64,102,10,7,3,1
S01007245,669,27,6,21,143,66,164,76,94,89,7,5,2,3
S01007246,564,50,12,38,102,55,114,59,49,125,6,5,1,4
S01007247,641,77,15,62,151,42,100,70,104,89,6,5,1,2
S01007248,763,109,29,80,236,97,92,98,56,63,8,7,1,4
S01007249,377,48,15,33,94,56,56,29,39,43,11,7,4,1
S01007250,822,67,16,51,190,92,94,86,123,133,34,18,16,3
S01007251,523,35,5,30,105,45,64,34,106,125,4,3,1,5
S01007252,798,57,22,35,127,65,123,131,121,144,18,11,7,12
S01007253,798,96,35,61,204,78,96,122,76,107,10,2,8,9
S01007254,793,40,12,28,149,79,48,101,137,191,40,32,8,8
S01007255,792,27,7,20,114,56,44,107,154,224,63,23,40,3
S01007256,799,46,18,28,126,59,51,99,184,197,27,10,17,10
S01007257,606,27,6,21,84,38,60,73,140,123,42,22,20,19
S01007258,870,69,17,52,168,36,106,114,186,142,38,28,10,11
S01007259,840,35,6,29,131,60,60,119,166,227,37,20,17,5
S01007260,884,38,14,24,125,81,50,100,186,208,69,38,31,27
S01007261,782,109,37,72,179,79,97,88,81,135,14,5,9,0
S01007262,712,12,2,10,132,41,30,120,140,202,26,13,13,9
S01007263,777,39,9,30,129,75,52,121,142,177,19,7,12,23
S01007264,744,78,18,60,193,62,56,72,121,148,13,9,4,1
S01007265,1059,54,19,35,193,120,81,137,190,241,29,14,15,14
S01007266,678,49,11,38,158,67,68,88,106,136,6,2,4,0
S01007267,521,78,9,69,105,21,138,54,60,48,8,4,4,9
S01007268,594,90,18,72,130,27,150,60,59,63,9,1,8,6
S01007269,528,80,21,59,152,44,81,60,40,54,6,5,1,11
S01007270,457,48,7,41,113,24,139,29,59,39,6,4,2,0
S01007271,957,95,15,80,222,94,137,137,110,135,18,7,11,9
S01007272,864,22,6,16,130,55,73,124,183,223,37,24,13,17
S01007273,668,65,24,41,161,55,65,80,92,120,17,5,12,13
S01007274,826,83,17,66,190,74,86,92,135,141,17,8,9,8
S01007275,551,76,4,72,157,43,62,48,67,91,6,5,1,1
S01007276,850,101,26,75,185,96,78,89,119,143,26,18,8,13
S01007277,756,126,32,94,228,73,85,68,90,74,7,3,4,5
S01007278,542,88,30,58,191,55,57,52,49,44,3,3,0,3
S01007279,558,117,27,90,115,7,175,36,61,40,7,3,4,0
S01007280,568,72,15,57,116,54,126,60,63,62,8,0,8,7
S01007281,885,109,37,72,181,101,197,115,95,80,5,0,5,2
S01007282,538,53,21,32,83,15,150,97,73,52,12,5,7,3
S01007283,992,184,44,140,245,67,138,123,95,114,19,17,2,7
S01007284,841,44,8,36,181,116,222,84,88,89,14,13,1,3
S01007285,833,58,5,53,185,54,289,72,115,52,8,4,4,0
S01007286,939,64,14,50,228,75,237,117,122,87,9,3,6,0
S01007287,562,42,8,34,102,39,197,59,71,32,18,3,15,2
S01007288,534,44,12,32,121,33,166,54,46,60,10,3,7,0
S01007289,792,89,31,58,238,100,126,89,98,46,1,1,0,5
S01007290,786,47,11,36,163,59,131,78,142,140,24,6,18,2
S01007291,643,40,4,36,125,67,65,84,105,124,20,10,10,13
S01007292,771,49,20,29,221,83,124,91,111,86,6,2,4,0
S01007293,786,28,3,25,129,42,64,108,202,178,33,15,18,2
S01007294,865,44,18,26,165,67,146,131,137,146,13,11,2,16
S01007295,520,18,1,17,82,39,36,70,116,114,38,33,5,7
S01007296,544,44,4,40,114,40,70,81,76,85,22,10,12,12
S01007297,880,117,17,100,246,73,144,96,90,87,17,10,7,10
S01007298,532,32,3,29,127,58,63,71,83,86,3,1,2,9
S01007299,785,52,12,40,158,61,110,143,109,115,16,6,10,21
S01007300,464,15,2,13,62,62,61,72,81,87,23,11,12,1
S01007301,723,130,32,98,194,49,140,58,64,74,9,5,4,5
S01007302,625,37,7,30,115,51,101,111,115,71,12,9,3,12
S01007303,868,108,26,82,230,64,200,101,94,50,12,10,2,9
S01007304,684,76,17,59,160,49,214,58,73,44,8,6,2,2
S01007305,736,130,34,96,163,36,164,90,70,76,7,5,2,0
S01007306,756,106,28,78,188,59,133,78,100,71,13,9,4,8
S01007307,782,126,32,94,189,70,205,79,65,38,10,7,3,0
S01007308,749,69,25,44,180,59,158,76,123,74,10,1,9,0
S01007309,609,92,24,68,166,42,117,43,74,66,5,3,2,4
S01007310,808,112,21,91,149,51,217,90,99,73,12,5,7,5
S01007311,734,46,17,29,131,41,172,93,125,116,10,6,4,0
S01007312,770,87,17,70,222,62,137,104,63,82,11,4,7,2
S01007313,965,135,29,106,302,67,239,62,75,79,6,6,0,0
S01007314,635,60,9,51,175,68,111,58,70,70,13,5,8,10
S01007315,937,134,51,83,277,120,87,96,89,116,18,8,10,0
S01007316,861,74,23,51,234,91,102,83,117,123,31,9,22,6
S01007317,639,62,17,45,213,67,59,60,68,89,19,3,16,2
S01007318,607,33,8,25,122,67,116,61,103,81,20,3,17,4
S01007319,725,75,14,61,189,82,123,74,57,96,20,9,11,9
S01007320,743,122,45,77,235,59,151,60,71,35,5,5,0,5
S01007321,586,91,38,53,141,24,154,40,77,53,6,2,4,0
S01007322,730,35,3,32,144,65,172,63,77,146,19,12,7,9
S01007323,448,20,6,14,89,48,104,55,41,89,0,0,0,2
S01007324,323,59,36,23,74,15,56,28,51,32,8,2,6,0
S01007325,828,54,13,41,179,66,246,81,116,72,11,9,2,3
S01007326,762,51,20,31,158,24,185,112,144,77,11,7,4,0
S01007327,763,46,5,41,123,56,124,102,139,146,18,9,9,9
S01007328,846,45,15,30,125,58,188,53,238,105,34,13,21,0
S01007329,702,38,19,19,157,43,219,67,84,71,19,11,8,4
S01007330,766,42,14,28,181,49,258,56,111,50,19,14,5,0
S01007331,986,38,2,36,185,98,274,97,137,132,23,16,7,2
S01007332,505,45,6,39,110,24,206,29,39,33,18,13,5,1
S01007333,781,80,19,61,197,83,151,56,107,82,18,10,8,7
S01007334,750,27,7,20,84,70,72,77,179,176,55,29,26,10
S01007335,810,6,0,6,128,81,69,138,141,203,40,29,11,4
S01007336,500,23,12,11,89,61,87,49,90,70,28,15,13,3
S01007337,654,27,15,12,103,82,101,82,122,113,19,11,8,5
S01007338,752,30,10,20,119,100,75,139,103,181,5,1,4,0
S01007339,610,44,4,40,170,75,109,77,65,66,4,3,1,0
S01007340,470,39,8,31,103,48,69,68,58,71,14,9,5,0
S01007341,730,54,20,34,153,80,155,67,96,97,27,19,8,1
S01007342,797,138,33,105,254,74,166,58,70,28,8,4,4,1
S01007343,649,60,12,48,109,45,229,77,75,48,2,2,0,4
S01007344,438,26,4,22,99,49,80,47,65,62,7,5,2,3
S01007345,595,11,5,6,86,82,70,73,112,109,46,23,23,6
S01007346,533,16,5,11,89,60,55,63,108,100,36,15,21,6
S01007347,601,26,15,11,94,56,71,53,127,134,28,13,15,12
S01007348,600,13,1,12,81,91,77,92,109,110,21,13,8,6
S01007349,457,14,7,7,83,74,49,54,90,62,23,15,8,8
S01007350,553,27,5,22,99,61,89,57,101,92,26,13,13,1
S01007351,650,55,13,42,143,41,189,67,83,57,11,8,3,4
S01007352,488,50,15,35,108,37,164,34,51,30,11,5,6,3
S01007353,642,79,25,54,158,74,134,64,63,62,8,4,4,0
S01007354,786,78,24,54,215,115,138,55,88,78,17,6,11,2
S01007355,916,98,19,79,246,54,228,80,116,69,22,13,9,3
S01007356,714,104,32,72,187,44,115,58,107,81,14,6,8,4
S01007357,793,95,25,70,192,64,163,70,110,89,10,2,8,0
S01007358,843,80,26,54,206,110,125,106,121,75,18,6,12,2
S01007359,823,50,19,31,194,95,87,68,169,123,37,12,25,0
S01007360,494,50,15,35,179,52,61,39,49,53,8,1,7,3
S01007361,983,97,25,72,263,122,171,83,126,88,23,12,11,10
S01007362,729,59,8,51,197,87,98,59,108,88,15,5,10,18
S01007363,679,44,14,30,168,99,89,84,68,109,15,5,10,3
S01007364,897,17,0,17,136,124,64,67,232,186,52,21,31,19
S01007365,467,27,2,25,87,46,60,43,98,92,11,8,3,3
S01007366,465,18,2,16,69,34,34,60,81,134,29,24,5,6
S01007367,556,54,16,38,87,51,85,55,97,96,29,14,15,2
S01007368,541,14,7,7,90,78,44,67,86,118,29,2,27,15
S01007369,786,32,14,18,181,79,97,64,181,112,33,12,21,7
S01007370,738,60,6,54,161,73,93,113,107,106,22,13,9,3
S01007371,716,44,11,33,191,80,111,67,110,85,23,9,14,5
S01007372,814,101,16,85,232,84,116,85,107,72,15,6,9,2
S01007373,605,94,27,67,171,66,123,73,43,29,5,3,2,1
S01007374,531,73,20,53,150,55,80,59,46,61,6,3,3,1
S01007375,464,104,46,58,125,44,71,29,42,43,5,1,4,1
S01007376,844,35,6,29,184,102,60,109,154,139,59,22,37,2
S01007377,664,96,28,68,266,81,69,52,46,39,4,2,2,11
S01007378,548,113,31,82,169,68,88,28,36,36,8,6,2,2
S01007379,484,15,2,13,86,70,19,82,91,97,22,5,17,2
S01007380,581,68,28,40,127,72,31,71,95,99,18,5,13,0
S01007381,470,196,98,98,132,36,50,11,13,24,3,3,0,5
S01007382,650,136,41,95,221,75,79,40,39,42,12,1,11,6
S01007383,749,162,37,125,242,80,90,59,65,39,12,11,1,0
S01007384,793,186,113,73,238,115,43,41,85,62,22,6,16,1
S01007385,826,107,24,83,257,116,84,62,103,72,14,5,9,11
S01007386,806,265,52,213,267,68,101,40,48,10,5,4,1,2
S01007387,778,254,60,194,272,48,83,50,32,32,4,4,0,3
S01007388,680,163,61,102,242,104,53,30,45,35,4,0,4,4
S01007389,585,21,2,19,250,89,22,47,109,29,16,2,14,2
S01007390,571,27,6,21,215,128,17,58,50,52,17,14,3,7
S01007391,572,112,31,81,214,75,59,44,39,23,3,1,2,3
S01007392,450,112,32,80,133,63,48,29,33,26,5,5,0,1
S01007393,653,197,44,153,181,72,81,33,51,29,7,6,1,2
S01007394,640,150,46,104,232,81,63,38,47,17,12,7,5,0
S01007395,785,46,9,37,192,113,91,83,128,85,31,16,15,16
S01007396,783,67,18,49,190,91,70,78,129,103,39,25,14,16
S01007397,937,199,48,151,290,108,95,73,80,55,21,13,8,16
S01007398,703,10,6,4,72,55,61,85,144,244,30,18,12,2
S01007399,642,35,6,29,123,43,44,57,116,133,84,38,46,7
S01007400,699,96,25,71,193,111,73,49,85,81,10,5,5,1
S01007401,676,77,14,63,236,102,66,57,68,48,19,14,5,3
S01007402,610,84,22,62,179,87,57,66,75,47,9,9,0,6
S01007403,825,70,30,40,463,115,41,33,45,46,10,8,2,2
S01007404,426,64,12,52,94,35,110,58,33,28,2,0,2,2
S01007405,665,156,28,128,222,75,126,22,26,29,9,6,3,0
S01007406,603,147,36,111,229,81,70,23,22,24,5,1,4,2
S01007407,722,144,40,104,231,73,82,64,62,51,13,12,1,2
S01007408,596,43,9,34,145,66,76,109,74,61,22,8,14,0
S01007409,669,62,9,53,129,80,61,112,102,106,13,8,5,4
S01007410,703,8,5,3,53,48,50,128,161,193,58,32,26,4
S01007411,895,34,13,21,107,93,69,94,157,247,77,48,29,17
S01007412,478,23,0,23,53,48,35,71,78,159,11,3,8,0
S01007413,910,83,22,61,232,119,80,161,113,97,17,10,7,8
S01007414,694,164,55,109,208,71,51,97,35,42,7,0,7,19
S01007415,853,29,5,24,90,65,51,122,169,281,35,12,23,11
S01007416,595,18,5,13,49,45,38,63,143,160,68,38,30,11
S01007417,992,151,27,124,327,139,84,119,71,72,19,2,17,10
S01007418,654,15,0,15,88,66,34,74,153,177,34,18,16,13
S01007419,865,17,3,14,82,115,57,79,191,234,66,29,37,24
S01007420,794,123,22,101,204,109,81,81,72,97,19,8,11,8
S01007421,663,111,12,99,163,53,57,64,94,97,19,14,5,5
S01007422,550,60,19,41,135,77,58,86,62,60,7,3,4,5
S01007423,764,110,33,77,231,74,47,91,101,82,19,14,5,9
S01007424,787,124,20,104,276,98,43,82,76,80,5,5,0,3
S01007425,872,112,24,88,248,68,60,120,109,121,22,8,14,12
S01007426,658,59,4,55,100,51,62,76,138,102,24,8,16,46
S01007427,642,34,13,21,107,60,43,96,112,140,38,3,35,12
S01007428,887,38,17,21,224,99,73,105,124,173,36,13,23,15
S01007429,715,67,7,60,191,65,61,81,106,114,26,8,18,4
S01007430,442,51,13,38,90,54,54,68,64,49,7,2,5,5
S01007431,554,72,22,50,175,64,51,65,78,43,6,1,5,0
S01007432,782,50,12,38,182,94,64,101,143,138,8,1,7,2
S01007433,798,116,36,80,183,58,101,73,120,128,16,3,13,3
S01007434,496,17,4,13,84,38,52,67,94,120,17,6,11,7
S01007435,668,62,19,43,140,88,55,78,72,138,24,11,13,11
S01007436,674,44,13,31,101,64,27,64,132,160,56,37,19,26
S01007437,440,35,4,31,92,58,35,38,83,62,31,17,14,6
S01007438,671,43,8,35,124,65,41,109,109,138,36,16,20,6
S01007439,686,69,22,47,149,75,63,99,97,115,13,1,12,6
S01007440,645,38,10,28,125,57,55,98,127,125,12,7,5,8
S01007441,551,78,25,53,157,68,40,85,71,48,0,0,0,4
S01007442,478,126,31,95,143,49,52,54,37,16,1,1,0,0
S01007443,856,234,50,184,247,61,84,76,66,66,10,5,5,12
S01007444,936,272,74,198,286,55,107,62,70,56,15,12,3,13
S01007445,625,205,53,152,243,49,55,22,33,14,3,1,2,1
S01007446,541,198,43,155,182,38,58,22,23,12,5,1,4,3
S01007447,485,140,34,106,150,14,88,44,17,23,6,5,1,3
S01007448,867,125,28,97,202,81,140,101,88,118,12,4,8,0
S01007449,980,67,19,48,154,89,66,115,203,190,79,32,47,17
S01007450,774,43,14,29,108,64,49,105,136,172,84,44,40,13
S01007451,623,54,18,36,116,69,48,69,136,120,6,3,3,5
S01007452,523,51,9,42,80,43,74,47,87,106,32,12,20,3
S01007453,635,104,30,74,246,59,62,83,49,25,7,4,3,0
S01007454,512,23,12,11,83,45,44,59,95,140,23,14,9,0
S01007455,846,21,7,14,134,86,22,99,201,194,82,48,34,7
S01007456,853,9,0,9,108,64,52,77,227,241,58,33,25,17
S01007457,1033,69,20,49,180,85,92,164,154,194,72,27,45,23
S01007458,523,54,22,32,124,69,34,103,56,65,9,6,3,9
S01007459,643,43,12,31,144,88,48,121,73,108,14,8,6,4
S01007460,717,31,9,22,108,53,67,124,134,152,39,24,15,9
S01007461,680,18,9,9,62,57,51,87,151,160,87,54,33,7
S01007462,774,49,6,43,144,72,86,92,143,151,37,16,21,0
S01007463,988,25,9,16,64,70,80,76,271,252,137,71,66,13
S01007464,686,17,7,10,70,50,27,71,181,212,51,34,17,7
S01007465,785,16,5,11,45,56,31,68,166,248,145,88,57,10
S01007466,984,47,8,39,125,73,60,103,215,225,97,64,33,39
S01007467,974,59,15,44,189,116,54,140,173,182,40,21,19,21
S01007468,714,84,40,44,143,86,64,126,100,100,8,7,1,3
S01007469,611,29,19,10,69,59,27,106,139,129,45,23,22,8
S01007470,699,48,11,37,121,85,41,81,131,117,68,42,26,7
S01007471,479,33,10,23,86,46,18,67,82,104,39,10,29,4
S01007472,554,14,0,14,67,48,35,56,128,173,29,10,19,4
S01007473,438,20,10,10,76,54,20,62,82,102,17,11,6,5
S01007474,535,70,21,49,118,71,63,83,80,49,1,1,0,0
S01007475,594,98,23,75,163,71,41,86,64,55,13,3,10,3
S01007476,651,91,21,70,147,73,56,99,96,76,7,5,2,6
S01007477,540,98,7,91,135,68,56,75,45,52,8,2,6,3
S01007478,901,140,23,117,249,83,97,89,119,97,17,7,10,10
S01007479,579,42,2,40,134,102,25,84,86,92,10,8,2,4
S01007480,776,60,15,45,185,85,64,123,126,118,12,5,7,3
S01007481,830,103,32,71,231,100,145,92,83,67,6,6,0,3
S01007482,478,21,9,12,88,39,54,60,107,81,26,21,5,2
S01007483,783,20,3,17,104,59,128,114,111,211,29,14,15,7
S01007484,548,13,4,9,87,28,77,74,114,107,37,15,22,11
S01007485,481,3,0,3,32,16,29,62,133,142,54,24,30,10
S01007486,540,3,3,0,46,39,31,54,129,156,78,40,38,4
S01007487,893,23,1,22,117,71,92,124,186,193,73,50,23,14
S01007488,1032,45,8,37,206,115,150,106,163,191,43,20,23,13
S01007489,856,52,15,37,137,106,140,80,122,175,31,19,12,13
S01007490,883,28,7,21,109,73,93,153,159,230,36,24,12,2
S01007491,1127,27,6,21,170,122,97,134,266,231,73,32,41,7
S01007492,679,32,15,17,119,75,68,93,129,130,31,16,15,2
S01007493,824,25,8,17,128,90,68,132,142,191,40,21,19,8
S01007494,533,39,6,33,92,32,161,38,111,42,15,11,4,3
S01007495,844,53,10,43,166,61,273,75,110,87,11,9,2,8
S01007496,1011,67,27,40,243,63,311,88,133,89,12,7,5,5
S01007497,596,21,4,17,73,30,148,69,111,107,34,30,4,3
S01007498,836,40,6,34,121,74,158,113,147,157,22,20,2,4
S01007499,842,35,12,23,134,59,203,78,127,159,33,18,15,14
S01007500,603,30,5,25,59,37,146,81,132,90,28,10,18,0
S01007501,678,36,7,29,125,52,251,36,100,54,24,4,20,0
S01007502,521,22,7,15,105,14,159,79,64,68,8,6,2,2
S01007503,1044,46,11,35,178,52,319,80,160,158,45,20,25,6
S01007504,677,47,6,41,123,41,211,59,87,85,20,11,9,4
S01007505,429,37,10,27,60,32,149,30,60,46,11,7,4,4
S01007506,514,41,10,31,110,33,201,43,48,34,4,4,0,0
S01007507,921,58,6,52,121,57,268,69,137,184,24,17,7,3
S01007508,696,39,3,36,126,38,190,75,106,104,18,10,8,0
S01007509,626,48,5,43,105,52,215,33,97,46,26,14,12,4
S01007510,997,64,3,61,186,58,286,109,170,86,35,20,15,3
S01007511,829,19,4,15,88,52,180,53,205,175,37,28,9,20
S01007512,526,33,10,23,121,21,195,33,71,35,12,5,7,5
S01007513,1045,65,28,37,147,83,154,127,213,184,72,42,30,0
S01007514,518,28,8,20,74,55,90,76,87,82,19,9,10,7
S01007515,563,56,11,45,190,61,88,52,56,51,5,3,2,4
S01007516,620,31,3,28,71,27,96,74,165,129,25,11,14,2
S01007517,423,44,9,35,80,39,86,46,81,37,10,9,1,0
S01007518,832,22,4,18,108,48,139,115,136,209,48,24,24,7
S01007519,433,55,18,37,101,21,119,30,57,37,13,8,5,0
S01007520,978,78,20,58,154,70,218,76,202,135,35,18,17,10
S01007521,443,55,19,36,85,19,105,61,94,19,5,2,3,0
S01007522,940,101,24,77,183,68,178,107,156,110,33,18,15,4
S01007523,540,69,17,52,104,50,139,34,67,57,17,7,10,3
S01007524,897,91,11,80,144,59,260,91,115,113,24,13,11,0
S01007525,504,38,14,24,90,43,92,60,104,69,8,5,3,0
S01007526,734,51,24,27,160,74,126,67,137,101,18,10,8,0
S01007527,787,68,17,51,178,67,128,91,115,129,11,6,5,0
S01007528,735,42,4,38,122,54,119,88,149,118,30,22,8,13
S01007529,663,93,20,73,173,44,125,53,86,69,16,7,9,4
S01007530,524,73,20,53,110,27,182,46,54,18,7,7,0,7
S01007531,690,44,7,37,149,66,178,56,112,63,9,7,2,13
S01007532,597,50,13,37,122,39,171,79,61,60,10,7,3,5
S01007533,533,35,9,26,106,44,196,38,70,34,9,3,6,1
S01007534,939,71,28,43,122,56,174,99,196,185,35,25,10,1
S01007535,1058,63,24,39,199,85,158,124,213,133,75,31,44,8
S01007536,934,51,9,42,134,86,146,125,195,174,23,17,6,0
S01007537,1010,112,14,98,174,81,141,101,171,196,28,18,10,6
S01007538,892,76,11,65,182,60,258,86,106,109,11,7,4,4
S01007539,667,98,23,75,172,83,99,62,79,65,9,8,1,0
S01007540,837,47,16,31,153,86,115,86,135,182,27,13,14,6
S01007541,724,50,9,41,167,78,123,86,85,128,7,4,3,0
S01007542,866,40,11,29,151,56,119,97,166,197,38,6,32,2
S01007543,1078,39,9,30,148,92,134,116,270,230,39,14,25,10
S01007544,1047,193,48,145,254,83,318,61,75,49,8,8,0,6
S01007545,808,87,20,67,143,58,236,75,119,78,11,7,4,1
S01007546,565,71,11,60,114,55,141,68,58,55,3,2,1,0
S01007547,549,64,16,48,113,32,162,38,75,57,6,3,3,2
S01007548,703,41,5,36,170,54,130,81,108,88,26,7,19,5
S01007549,620,78,28,50,109,50,143,63,94,51,23,13,10,9
S01007550,915,140,24,116,187,82,169,90,119,117,10,7,3,1
S01007551,856,110,18,92,172,52,321,59,70,50,20,17,3,2
S01007552,913,28,14,14,89,58,114,171,169,211,57,25,32,16
S01007553,885,28,7,21,69,55,54,158,199,237,75,33,42,10
S01007554,435,7,3,4,22,18,26,48,110,154,40,34,6,10
S01007555,509,53,4,49,90,33,91,65,67,93,17,5,12,0
S01007556,456,24,5,19,51,30,65,63,91,104,28,14,14,0
S01007557,1131,26,13,13,107,92,98,172,243,324,51,25,26,18
S01007558,427,27,5,22,81,26,127,47,46,63,10,7,3,0
S01007559,734,79,15,64,144,74,189,97,84,56,6,4,2,5
S01007560,940,96,25,71,164,80,152,121,150,155,20,11,9,2
S01007561,687,39,11,28,123,70,104,61,159,112,15,13,2,4
S01007562,851,88,23,65,185,70,171,70,163,90,8,4,4,6
S01007563,889,86,19,67,207,89,262,51,129,59,1,1,0,5
S01007564,772,98,11,87,170,52,215,38,104,74,20,11,9,1
S01007565,943,81,17,64,219,84,152,84,165,121,29,25,4,8
S01007566,719,74,12,62,134,48,206,39,129,78,6,5,1,5
S01007567,588,48,19,29,150,35,196,53,55,44,6,3,3,1
S01007568,657,79,41,38,160,60,128,77,71,70,6,3,3,6
S01007569,781,60,13,47,137,50,160,68,160,126,13,10,3,7
S01007570,680,102,29,73,178,56,97,59,83,73,29,11,18,3
S01007571,539,76,20,56,143,47,126,46,56,37,5,3,2,3
S01007572,882,71,17,54,170,109,136,91,93,151,51,21,30,10
S01007573,895,117,36,81,266,143,79,93,115,79,3,3,0,0
S01007574,1023,26,9,17,168,85,65,125,258,243,40,16,24,13
S01007575,854,23,9,14,88,89,70,116,185,205,63,30,33,15
S01007576,718,21,1,20,56,38,42,68,177,179,135,57,78,2
S01007577,688,7,0,7,52,57,38,71,203,195,52,20,32,13
S01007578,692,11,7,4,44,58,49,98,185,195,42,28,14,10
S01007579,663,8,5,3,88,72,30,69,167,170,49,16,33,10
S01007580,809,19,14,5,91,34,34,120,190,230,64,29,35,27
S01007581,509,5,3,2,54,41,49,92,101,125,40,26,14,2
S01007582,660,14,0,14,82,60,67,96,146,152,37,20,17,6
S01007583,1048,27,5,22,93,84,72,112,306,278,64,36,28,12
S01007584,624,36,5,31,81,56,53,61,138,145,45,30,15,9
S01007585,906,92,21,71,205,118,84,110,116,154,15,8,7,12
S01007586,858,28,12,16,134,71,57,69,230,211,51,16,35,7
S01007587,623,85,17,68,191,87,67,54,56,73,8,5,3,2
S01007588,844,150,24,126,283,78,98,67,88,70,7,7,0,3
S01007589,751,85,24,61,214,80,80,50,112,80,39,19,20,11
S01007590,661,142,36,106,212,88,76,52,49,35,4,4,0,3
S01007591,574,72,7,65,117,64,58,85,81,89,8,4,4,0
S01007592,694,40,9,31,91,85,30,72,188,146,27,6,21,15
S01007593,1047,99,28,71,235,118,146,172,131,129,13,6,7,4
S01007594,799,62,14,48,186,85,147,90,107,106,12,9,3,4
S01007595,977,117,22,95,189,72,255,80,140,118,5,0,5,1
S01007596,550,45,17,28,132,49,129,57,68,61,8,7,1,1
S01007597,646,90,23,67,178,57,139,44,67,59,7,1,6,5
S01007598,627,70,24,46,139,60,117,67,63,83,15,8,7,13
S01007599,808,103,21,82,210,71,86,56,135,120,13,10,3,14
S01007600,1037,179,39,140,293,85,132,104,104,115,15,8,7,10
S01007601,631,44,19,25,180,75,54,81,95,86,9,1,8,7
S01007602,650,56,13,43,169,98,63,81,82,89,4,2,2,8
S01007603,778,107,26,81,269,93,48,89,80,72,13,7,6,7
S01007604,891,113,43,70,274,121,85,123,87,82,3,2,1,3
S01007605,828,96,20,76,224,101,67,99,119,122,0,0,0,0
S01007606,614,53,23,30,173,79,58,74,107,49,6,4,2,15
S01007607,702,92,21,71,190,95,47,89,102,82,3,3,0,2
S01007608,731,53,9,44,260,104,63,80,93,77,1,1,0,0
S01007609,917,42,6,36,151,103,54,91,203,210,48,26,22,15
S01007610,456,34,12,22,94,58,34,50,98,70,14,10,4,4
S01007611,917,69,9,60,125,109,55,101,212,173,54,40,14,19
S01007612,1037,38,3,35,192,100,111,107,195,174,85,37,48,35
S01007613,736,122,22,100,198,86,116,54,92,50,11,5,6,7
S01007614,843,192,56,136,321,93,75,37,78,45,0,0,0,2
S01007615,1074,126,43,83,294,135,94,94,172,132,23,12,11,4
S01007616,736,34,4,30,162,96,68,84,124,120,29,22,7,19
S01007617,519,17,4,13,90,54,58,55,99,121,20,10,10,5
S01007618,638,4,3,1,99,46,48,67,154,193,20,10,10,7
S01007619,629,15,2,13,90,44,55,69,160,171,21,12,9,4
S01007620,579,37,6,31,131,87,80,74,105,65,0,0,0,0
S01007621,656,27,20,7,155,85,92,118,105,66,5,1,4,3
S01007622,582,35,10,25,123,57,62,79,114,100,12,9,3,0
S01007623,608,76,13,63,184,70,72,66,77,56,7,5,2,0
S01007624,664,59,15,44,110,82,51,109,127,124,2,2,0,0
S01007625,505,36,5,31,110,61,55,73,71,84,11,8,3,4
S01007626,650,50,9,41,151,63,64,120,117,74,3,0,3,8
S01007627,547,63,10,53,150,54,80,70,76,43,11,11,0,0
S01007628,713,67,18,49,215,91,98,96,66,76,4,4,0,0
S01007629,696,67,16,51,168,57,122,68,78,129,7,2,5,0
S01007630,809,57,11,46,217,82,215,58,120,51,3,1,2,6
S01007631,625,90,12,78,104,51,201,68,67,26,15,9,6,3
S01007632,960,83,26,57,177,64,129,123,159,201,21,15,6,3
S01007633,977,84,18,66,157,96,132,132,178,157,31,12,19,10
S01007634,570,69,18,51,122,44,117,43,99,62,14,2,12,0
S01007635,671,79,20,59,184,58,124,78,92,50,5,5,0,1
S01007636,819,67,25,42,139,90,108,71,173,144,23,17,6,4
S01007637,857,42,8,34,102,68,130,93,201,192,29,12,17,0
S01007638,768,51,11,40,149,61,86,112,153,139,15,9,6,2
S01007639,1087,62,24,38,181,80,93,108,259,253,44,20,24,7
S01007640,722,52,6,46,94,51,213,106,112,80,13,8,5,1
S01007641,854,100,46,54,172,72,179,77,113,120,16,7,9,5
S01007642,794,105,23,82,206,85,142,90,80,70,11,7,4,5
S01007643,897,87,20,67,227,65,154,121,117,100,18,5,13,8
S01007644,844,107,32,75,196,45,112,109,147,100,22,11,11,6
S01007645,524,57,12,45,90,34,168,48,62,57,6,2,4,2
S01007646,576,52,17,35,132,45,154,57,73,55,7,6,1,1
S01007647,717,47,14,33,187,66,122,62,98,108,26,11,15,1
S01007648,873,45,13,32,165,126,103,107,120,186,13,6,7,8
S01007649,729,30,14,16,104,75,126,83,110,177,22,10,12,2
S01007650,949,74,13,61,186,92,236,89,101,144,22,10,12,5
S01007651,585,66,28,38,73,32,239,40,61,68,6,4,2,0
S01007652,588,27,6,21,120,50,118,75,79,100,17,11,6,2
S01007653,886,58,15,43,153,53,227,127,126,128,9,4,5,5
S01007654,1050,46,11,35,143,55,221,99,226,226,28,15,13,6
S01007655,780,79,18,61,144,51,285,58,86,69,8,7,1,0
S01007656,848,57,14,43,132,57,268,81,144,96,13,5,8,0
S01007657,428,26,12,14,67,34,110,57,81,46,7,2,5,0
S01007658,505,37,5,32,116,28,145,55,71,42,8,1,7,3
S01007659,820,76,10,66,169,36,159,102,126,132,17,9,8,3
S01007660,851,22,9,13,95,63,75,132,240,180,41,23,18,3
S01007661,652,28,9,19,136,62,93,72,111,133,15,8,7,2
S01007662,908,46,15,31,166,77,98,128,187,171,23,19,4,12
S01007663,841,60,5,55,179,79,103,114,137,158,5,3,2,6
S01007664,578,28,9,19,84,27,48,95,154,132,8,7,1,2
S01007665,660,28,11,17,105,52,46,126,145,140,16,10,6,2
S01007666,502,44,3,41,134,75,41,64,46,92,3,3,0,3
S01007667,717,81,14,67,189,81,102,103,72,83,0,0,0,6
S01007668,1041,39,11,28,113,94,81,123,254,300,34,14,20,3
S01007669,642,12,3,9,48,27,47,62,193,209,44,16,28,0
S01007670,729,32,4,28,73,69,52,112,171,129,77,34,43,14
S01007671,711,102,26,76,159,52,170,82,81,59,6,6,0,0
S01007672,874,131,34,97,260,76,110,102,111,81,3,3,0,0
S01007673,697,34,10,24,141,61,91,133,87,134,12,6,6,4
S01007674,797,22,4,18,93,63,67,139,202,172,39,19,20,0
S01007675,627,72,19,53,111,53,124,93,82,89,3,2,1,0
S01007676,681,72,24,48,117,33,217,66,82,80,10,8,2,4
S01007677,511,38,15,23,95,37,64,80,82,101,8,2,6,6
S01007678,788,26,13,13,107,72,70,110,169,208,21,15,6,5
S01007679,843,46,26,20,86,61,83,132,195,199,36,20,16,5
S01007680,916,42,15,27,181,91,129,155,140,175,2,1,1,1
S01007681,389,17,6,11,36,30,66,70,85,80,2,2,0,3
S01007682,882,231,39,192,257,90,116,57,62,21,7,2,5,41
S01007683,701,280,16,264,159,61,56,37,21,18,3,1,2,66
S01007684,781,220,27,193,285,71,53,53,35,36,7,3,4,21
S01007685,638,289,28,261,185,44,52,10,16,25,3,3,0,14
S01007686,665,159,11,148,190,87,52,49,33,20,15,14,1,60
S01007687,869,188,13,175,216,84,70,24,54,38,17,13,4,178
S01007688,1015,164,8,156,184,91,46,39,89,60,20,15,5,322
S01007689,579,114,0,114,109,28,37,24,38,31,14,12,2,184
S01007690,835,95,15,80,153,34,21,35,65,35,19,12,7,378
S01007691,1013,82,3,79,125,78,37,27,98,72,61,31,30,433
S01007692,939,94,6,88,127,41,35,56,70,45,19,15,4,452
S01007693,563,40,1,39,51,28,8,37,61,44,40,22,18,254
S01007694,1015,57,5,52,89,101,42,60,143,82,54,34,20,387
S01007695,963,138,6,132,161,101,49,65,141,115,29,13,16,164
S01007696,800,37,3,34,67,41,30,40,87,74,76,51,25,348
S01007697,948,126,20,106,207,95,52,72,112,115,20,12,8,149
S01007698,1056,89,6,83,177,127,65,65,132,97,34,15,19,270
S01007699,808,68,5,63,110,61,38,58,132,83,38,20,18,220
S01007700,971,260,42,218,278,102,75,46,51,91,22,17,5,46
S01007701,535,31,6,25,75,36,10,27,58,100,62,30,32,136
S01007702,560,100,3,97,111,32,19,17,42,29,7,0,7,203
S01007703,762,102,13,89,175,87,46,60,119,71,22,8,14,80
S01007704,907,26,5,21,101,51,49,67,161,160,138,69,69,154
S01007705,541,21,4,17,47,28,11,32,54,28,9,5,4,311
S01007706,775,26,1,25,67,43,6,37,42,22,18,12,6,514
S01007707,862,157,9,148,182,61,53,62,41,35,14,11,3,257
S01007708,644,33,2,31,109,100,43,61,111,80,53,36,17,54
S01007709,539,52,3,49,80,49,20,61,88,80,46,22,24,63
S01007710,803,53,5,48,131,71,38,57,97,78,33,21,12,245
S01007711,961,42,6,36,99,76,39,82,165,165,19,10,9,274
S01007712,644,66,0,66,140,68,26,52,69,47,11,8,3,165
S01007713,472,39,8,31,56,45,58,39,72,85,34,16,18,44
S01007714,637,30,4,26,134,85,34,76,104,136,17,12,5,21
S01007715,516,33,2,31,76,53,16,34,114,98,44,22,22,48
S01007716,967,57,11,46,122,93,66,79,158,194,68,38,30,130
S01007717,997,16,4,12,119,97,89,66,218,190,91,39,52,111
S01007718,689,21,2,19,89,59,57,66,138,140,50,32,18,69
S01007719,960,34,4,30,130,117,53,118,185,214,58,27,31,51
S01007720,705,32,8,24,89,90,51,87,145,173,28,11,17,10
S01007721,730,19,3,16,129,75,60,120,114,149,33,5,28,31
S01007722,840,26,3,23,115,111,50,89,159,185,70,52,18,35
S01007723,952,29,4,25,111,75,46,122,177,270,90,72,18,32
S01007724,643,21,0,21,60,74,16,74,146,122,59,29,30,71
S01007725,773,31,0,31,85,95,22,71,136,200,84,46,38,49
S01007726,786,37,4,33,129,80,37,104,145,124,67,53,14,63
S01007727,1007,22,4,18,150,110,70,78,184,180,89,60,29,124
S01007728,694,24,2,22,104,74,39,71,132,113,58,26,32,79
S01007729,772,28,3,25,126,74,37,73,134,128,62,23,39,110
S01007730,764,47,1,46,167,89,40,64,135,88,51,20,31,83
S01007731,729,42,6,36,181,74,37,88,117,100,36,17,19,54
S01007732,677,48,1,47,129,74,37,77,105,87,35,9,26,85
S01007733,853,146,32,114,207,116,136,68,100,49,22,18,4,9
S01007734,821,137,25,112,214,137,96,70,78,78,9,4,5,2
S01007735,827,113,21,92,199,108,123,93,84,86,18,12,6,3
S01007736,723,83,17,66,169,80,122,92,99,65,5,5,0,8
S01007737,1062,101,12,89,237,152,84,108,188,123,35,21,14,34
S01007738,730,69,23,46,172,90,61,82,122,111,15,4,11,8
S01007739,591,35,13,22,86,74,52,88,111,132,12,4,8,1
S01007740,541,60,7,53,132,106,53,43,74,46,11,7,4,16
S01007741,753,66,24,42,117,115,46,51,135,172,32,18,14,19
S01007742,624,63,24,39,140,98,54,66,80,106,14,5,9,3
S01007743,895,58,14,44,147,99,54,104,178,176,59,32,27,20
S01007744,766,24,3,21,81,85,35,72,162,199,85,55,30,23
S01007745,667,13,3,10,75,77,55,110,145,147,34,12,22,11
S01007746,889,13,2,11,117,72,61,108,175,254,77,42,35,12
S01007747,505,10,1,9,58,36,47,73,130,102,49,24,25,0
S01007748,704,5,0,5,101,60,36,69,146,177,90,50,40,20
S01007749,709,98,24,74,195,118,74,100,52,42,27,15,12,3
S01007750,794,168,22,146,208,139,95,79,60,38,2,2,0,5
S01007751,737,202,26,176,209,94,99,26,46,42,16,8,8,3
S01007752,689,164,26,138,194,98,56,52,66,49,8,8,0,2
S01007753,535,6,3,3,73,44,40,69,117,150,30,16,14,6
S01007754,884,9,0,9,107,82,56,79,194,242,107,48,59,8
S01007755,877,6,0,6,95,82,41,78,216,246,104,50,54,9
S01007756,629,15,2,13,71,66,33,69,190,134,42,24,18,9
S01007757,840,109,20,89,327,131,77,65,84,44,0,0,0,3
S01007758,899,233,58,175,307,72,106,54,60,54,9,7,2,4
S01007759,951,92,20,72,237,127,81,98,151,107,40,21,19,18
S01007760,588,172,45,127,216,52,71,15,38,19,4,3,1,1
S01007761,849,201,27,174,319,80,74,66,48,39,15,5,10,7
S01007762,761,105,19,86,245,107,59,72,79,70,11,6,5,13
S01007763,545,26,7,19,118,75,46,66,81,111,16,6,10,6
S01007764,756,123,32,91,236,120,96,73,47,52,6,6,0,3
S01007765,683,109,16,93,232,122,47,80,51,30,9,3,6,3
S01007766,914,163,33,130,353,139,52,73,76,46,1,1,0,11
S01007767,884,170,48,122,283,120,94,84,64,44,19,14,5,6
S01007768,649,127,19,108,227,78,50,37,56,43,21,9,12,10
S01007769,708,162,36,126,245,72,90,31,63,36,8,6,2,1
S01007770,738,256,65,191,220,74,74,42,36,16,6,6,0,14
S01007771,532,153,28,125,167,60,43,53,22,21,11,5,6,2
S01007772,964,67,10,57,165,183,55,129,171,147,35,20,15,12
S01007773,734,93,21,72,229,134,80,67,75,46,10,5,5,0
S01007774,954,174,37,137,364,128,86,92,53,48,4,0,4,5
S01007775,825,184,39,145,250,103,57,79,90,54,3,2,1,5
S01007776,727,144,44,100,273,78,79,63,37,42,7,4,3,4
S01007777,962,228,48,180,360,100,94,69,57,45,6,2,4,3
S01007778,446,120,24,96,178,19,61,34,29,4,1,1,0,0
S01007779,701,40,22,18,163,105,73,100,99,110,8,4,4,3
S01007780,795,45,13,32,203,126,79,110,115,98,10,1,9,9
S01007781,899,63,23,40,213,118,66,134,130,159,16,4,12,0
S01007782,499,11,3,8,96,40,27,32,90,133,48,26,22,22
S01007783,782,8,0,8,57,73,36,79,154,219,135,74,61,21
S01007784,711,46,22,24,118,122,48,70,153,110,35,10,25,9
S01007785,603,6,0,6,70,60,22,43,162,133,84,44,40,23
S01007786,763,10,2,8,117,85,54,77,170,221,28,14,14,1
S01007787,676,11,4,7,81,59,56,83,161,169,53,27,26,3
S01007788,708,12,1,11,65,54,50,70,193,112,140,71,69,12
S01007789,624,14,0,14,98,60,30,53,136,172,47,29,18,14
S01007790,895,23,15,8,89,75,27,77,254,187,140,63,77,23
S01007791,468,52,18,34,134,38,64,37,76,61,5,0,5,1
S01007792,879,9,4,5,131,72,57,99,159,280,62,42,20,10
S01007793,959,18,2,16,89,86,46,107,232,233,127,57,70,21
S01007794,567,11,4,7,96,65,29,94,115,129,14,3,11,14
S01007795,606,14,4,10,78,69,25,94,131,175,14,9,5,6
S01007796,724,28,10,18,134,82,25,107,135,141,47,21,26,25
S01007797,522,10,3,7,52,44,22,68,100,159,54,28,26,13
S01007798,665,74,12,62,156,102,65,95,78,73,10,7,3,12
S01007799,622,73,5,68,190,66,67,92,47,70,13,11,2,4
S01007800,913,9,2,7,120,80,49,78,224,231,100,47,53,22
S01007801,833,12,5,7,97,62,28,80,211,223,113,68,45,7
S01007802,547,26,0,26,144,88,57,69,69,69,15,2,13,10
S01007803,1087,30,4,26,68,104,39,141,233,305,136,91,45,31
S01007804,627,13,5,8,81,83,47,48,111,155,72,51,21,17
S01007805,520,14,0,14,49,73,19,42,127,113,65,37,28,18
S01007806,634,14,3,11,91,95,42,63,112,191,21,14,7,5
S01007807,707,82,12,70,202,107,77,72,81,72,11,4,7,3
S01007808,848,37,0,37,132,88,56,96,187,185,45,38,7,22
S01007809,919,119,36,83,235,136,93,105,124,92,13,13,0,2
S01007810,883,5,2,3,145,75,38,75,155,297,85,51,34,8
S01007811,871,25,2,23,113,77,39,71,214,239,87,57,30,6
S01007812,850,39,0,39,93,44,57,72,166,242,120,51,69,17
S01007813,799,10,1,9,61,130,33,76,182,205,82,35,47,20
S01007814,565,17,4,13,106,72,61,63,94,126,17,17,0,9
S01007815,856,81,36,45,236,107,74,126,126,94,0,0,0,12
S01007816,669,27,3,24,150,125,64,112,96,95,0,0,0,0
S01007817,449,24,16,8,88,41,39,52,81,119,3,1,2,2
S01007818,753,51,27,24,173,108,81,77,133,106,18,10,8,6
S01007819,803,28,2,26,201,96,80,93,103,165,29,17,12,8
S01007820,954,55,11,44,197,125,78,99,152,199,38,16,22,11
S01007821,552,30,5,25,129,56,61,64,106,93,10,10,0,3
S01007822,734,59,14,45,192,117,61,72,65,153,13,2,11,2
S01007823,696,86,24,62,190,112,59,105,84,49,8,8,0,3
S01007824,727,78,22,56,168,92,88,102,82,97,14,14,0,6
S01007825,1013,105,13,92,276,140,119,99,135,117,11,8,3,11
S01007826,573,16,5,11,92,38,34,62,123,167,28,21,7,13
S01007827,583,51,9,42,164,64,34,80,87,55,34,21,13,14
S01007828,924,53,8,45,162,165,57,110,135,166,49,29,20,27
S01007829,579,33,8,25,106,110,47,54,84,116,14,13,1,15
S01007830,928,36,8,28,122,129,37,113,180,209,45,27,18,57
S01007831,883,40,5,35,154,110,61,87,169,144,75,44,31,43
S01007832,629,18,3,15,126,68,37,67,115,138,40,19,21,20
S01007833,792,31,6,25,141,101,62,91,142,175,26,15,11,23
S01007834,742,64,11,53,96,107,31,76,123,153,52,20,32,40
S01007835,695,87,3,84,191,73,46,67,106,98,16,13,3,11
S01007836,522,63,19,44,159,90,38,40,58,45,23,17,6,6
S01007837,778,93,38,55,247,131,87,83,59,68,2,2,0,8
S01007838,845,98,16,82,224,125,94,91,110,77,11,11,0,15
S01007839,528,29,1,28,92,59,43,64,89,119,13,9,4,20
S01007840,762,40,10,30,123,124,42,89,125,162,34,20,14,23
S01007841,711,22,3,19,111,100,45,43,150,166,43,20,23,31
S01007842,770,33,6,27,75,103,42,61,135,168,114,62,52,39
S01007843,705,39,3,36,113,133,24,77,121,109,45,24,21,44
S01007844,935,52,4,48,135,129,41,117,175,167,69,23,46,50
S01007845,903,24,11,13,122,126,44,79,186,197,119,73,46,6
S01007846,744,14,0,14,112,80,37,94,156,178,60,20,40,13
S01007847,917,32,6,26,145,104,45,108,169,245,63,25,38,6
S01007848,819,20,1,19,151,81,24,84,189,164,75,31,44,31
S01007849,934,19,4,15,93,112,51,116,199,234,86,46,40,24
S01007850,754,17,4,13,85,93,80,78,162,187,45,32,13,7
S01007851,939,41,16,25,161,138,76,110,185,212,8,3,5,8
S01007852,667,21,0,21,87,78,55,57,153,121,85,53,32,10
S01007853,660,7,0,7,80,88,27,58,133,157,85,48,37,25
S01007854,1075,33,1,32,170,110,53,103,224,211,146,78,68,25
S01007855,501,23,5,18,77,54,33,46,100,108,43,13,30,17
S01007856,843,30,5,25,155,108,62,104,159,170,36,19,17,19
S01007857,492,9,2,7,75,59,28,24,110,136,34,22,12,17
S01007858,1019,29,9,20,178,150,72,83,213,205,70,34,36,19
S01007859,528,3,2,1,69,65,46,56,96,151,39,20,19,3
S01007860,637,59,15,44,148,53,65,72,106,89,39,20,19,6
S01007861,674,9,0,9,109,83,37,46,150,200,35,15,20,5
S01007862,701,16,2,14,119,67,45,72,137,194,38,16,22,13
S01007863,895,5,0,5,106,98,45,107,177,215,114,80,34,28
S01007864,938,35,8,27,131,111,46,131,182,203,75,40,35,24
S01007865,693,122,18,104,185,77,60,121,72,38,13,8,5,5
S01007866,586,53,10,43,207,71,84,82,46,39,4,3,1,0
S01007867,456,81,12,69,129,56,64,41,30,43,3,0,3,9
S01007868,861,117,7,110,276,118,74,95,85,80,8,0,8,8
S01007869,906,228,23,205,231,103,75,78,91,66,10,10,0,24
S01007870,505,31,10,21,90,41,98,72,83,81,7,3,4,2
S01007871,669,14,5,9,46,35,66,90,166,169,78,47,31,5
S01007872,705,14,0,14,76,40,50,80,160,191,89,69,20,5
S01007873,639,19,0,19,94,75,71,116,98,131,35,22,13,0
S01007874,723,15,6,9,86,58,63,115,169,187,30,18,12,0
S01007875,526,30,1,29,101,47,45,77,101,113,10,8,2,2
S01007876,1009,43,7,36,231,124,106,120,158,176,39,26,13,12
S01007877,773,22,7,15,97,75,82,87,125,236,39,26,13,10
S01007878,598,25,0,25,75,44,37,73,122,174,32,19,13,16
S01007879,764,2,0,2,77,46,48,105,197,233,53,33,20,3
S01007880,382,52,12,40,99,15,82,35,46,45,8,0,8,0
S01007881,557,17,3,14,94,28,79,66,86,144,39,19,20,4
S01007882,730,101,33,68,209,37,191,64,48,60,6,1,5,14
S01007883,1046,58,16,42,241,131,137,134,128,179,24,11,13,14
S01007884,639,17,5,12,107,68,64,70,126,155,23,13,10,9
S01007885,730,25,0,25,86,51,65,110,136,173,79,34,45,5
S01007886,867,76,11,65,159,105,104,128,114,138,36,25,11,7
S01007887,578,58,17,41,134,45,172,57,39,49,15,12,3,9
S01007888,1070,18,1,17,99,84,40,140,237,337,93,48,45,22
S01007889,533,16,6,10,67,51,27,84,131,144,10,6,4,3
S01007890,736,32,0,32,106,83,96,113,104,161,32,8,24,9
S01007891,866,33,9,24,164,104,70,148,161,164,18,10,8,4
S01007892,738,90,25,65,194,87,97,85,103,64,18,11,7,0
S01007893,1019,114,21,93,308,65,186,111,106,99,25,20,5,5
S01007894,916,61,12,49,124,71,95,114,150,257,27,20,7,17
S01007895,542,67,13,54,103,63,76,59,80,68,21,11,10,5
S01007896,867,10,2,8,125,68,52,116,178,265,47,18,29,6
S01007897,439,38,5,33,102,31,150,37,40,28,13,9,4,0
S01007898,446,29,8,21,65,39,124,44,63,64,12,10,2,6
S01007899,349,20,7,13,67,28,152,21,16,38,6,1,5,1
S01007900,549,16,9,7,66,43,26,90,136,125,41,29,12,6
S01007901,711,22,7,15,78,67,57,99,117,192,73,38,35,6
S01007902,883,6,1,5,72,72,65,124,163,289,84,55,29,8
S01007903,645,29,10,19,80,62,77,120,95,151,30,14,16,1
S01007904,787,105,42,63,164,48,213,94,65,94,1,1,0,3
S01007905,687,5,0,5,39,48,29,97,166,195,100,44,56,8
S01007906,724,17,7,10,48,43,58,111,143,255,43,27,16,6
S01007907,536,21,6,15,57,31,25,72,95,187,48,28,20,0
S01007908,913,37,14,23,164,72,105,120,163,225,23,14,9,4
S01007909,543,23,4,19,60,34,48,98,79,163,28,16,12,10
S01007910,916,27,17,10,130,38,53,132,179,239,86,52,34,32
S01007911,777,33,8,25,132,80,64,114,149,174,17,13,4,14
S01007912,757,15,2,13,121,69,63,105,145,206,32,17,15,1
S01007913,616,4,0,4,85,41,55,91,119,166,49,31,18,6
S01007914,628,16,8,8,80,41,51,67,170,151,40,24,16,12
S01007915,835,21,9,12,118,105,79,131,168,156,43,13,30,14
S01007916,810,24,7,17,107,104,86,100,131,211,44,26,18,3
S01007917,811,18,11,7,147,63,60,120,137,227,32,23,9,7
S01007918,902,60,6,54,164,86,95,128,121,186,50,29,21,12
S01007919,773,108,30,78,241,73,84,97,76,83,7,5,2,4
S01007920,615,64,20,44,132,83,75,97,60,94,10,3,7,0
S01007921,922,30,6,24,70,66,71,133,190,300,61,33,28,1
S01007922,867,16,3,13,97,55,94,97,203,253,50,18,32,2
S01007923,968,43,14,29,189,98,123,138,136,219,20,12,8,2
S01007924,984,33,10,23,129,69,99,106,214,258,58,23,35,18
S01007925,465,74,25,49,111,26,166,41,26,17,4,4,0,0
S01007926,464,72,8,64,134,27,126,30,40,29,4,4,0,2
S01007927,617,102,21,81,148,48,197,32,49,34,7,4,3,0
S01007928,998,175,59,116,300,85,134,84,100,99,20,16,4,1
S01007929,738,127,28,99,188,64,222,53,29,45,5,2,3,5
S01007930,595,116,33,83,154,34,183,41,32,33,0,0,0,2
S01007931,1124,255,63,192,297,85,96,84,118,151,24,20,4,14
S01007932,831,144,31,113,271,83,112,78,61,56,13,10,3,13
S01007933,874,123,29,94,222,88,89,69,118,119,32,14,18,14
S01007934,720,82,12,70,180,73,82,60,91,109,33,25,8,10
S01007935,803,88,10,78,184,101,84,72,102,116,51,28,23,5
S01007936,1008,236,38,198,357,105,90,99,75,29,13,9,4,4
S01007937,1059,191,34,157,303,121,119,107,93,108,12,11,1,5
S01007938,740,45,12,33,133,112,68,86,134,108,43,17,26,11
S01007939,896,16,0,16,122,122,70,89,225,188,57,25,32,7
S01007940,1056,131,19,112,185,112,83,131,152,221,31,17,14,10
S01007941,631,75,32,43,178,95,61,76,64,70,12,8,4,0
S01007942,508,42,9,33,99,60,38,66,50,106,42,23,19,5
S01007943,660,80,22,58,142,79,72,69,73,120,19,10,9,6
S01007944,915,53,13,40,168,71,104,150,150,171,39,30,9,9
S01007945,850,77,21,56,180,89,104,77,126,144,43,18,25,10
S01007946,780,53,19,34,152,86,71,103,124,134,42,18,24,15
S01007947,756,123,46,77,135,91,78,73,92,117,46,18,28,1
S01007948,660,34,9,25,66,43,62,73,108,189,79,40,39,6
S01007949,751,82,16,66,190,80,65,122,108,86,15,8,7,3
S01007950,881,111,31,80,280,91,119,110,72,75,16,7,9,7
S01007951,755,70,16,54,149,88,75,109,110,106,27,12,15,21
S01007952,617,24,6,18,83,72,81,71,109,127,43,24,19,7
S01007953,938,28,5,23,154,85,107,121,211,197,18,1,17,17
S01007954,728,17,0,17,89,42,24,124,163,180,70,23,47,19
S01007955,833,19,5,14,72,79,59,120,194,215,65,32,33,10
S01007956,745,35,17,18,89,71,55,101,164,166,43,15,28,21
S01007957,928,33,9,24,150,107,68,143,176,196,41,29,12,14
S01007958,809,42,5,37,105,80,49,112,174,151,89,41,48,7
S01007959,761,51,19,32,155,73,75,141,114,132,18,10,8,2
S01007960,696,34,3,31,118,53,33,93,178,156,31,13,18,0
S01007961,703,72,12,60,119,75,273,52,75,28,8,8,0,1
S01007962,597,28,11,17,59,75,62,67,110,138,49,31,18,9
S01007963,1003,9,1,8,52,87,65,99,212,265,192,103,89,22
S01007964,791,29,7,22,74,60,60,112,166,213,59,31,28,18
S01007965,576,12,4,8,78,51,35,65,122,143,62,26,36,8
S01007966,977,45,10,35,117,83,47,113,208,233,117,54,63,14
S01007967,639,5,0,5,67,68,49,39,169,132,101,48,53,9
S01007968,869,30,12,18,128,127,62,111,209,172,28,8,20,2
S01007969,840,19,4,15,126,131,54,106,195,155,44,23,21,10
S01007970,874,21,4,17,167,98,57,101,200,179,42,11,31,9
S01007971,927,27,15,12,122,101,53,146,193,224,47,26,21,14
S01007972,828,20,3,17,134,85,56,144,185,181,13,5,8,10
S01007973,816,74,26,48,250,128,40,125,90,95,13,10,3,1
S01007974,784,30,10,20,97,88,40,98,171,174,71,39,32,15
S01007975,655,14,4,10,125,71,57,99,133,111,33,17,16,12
S01007976,703,39,6,33,116,86,31,82,120,159,56,26,30,14
S01007977,645,68,19,49,159,73,44,97,122,61,15,7,8,6
S01007978,559,33,16,17,114,84,31,77,106,82,24,11,13,8
S01007979,829,124,23,101,266,93,82,96,95,50,11,3,8,12
S01007980,701,75,20,55,141,104,70,80,104,105,17,8,9,5
S01007981,547,27,11,16,176,91,62,66,61,55,7,3,4,2
S01007982,514,48,13,35,142,77,43,64,69,63,8,3,5,0
S01007983,777,30,8,22,101,88,57,104,172,174,41,13,28,10
S01007984,825,87,23,64,181,104,63,82,144,130,28,23,5,6
S01007985,923,48,19,29,103,77,57,133,202,219,65,24,41,19
S01007986,576,43,13,30,105,76,44,85,112,104,6,6,0,1
S01007987,759,91,12,79,168,116,55,76,116,97,32,5,27,8
S01007988,817,36,12,24,121,99,49,98,198,168,45,22,23,3
S01007989,722,22,11,11,125,50,61,99,170,146,39,21,18,10
S01007990,928,49,11,38,184,120,58,152,130,171,49,19,30,15
S01007991,958,216,45,171,371,109,82,58,64,39,15,4,11,4
S01007992,657,93,9,84,217,38,84,144,42,32,0,0,0,7
S01007993,818,95,16,79,219,117,77,103,120,73,10,8,2,4
S01007994,853,184,53,131,316,98,73,65,57,43,7,2,5,10
S01007995,887,133,25,108,278,138,48,117,91,73,6,1,5,3
S01007996,468,82,22,60,157,36,84,29,43,26,11,4,7,0
S01007997,669,112,23,89,245,92,87,52,28,30,21,12,9,2
S01007998,506,96,14,82,151,61,63,42,43,27,23,7,16,0
S01007999,656,7,3,4,79,57,62,64,182,159,38,12,26,8
S01008000,868,26,1,25,105,91,43,82,223,220,59,37,22,19
S01008001,858,16,3,13,70,64,46,92,207,248,97,44,53,18
S01008002,781,17,13,4,98,45,52,89,165,170,120,59,61,25
S01008003,596,39,9,30,108,73,61,74,113,95,16,6,10,17
S01008004,673,74,8,66,150,100,45,100,77,99,20,7,13,8
S01008005,565,68,6,62,126,73,54,55,93,65,22,15,7,9
S01008006,579,5,1,4,70,25,49,78,127,132,82,60,22,11
S01008007,430,7,0,7,44,29,14,55,97,118,60,25,35,6
S01008008,645,25,1,24,107,39,54,76,74,150,89,60,29,31
S01008009,785,49,11,38,115,111,47,87,147,138,66,44,22,25
S01008010,858,46,16,30,141,107,85,107,155,105,98,54,44,14
S01008011,657,19,1,18,110,82,36,44,133,150,70,38,32,13
S01008012,760,73,14,59,162,101,82,68,102,115,36,17,19,21
S01008013,605,58,14,44,127,93,57,61,85,91,26,18,8,7
S01008014,622,66,11,55,180,68,46,79,83,76,16,9,7,8
S01008015,776,33,2,31,135,97,31,95,168,157,53,27,26,7
S01008016,781,37,7,30,159,124,71,76,130,137,33,13,20,14
S01008017,879,184,55,129,303,109,89,62,63,54,10,7,3,5
S01008018,634,101,30,71,208,88,66,58,65,39,5,4,1,4
S01008019,695,161,32,129,230,48,97,49,62,39,8,7,1,1
S01008020,587,59,15,44,164,105,55,82,49,60,9,7,2,4
S01008021,571,103,26,77,157,59,101,56,66,21,7,1,6,1
S01008022,728,115,35,80,285,72,91,62,64,33,1,1,0,5
S01008023,734,167,37,130,228,68,87,90,53,30,6,0,6,5
S01008024,685,170,33,137,249,70,73,72,34,17,0,0,0,0
S01008025,685,64,12,52,144,114,67,106,89,87,9,7,2,5
S01008026,1026,70,23,47,195,108,77,132,157,224,53,27,26,10
S01008027,563,25,1,24,109,69,22,93,84,132,25,14,11,4
S01008028,585,35,5,30,136,63,81,80,79,98,8,6,2,5
S01008029,784,109,12,97,160,77,190,57,115,56,12,8,4,8
S01008030,1054,111,16,95,329,122,137,125,100,121,8,4,4,1
S01008031,881,75,13,62,161,109,74,92,163,156,46,28,18,5
S01008032,890,71,27,44,177,100,79,107,153,165,25,14,11,13
S01008033,810,295,64,231,252,53,119,45,30,16,0,0,0,0
S01008034,790,260,50,210,267,69,95,46,27,20,5,0,5,1
S01008035,627,106,23,83,237,100,52,50,48,25,8,6,2,1
S01008036,669,149,34,115,239,79,72,43,55,23,7,0,7,2
S01008037,1014,96,19,77,205,158,117,111,201,108,14,11,3,4
S01008038,761,60,6,54,148,97,72,92,140,127,15,5,10,10
S01008039,898,113,30,83,228,102,73,124,142,91,13,5,8,12
S01008040,814,223,47,176,271,74,84,50,62,37,5,2,3,8
S01008041,707,175,25,150,222,70,57,41,66,59,8,4,4,9
S01008042,597,200,21,179,187,65,69,18,30,17,8,5,3,3
S01008043,962,362,72,290,306,88,126,30,31,6,11,7,4,2
S01008044,959,277,41,236,321,114,89,75,48,20,10,10,0,5
S01008045,977,301,29,272,279,94,113,54,49,49,35,21,14,3
S01008046,847,125,24,101,214,127,59,62,105,85,54,41,13,16
S01008047,697,240,26,214,198,59,96,33,38,23,5,4,1,5
S01008048,575,166,42,124,221,65,35,30,22,23,5,4,1,8
S01008049,858,242,33,209,313,105,105,44,23,18,3,3,0,5
S01008050,618,224,56,168,188,70,73,19,20,12,6,2,4,6
S01008051,884,268,48,220,325,106,64,44,31,31,5,5,0,10
S01008052,829,284,28,256,338,60,67,21,26,16,10,10,0,7
S01008053,610,157,24,133,242,79,65,23,33,10,1,1,0,0
S01008054,769,260,62,198,239,75,105,29,28,20,13,6,7,0
S01008055,1049,450,91,359,344,81,93,31,29,12,3,3,0,6
S01008056,755,276,23,253,230,73,80,23,39,21,6,6,0,7
S01008057,936,290,63,227,344,102,106,28,47,7,2,1,1,10
S01008058,895,341,51,290,263,46,181,22,20,12,3,0,3,7
S01008059,678,171,19,152,227,86,73,38,45,28,4,2,2,6
S01008060,903,231,46,185,305,147,87,56,39,30,8,1,7,0
S01008061,704,163,30,133,269,75,74,32,58,24,6,4,2,3
S01008062,872,138,29,109,259,137,98,106,80,44,8,2,6,2
S01008063,936,252,29,223,335,104,105,49,52,21,10,10,0,8
S01008064,701,72,8,64,157,100,77,65,83,95,40,17,23,12
S01008065,993,344,56,288,391,70,91,24,18,32,9,7,2,14
S01008066,937,454,63,391,263,43,128,21,17,6,2,0,2,3
S01008067,629,271,26,245,177,52,59,18,21,16,6,6,0,9
S01008068,914,221,37,184,284,103,107,65,86,39,5,5,0,4
S01008069,932,97,11,86,298,159,81,98,107,80,10,3,7,2
S01008070,878,90,25,65,252,186,81,91,87,71,16,7,9,4
S01008071,702,109,8,101,273,104,79,53,40,38,4,3,1,2
S01008072,769,268,46,222,260,63,80,23,31,22,11,0,11,11
S01008073,471,188,13,175,129,34,76,17,10,16,1,1,0,0
S01008074,972,271,49,222,339,114,122,39,61,20,2,2,0,4
S01008075,613,204,33,171,202,60,87,6,17,24,8,4,4,5
S01008076,624,214,24,190,199,71,65,32,18,12,6,6,0,7
S01008077,831,343,50,293,252,84,90,24,15,7,13,6,7,3
S01008078,860,218,34,184,272,102,142,47,50,20,7,6,1,2
S01008079,905,278,52,226,289,82,138,21,59,21,17,6,11,0
S01008080,699,175,30,145,209,75,136,43,25,27,4,3,1,5
S01008081,599,193,39,154,184,54,74,38,31,17,5,5,0,3
S01008082,820,186,29,157,289,106,114,37,52,18,7,3,4,11
S01008083,727,201,46,155,236,85,89,30,62,18,3,1,2,3
S01008084,853,162,31,131,266,115,105,76,66,45,9,5,4,9
S01008085,973,197,22,175,348,93,150,63,72,30,11,5,6,9
S01008086,1091,218,47,171,273,158,151,88,90,94,8,6,2,11
S01008087,856,199,47,152,239,141,80,72,57,41,14,9,5,13
S01008088,917,167,34,133,302,139,62,94,77,53,14,6,8,9
S01008089,653,106,33,73,219,91,71,68,58,36,4,2,2,0
S01008090,771,175,30,145,209,115,67,56,46,95,3,3,0,5
S01008091,385,82,9,73,124,34,55,16,35,29,8,5,3,2
S01008092,908,221,26,195,315,113,113,53,62,29,1,1,0,1
S01008093,809,128,32,96,251,134,116,76,54,40,7,5,2,3
S01008094,667,142,22,120,227,66,103,55,43,17,14,6,8,0
S01008095,744,86,21,65,223,116,82,90,61,72,12,3,9,2
S01008096,790,150,34,116,241,100,78,73,78,66,2,1,1,2
S01008097,628,120,45,75,199,98,80,30,42,49,9,1,8,1
S01008098,750,137,34,103,218,116,66,72,65,61,10,9,1,5
S01008099,521,63,11,52,127,77,62,62,56,64,8,3,5,2
S01008100,946,244,36,208,265,100,146,45,55,72,15,1,14,4
S01008101,790,145,16,129,235,114,74,82,69,56,9,1,8,6
S01008102,749,67,17,50,226,109,100,67,90,68,16,10,6,6
S01008103,610,59,16,43,137,93,62,48,95,82,29,17,12,5
S01008104,864,50,12,38,163,161,78,97,130,132,38,23,15,15
S01008105,1072,76,22,54,213,153,109,85,186,173,62,34,28,15
S01008106,785,21,0,21,146,95,58,70,155,178,59,37,22,3
S01008107,909,174,41,133,251,73,209,92,64,31,5,0,5,10
S01008108,655,131,29,102,191,85,94,56,54,37,6,3,3,1
S01008109,940,126,35,91,239,147,121,105,110,71,14,7,7,7
S01008110,881,81,9,72,326,120,117,90,74,63,4,2,2,6
S01008111,869,215,56,159,237,142,94,74,61,43,1,1,0,2
S01008112,816,120,31,89,256,113,77,120,70,47,4,4,0,9
S01008113,891,156,25,131,300,151,91,80,76,33,0,0,0,4
S01008114,685,88,15,73,224,103,61,79,65,55,10,6,4,0
S01008115,913,107,25,82,212,174,116,118,83,84,15,7,8,4
S01008116,933,186,38,148,334,130,81,50,68,64,10,7,3,10
S01008117,800,200,43,157,287,94,79,43,54,27,16,11,5,0
S01008118,882,122,21,101,243,122,93,81,110,80,20,7,13,11
S01008119,665,36,5,31,93,77,55,83,148,132,28,15,13,13
S01008120,635,131,19,112,199,109,60,29,57,30,15,10,5,5
S01008121,662,221,37,184,220,70,58,26,42,20,3,1,2,2
S01008122,752,257,42,215,287,41,82,27,25,15,11,4,7,7
S01008123,904,339,53,286,278,91,104,23,45,15,2,2,0,7
S01008124,835,189,30,159,253,134,90,57,45,52,6,3,3,9
S01008125,881,220,71,149,273,128,85,39,45,81,5,5,0,5
S01008126,812,214,35,179,278,106,78,53,39,31,9,1,8,4
S01008127,489,127,39,88,174,63,36,31,21,27,9,3,6,1
S01008128,880,209,31,178,298,117,78,65,49,45,11,3,8,8
S01008129,891,77,21,56,230,118,78,86,145,102,46,19,27,9
S01008130,955,90,26,64,225,169,68,84,144,109,42,18,24,24
S01008131,766,42,6,36,185,131,59,71,118,113,34,17,17,13
S01008132,1025,212,47,165,356,115,112,103,75,42,8,5,3,2
S01008133,630,121,19,102,149,63,58,62,79,69,24,18,6,5
S01008134,602,126,22,104,157,94,44,52,60,38,26,15,11,5
S01008135,1105,127,35,92,330,146,113,107,145,82,32,15,17,23
S01008136,875,79,20,59,168,131,74,86,168,121,38,31,7,10
S01008137,900,35,10,25,105,74,43,139,253,165,71,38,33,15
S01008138,852,34,9,25,122,75,40,87,210,196,73,38,35,15
S01008139,875,40,8,32,171,125,78,113,109,177,50,16,34,12
S01008140,522,47,7,40,99,49,34,51,94,114,34,24,10,0
S01008141,840,98,17,81,246,117,99,110,85,66,8,3,5,11
S01008142,802,128,46,82,254,101,62,103,57,77,5,4,1,15
S01008143,899,65,0,65,245,121,55,99,136,125,40,19,21,13
S01008144,614,97,21,76,184,70,99,49,60,51,1,1,0,3
S01008145,808,35,9,26,127,86,69,127,113,221,26,11,15,4
S01008146,499,46,15,31,71,21,53,67,89,132,19,10,9,1
S01008147,788,69,23,46,158,125,69,86,131,129,12,5,7,9
S01008148,747,67,5,62,203,130,70,92,76,81,16,11,5,12
S01008149,707,39,12,27,147,144,42,74,115,111,24,8,16,11
S01008150,941,57,20,37,208,169,56,96,150,177,25,13,12,3
S01008151,704,46,12,34,135,84,55,102,154,111,12,6,6,5
S01008152,1057,73,12,61,255,157,82,112,183,133,46,25,21,16
S01008153,795,141,18,123,245,112,90,66,63,65,5,0,5,8
S01008154,828,156,43,113,245,126,88,54,59,77,17,4,13,6
S01008155,670,105,25,80,190,120,66,47,80,55,7,4,3,0
S01008156,919,82,21,61,218,88,164,83,127,122,32,18,14,3
S01008157,746,143,10,133,204,108,71,83,62,56,5,0,5,14
S01008158,715,78,18,60,231,109,84,81,67,57,6,0,6,2
S01008159,987,80,16,64,158,115,87,116,213,138,67,39,28,13
S01008160,942,74,15,59,157,97,78,121,206,142,51,14,37,16
S01008161,1035,144,28,116,368,89,151,97,111,67,6,4,2,2
S01008162,993,140,23,117,282,69,119,94,139,138,7,2,5,5
S01008163,758,43,2,41,108,70,80,101,134,185,30,15,15,7
S01008164,650,31,4,27,98,92,80,66,131,124,17,6,11,11
S01008165,763,98,14,84,246,106,134,67,44,60,3,2,1,5
S01008166,559,11,2,9,93,38,49,90,133,127,8,7,1,10
S01008167,724,23,10,13,101,65,49,89,140,206,38,13,25,13
S01008168,816,34,9,25,128,93,43,112,197,170,32,19,13,7
S01008169,711,48,13,35,122,74,66,90,159,140,7,7,0,5
S01008170,575,152,29,123,132,78,74,36,43,54,5,3,2,1
S01008171,733,54,8,46,155,135,45,79,144,95,8,8,0,18
S01008172,557,38,14,24,142,80,74,48,83,85,4,1,3,3
S01008173,664,90,15,75,146,132,63,64,93,62,10,9,1,4
S01008174,532,57,6,51,128,112,72,55,39,63,0,0,0,6
S01008175,750,68,8,60,163,114,70,73,98,129,28,13,15,7
S01008176,727,181,39,142,208,71,99,62,49,36,4,2,2,17
S01008177,776,83,30,53,167,109,65,67,123,132,26,11,15,4
S01008178,640,78,17,61,167,120,70,60,72,58,13,7,6,2
S01008179,512,95,30,65,149,63,80,31,51,43,0,0,0,0
S01008180,473,89,10,79,158,63,53,47,51,7,2,2,0,3
S01008181,678,120,36,84,200,93,95,57,53,43,8,8,0,9
S01008182,924,98,11,87,194,134,61,92,160,118,32,13,19,35
S01008183,642,83,20,63,150,89,60,95,63,63,12,2,10,27
S01008184,798,79,24,55,191,125,66,58,112,118,19,8,11,30
S01008185,1012,59,12,47,229,163,86,100,157,150,41,17,24,27
S01008186,628,47,4,43,197,91,55,76,57,67,17,8,9,21
S01008187,617,72,10,62,128,71,49,45,125,95,22,14,8,10
S01008188,920,56,8,48,164,86,63,93,180,198,36,28,8,44
S01008189,565,73,14,59,90,102,73,64,67,74,10,5,5,12
S01008190,877,42,5,37,141,102,81,81,188,190,34,11,23,18
S01008191,478,42,17,25,123,69,38,54,63,67,16,8,8,6
S01008192,773,69,8,61,174,102,68,73,125,126,25,13,12,11
S01008193,790,146,17,129,171,86,57,59,152,104,14,6,8,1
S01008194,584,92,19,73,124,59,58,47,96,84,19,7,12,5
S01008195,796,28,3,25,133,117,65,96,164,156,23,20,3,14
S01008196,796,25,7,18,107,115,82,111,117,175,54,27,27,10
S01008197,940,120,17,103,242,131,65,139,117,89,26,11,15,11
S01008198,693,18,3,15,116,89,57,108,147,136,19,12,7,3
S01008199,776,6,0,6,81,68,51,116,194,215,45,32,13,0
S01008200,628,34,2,32,63,74,57,76,138,149,29,26,3,8
S01008201,797,44,8,36,101,104,29,110,153,194,51,18,33,11
S01008202,567,28,10,18,121,105,34,62,102,97,11,11,0,7
S01008203,556,13,5,8,90,80,35,49,104,133,46,15,31,6
S01008204,875,67,17,50,212,85,85,91,131,165,33,27,6,6
S01008205,680,36,19,17,108,75,74,97,129,147,12,2,10,2
S01008206,654,27,7,20,93,80,43,96,106,173,33,18,15,3
S01008207,618,16,8,8,62,77,82,87,116,142,27,5,22,9
S01008208,793,74,16,58,192,112,85,100,104,98,16,1,15,12
S01008209,563,46,6,40,151,87,120,65,41,46,3,3,0,4
S01008210,935,68,10,58,213,122,138,120,125,121,25,10,15,3
S01008211,887,84,21,63,210,145,110,70,112,115,32,21,11,9
S01008212,583,72,11,61,181,72,82,71,60,36,3,0,3,6
S01008213,1029,178,34,144,255,110,122,130,138,73,14,3,11,9
S01008214,704,58,25,33,162,104,79,96,91,93,21,11,10,0
S01008215,735,51,7,44,193,106,55,79,151,88,12,6,6,0
S01008216,515,56,11,45,126,97,76,44,59,42,6,3,3,9
S01008217,557,124,28,96,211,52,59,58,26,24,3,1,2,0
S01008218,1077,185,29,156,344,133,180,58,79,86,2,0,2,10
S01008219,933,91,14,77,200,125,120,72,161,130,27,19,8,7
S01008220,644,29,4,25,103,14,55,104,154,145,33,28,5,7
S01008221,718,40,10,30,93,46,52,79,165,178,56,40,16,9
S01008222,641,24,8,16,111,48,58,83,143,147,20,9,11,7
S01008223,597,25,7,18,108,91,34,56,129,114,36,23,13,4
S01008224,907,68,9,59,196,183,86,130,127,105,8,7,1,4
S01008225,714,31,8,23,183,107,64,96,99,125,4,2,2,5
S01008226,755,17,0,17,91,98,73,64,182,192,33,27,6,5
S01008227,819,22,0,22,105,79,54,99,169,261,23,13,10,7
S01008228,639,57,10,47,176,89,112,57,72,64,12,6,6,0
S01008229,686,21,6,15,123,76,54,76,135,178,19,10,9,4
S01008230,811,78,17,61,212,127,108,79,105,81,17,8,9,4
S01008231,794,101,17,84,228,94,142,100,42,69,4,2,2,14
S01008232,686,89,11,78,168,89,79,57,83,78,38,15,23,5
S01008233,467,60,16,44,139,58,67,44,35,50,11,6,5,3
S01008234,387,11,0,11,66,44,49,54,77,75,7,7,0,4
S01008235,829,45,5,40,141,99,106,117,134,158,23,14,9,6
S01008236,845,100,23,77,195,101,120,90,110,99,21,7,14,9
S01008237,864,83,15,68,183,110,123,63,166,105,31,11,20,0
S01008238,756,36,4,32,139,81,63,122,100,174,35,17,18,6
S01008239,760,83,28,55,174,75,96,90,128,101,13,7,6,0
S01008240,885,213,30,183,299,104,127,49,56,31,3,3,0,3
S01008241,648,133,30,103,249,80,102,25,35,10,7,3,4,7
S01008242,900,138,26,112,248,104,120,84,102,86,14,13,1,4
S01008243,936,230,38,192,277,58,136,97,76,53,4,3,1,5
S01008244,574,110,18,92,194,34,86,40,55,48,7,5,2,0
S01008245,992,191,20,171,329,93,110,84,105,71,9,4,5,0
S01008246,933,285,38,247,272,67,113,53,85,46,5,1,4,7
S01008247,789,177,59,118,192,57,168,67,64,51,12,5,7,1
S01008248,936,187,24,163,216,87,150,80,101,93,11,10,1,11
S01008249,883,193,57,136,258,69,171,52,74,55,11,8,3,0
S01008250,1024,272,51,221,314,79,187,45,78,33,6,4,2,10
S01008251,754,245,50,195,247,71,86,37,33,26,3,3,0,6
S01008252,825,171,28,143,285,95,110,48,59,42,8,0,8,7
S01008253,755,58,7,51,147,76,59,80,138,162,26,12,14,9
S01008254,973,69,10,59,218,102,76,154,143,171,40,27,13,0
S01008255,725,76,13,63,191,106,86,59,101,83,16,12,4,7
S01008256,838,58,7,51,141,71,107,100,185,137,20,11,9,19
S01008257,642,78,16,62,150,62,76,56,97,92,25,19,6,6
S01008258,809,127,26,101,261,116,91,33,98,78,3,2,1,2
S01008259,777,159,46,113,198,70,111,42,89,85,15,7,8,8
S01008260,780,55,15,40,155,79,63,97,177,119,32,21,11,3
S01008261,901,62,20,42,158,70,93,121,142,212,29,13,16,14
S01008262,612,146,23,123,137,37,98,61,78,47,8,7,1,0
S01008263,560,174,37,137,132,60,74,37,49,26,6,6,0,2
S01008264,751,100,12,88,183,89,78,82,123,71,22,12,10,3
S01008265,706,176,26,150,261,76,73,40,34,31,11,9,2,4
S01008266,678,240,68,172,200,50,87,26,35,31,9,9,0,0
S01008267,808,194,47,147,209,69,132,49,102,45,6,1,5,2
S01008268,827,290,52,238,283,70,97,31,25,17,10,4,6,4
S01008269,808,221,58,163,259,111,72,51,60,30,1,0,1,3
S01008270,785,224,47,177,280,74,94,21,43,29,16,6,10,4
S01008271,664,80,17,63,204,53,101,57,92,40,29,16,13,8
S01008272,1002,218,40,178,321,67,131,96,97,62,7,1,6,3
S01008273,841,209,52,157,251,86,91,80,71,44,7,5,2,2
S01008274,729,94,13,81,109,76,73,111,136,91,30,9,21,9
S01008275,558,147,28,119,152,47,60,33,42,51,20,15,5,6
S01008276,557,178,44,134,151,60,66,27,50,23,2,2,0,0
S01008277,502,108,17,91,154,23,120,38,27,8,24,6,18,0
S01008278,774,244,44,200,247,49,104,29,54,34,13,11,2,0
S01008279,733,89,22,67,191,70,94,61,104,113,11,3,8,0
S01008280,939,157,23,134,264,64,182,76,94,83,16,7,9,3
S01008281,726,129,37,92,192,36,128,52,95,74,12,5,7,8
S01008282,686,108,22,86,164,53,152,78,59,60,8,3,5,4
S01008283,504,153,27,126,150,39,76,31,32,16,6,0,6,1
S01008284,892,175,50,125,209,94,118,84,98,93,21,8,13,0
S01008285,754,28,2,26,113,65,83,106,164,169,22,17,5,4
S01008286,724,66,16,50,139,54,74,92,118,169,9,7,2,3
S01008287,737,95,23,72,140,65,94,86,93,132,22,4,18,10
S01008288,899,145,27,118,240,53,124,65,109,142,21,12,9,0
S01008289,617,40,8,32,146,76,68,73,97,100,12,10,2,5
S01008290,864,143,40,103,254,66,107,60,113,70,38,18,20,13
S01008291,717,80,37,43,145,101,79,125,103,74,10,4,6,0
S01008292,831,105,15,90,138,89,71,67,140,165,42,19,23,14
S01008293,606,182,23,159,210,75,67,32,30,7,3,0,3,0
S01008294,937,229,53,176,257,63,102,110,71,84,13,9,4,8
S01008295,957,102,29,73,218,146,63,166,125,113,14,9,5,10
S01008296,687,64,15,49,115,78,78,101,98,103,36,19,17,14
S01008297,789,116,21,95,198,99,82,88,94,79,27,19,8,6
S01008298,745,66,9,57,171,95,93,114,89,89,27,24,3,1
S01008299,813,37,10,27,185,77,90,60,132,141,79,25,54,12
S01008300,846,49,19,30,191,116,96,98,152,95,45,33,12,4
S01008301,832,152,34,118,220,144,82,73,62,90,3,2,1,6
S01008302,745,177,32,145,243,74,125,38,31,46,7,3,4,4
S01008303,558,76,18,58,114,90,62,45,85,68,15,7,8,3
S01008304,476,110,19,91,119,49,42,58,48,40,7,7,0,3
S01008305,791,128,40,88,235,124,55,99,89,51,6,3,3,4
S01008306,611,60,6,54,179,97,67,74,57,74,3,3,0,0
S01008307,589,98,28,70,169,93,54,51,58,55,8,0,8,3
S01008308,566,101,34,67,187,68,41,89,50,17,9,6,3,4
S01008309,706,61,13,48,107,81,54,87,137,111,58,38,20,10
S01008310,949,67,13,54,223,124,80,133,129,144,40,16,24,9
S01008311,384,50,10,40,71,52,23,52,63,56,12,4,8,5
S01008312,413,48,6,42,109,64,19,32,69,42,20,17,3,10
S01008313,834,44,17,27,147,73,64,80,199,177,49,39,10,1
S01008314,566,20,3,17,101,70,36,63,152,83,24,10,14,17
S01008315,748,34,8,26,102,91,58,91,155,117,71,50,21,29
S01008316,598,42,5,37,66,53,31,44,97,160,97,67,30,8
S01008317,738,52,11,41,185,84,81,64,121,89,50,31,19,12
S01008318,923,162,55,107,279,98,130,72,92,63,20,16,4,7
S01008319,739,51,3,48,151,121,71,80,119,108,27,19,8,11
S01008320,633,73,21,52,188,74,49,83,72,63,26,23,3,5
S01008321,546,69,23,46,154,74,61,73,61,42,12,4,8,0
S01008322,1055,91,22,69,212,170,87,126,178,139,35,12,23,17
S01008323,799,28,8,20,103,73,73,84,177,175,72,36,36,14
S01008324,651,66,15,51,105,79,55,65,113,118,25,12,13,25
S01008325,764,30,2,28,110,92,32,111,110,191,64,46,18,24
S01008326,990,32,10,22,128,138,71,112,213,208,58,34,24,30
S01008327,857,55,7,48,123,120,49,131,197,142,36,17,19,4
S01008328,699,176,19,157,238,112,86,29,29,18,7,7,0,4
S01008329,883,184,31,153,306,106,121,67,45,39,9,3,6,6
S01008330,871,152,59,93,286,103,129,50,88,47,16,6,10,0
S01008331,602,101,18,83,197,67,89,44,56,35,10,1,9,3
S01008332,884,208,34,174,315,75,138,34,73,27,6,3,3,8
S01008333,943,296,83,213,307,80,138,19,66,16,19,11,8,2
S01008334,731,181,33,148,229,88,100,41,57,16,16,9,7,3
S01008335,763,122,24,98,229,91,75,48,113,61,11,6,5,13
S01008336,662,95,16,79,176,93,97,35,80,49,33,21,12,4
S01008337,906,226,40,186,297,94,40,92,74,43,23,17,6,17
S01008338,876,298,45,253,298,60,109,37,49,14,4,0,4,7
S01008339,629,170,29,141,190,102,52,22,69,16,7,6,1,1
S01008340,822,195,20,175,263,88,119,43,72,22,10,1,9,10
S01008341,700,211,34,177,247,57,124,14,31,16,0,0,0,0
S01008342,853,245,49,196,261,66,91,55,45,55,26,19,7,9
S01008343,848,329,61,268,279,51,121,19,19,22,8,2,6,0
S01008344,872,344,73,271,252,43,175,17,19,11,11,4,7,0
S01008345,916,325,73,252,292,51,150,29,35,14,16,15,1,4
S01008346,1023,333,92,241,340,84,162,40,30,26,6,5,1,2
S01008347,980,235,40,195,327,113,158,30,69,24,20,13,7,4
S01008348,734,228,42,186,227,83,106,18,45,9,12,2,10,6
S01008349,890,340,59,281,322,59,131,14,14,0,7,5,2,3
S01008350,589,151,32,119,225,52,103,16,25,7,7,2,5,3
S01008351,893,296,78,218,321,90,95,31,40,13,4,3,1,3
S01008352,674,261,34,227,212,55,96,21,16,2,7,7,0,4
S01008353,525,170,34,136,134,51,95,14,25,14,13,8,5,9
S01008354,698,190,37,153,171,44,155,49,40,34,13,11,2,2
S01008355,658,90,35,55,174,99,93,45,50,64,29,15,14,14
S01008356,587,133,27,106,178,63,68,46,55,27,4,1,3,13
S01008357,706,177,38,139,197,107,69,51,68,30,4,4,0,3
S01008358,697,86,22,64,186,89,103,69,82,59,19,8,11,4
S01008359,639,110,31,79,186,96,125,76,14,16,12,9,3,4
S01008360,844,265,60,205,277,101,105,29,36,23,6,4,2,2
S01008361,516,89,23,66,169,86,71,34,22,34,3,3,0,8
S01008362,956,172,18,154,379,134,101,55,54,40,13,8,5,8
S01008363,739,224,46,178,203,106,68,40,48,16,8,4,4,26
S01008364,761,200,43,157,225,89,122,28,62,19,7,3,4,9
S01008365,674,185,49,136,225,61,110,40,30,9,12,10,2,2
S01008366,897,120,10,110,253,148,70,37,129,80,34,25,9,26
S01008367,727,84,16,68,189,85,73,46,116,80,28,18,10,26
S01008368,657,112,13,99,242,99,64,32,43,51,4,1,3,10
S01008369,529,96,31,65,158,61,30,32,60,59,23,7,16,10
S01008370,692,156,32,124,206,102,99,23,67,15,16,12,4,8
S01008371,808,187,46,141,275,116,95,53,36,29,9,8,1,8
S01008372,790,173,48,125,245,112,58,106,37,37,14,3,11,8
S01008373,795,227,18,209,339,73,55,54,22,15,10,10,0,0
S01008374,705,142,18,124,286,119,49,35,41,26,1,1,0,6
S01008375,789,181,61,120,313,87,87,38,49,20,9,3,6,5
S01008376,550,193,54,139,143,64,45,33,38,18,13,2,11,3
S01008377,746,183,17,166,253,88,85,52,52,23,5,5,0,5
S01008378,1015,273,65,208,344,129,108,44,75,16,21,20,1,5
S01008379,530,98,37,61,236,50,50,52,29,8,5,5,0,2
S01008380,649,170,21,149,253,85,51,33,39,13,5,3,2,0
S01008381,649,167,19,148,234,77,81,26,28,22,6,0,6,8
S01008382,650,175,34,141,218,91,68,35,28,26,3,2,1,6
S01008383,480,136,20,116,163,46,53,38,13,24,3,3,0,4
S01008384,968,180,21,159,257,152,89,94,127,61,4,4,0,4
S01008385,674,202,35,167,248,60,86,27,20,25,6,2,4,0
S01008386,795,118,21,97,248,131,67,84,68,56,9,7,2,14
S01008387,609,87,21,66,195,122,72,30,65,33,5,1,4,0
S01008388,637,89,10,79,210,93,79,38,71,54,0,0,0,3
S01008389,621,169,30,139,185,78,66,37,58,17,11,10,1,0
S01008390,619,190,33,157,205,57,80,28,36,16,5,5,0,2
S01008391,785,213,35,178,269,88,66,41,52,36,17,16,1,3
S01008392,906,319,64,255,348,71,76,36,38,3,11,4,7,4
S01008393,836,262,41,221,306,97,74,20,31,32,11,3,8,3
S01008394,832,387,99,288,263,44,67,18,13,31,2,2,0,7
S01008395,531,92,26,66,227,79,57,31,18,21,2,0,2,4
S01008396,626,112,22,90,213,103,99,26,39,27,7,4,3,0
S01008397,935,298,54,244,313,68,93,78,45,33,4,3,1,3
S01008398,587,165,28,137,193,91,63,28,30,11,5,0,5,1
S01008399,536,107,15,92,180,71,92,27,42,10,6,6,0,1
S01008400,690,165,23,142,226,83,76,25,67,18,21,20,1,9
S01008401,968,167,15,152,325,184,117,47,64,29,19,19,0,16
S01008402,1092,376,70,306,325,83,225,21,37,16,4,4,0,5
S01008403,610,234,32,202,181,48,87,20,25,7,3,2,1,5
S01008404,886,285,32,253,285,93,111,21,56,16,19,12,7,0
S01008405,771,318,57,261,208,53,98,22,42,5,17,8,9,8
S01008406,966,259,34,225,304,102,125,28,70,34,32,30,2,12
S01008407,522,90,26,64,181,75,44,26,60,17,26,25,1,3
S01008408,667,138,25,113,201,80,75,40,37,71,16,15,1,9
S01008409,832,116,32,84,166,180,68,67,119,74,36,24,12,6
S01008410,589,144,30,114,132,86,82,29,53,31,29,26,3,3
S01008411,604,75,17,58,181,96,87,39,83,29,12,6,6,2
S01008412,706,137,38,99,216,62,90,63,78,24,23,20,3,13
S01008413,549,115,10,105,130,56,69,30,76,50,18,13,5,5
S01008414,458,109,24,85,164,47,74,16,33,8,0,0,0,7
S01008415,841,86,11,75,218,84,126,84,133,93,12,8,4,5
S01008416,941,84,15,69,195,147,92,95,126,126,66,38,28,10
S01008417,726,210,43,167,239,86,86,32,42,24,6,3,3,1
S01008418,692,191,22,169,207,84,77,31,62,25,4,2,2,11
S01008419,500,172,57,115,180,34,48,14,27,16,4,2,2,5
S01008420,476,153,13,140,137,51,34,39,30,25,3,1,2,4
S01008421,858,138,13,125,224,111,84,56,126,89,17,8,9,13
S01008422,621,223,39,184,232,41,49,20,24,27,1,1,0,4
S01008423,1063,409,84,325,314,92,138,25,19,51,11,4,7,4
S01008424,835,322,71,251,273,68,86,35,24,12,6,4,2,9
S01008425,955,224,28,196,254,152,114,55,71,61,12,8,4,12
S01008426,573,45,7,38,101,86,33,70,118,113,3,3,0,4
S01008427,1068,272,69,203,259,151,129,98,91,54,3,0,3,11
S01008428,676,74,14,60,126,109,74,68,97,90,20,13,7,18
S01008429,841,196,47,149,248,136,95,46,51,51,11,9,2,7
S01008430,666,187,44,143,179,84,56,35,70,46,3,1,2,6
S01008431,842,194,17,177,273,152,67,41,51,40,17,11,6,7
S01008432,701,151,11,140,209,142,71,59,50,10,6,1,5,3
S01008433,807,111,32,79,219,135,94,90,71,81,3,2,1,3
S01008434,801,149,15,134,258,135,85,64,60,38,5,2,3,7
S01008435,766,162,38,124,203,116,80,82,63,40,1,1,0,19
S01008436,836,211,21,190,274,99,88,47,58,40,11,6,5,8
S01008437,708,193,31,162,175,98,86,37,72,27,6,2,4,14
S01008438,437,107,13,94,183,41,59,3,22,17,1,1,0,4
S01008439,1112,445,110,335,404,74,78,41,35,20,5,1,4,10
S01008440,997,423,55,368,339,75,80,19,28,22,10,3,7,1
S01008441,465,183,51,132,141,43,46,11,27,12,2,1,1,0
S01008442,680,243,57,186,231,59,86,19,26,10,6,4,2,0
S01008443,582,200,26,174,180,48,71,19,27,26,5,0,5,6
S01008444,623,208,90,118,166,63,65,35,38,31,11,5,6,6
S01008445,909,163,40,123,365,145,57,37,60,53,17,17,0,12
S01008446,781,284,55,229,275,78,69,31,26,13,5,5,0,0
S01008447,675,214,52,162,224,68,105,21,18,20,5,5,0,0
S01008448,755,157,38,119,184,117,128,40,62,40,4,3,1,23
S01008449,795,42,11,31,98,48,74,89,166,150,99,61,38,29
S01008450,555,16,4,12,59,39,32,44,167,151,27,17,10,20
S01008451,699,25,3,22,32,69,45,60,161,154,119,78,41,34
S01008452,631,12,5,7,54,48,49,64,169,149,40,27,13,46
S01008453,506,34,0,34,72,49,53,54,97,63,51,29,22,33
S01008454,951,16,1,15,112,111,44,69,215,203,158,139,19,23
S01008455,1000,40,2,38,100,94,57,115,205,188,112,75,37,89
S01008456,973,27,3,24,115,93,47,127,201,198,111,60,51,54
S01008457,616,15,4,11,75,74,19,54,147,166,52,44,8,14
S01008458,994,54,3,51,190,141,85,111,167,165,50,23,27,31
S01008459,741,18,3,15,67,63,28,95,181,164,88,49,39,37
S01008460,805,13,3,10,58,85,13,75,182,222,129,90,39,28
S01008461,914,12,0,12,91,117,44,86,194,224,111,76,35,35
S01008462,564,12,5,7,38,65,19,43,141,154,82,41,41,10
S01008463,670,30,4,26,66,70,40,74,133,155,73,41,32,29
S01008464,850,51,9,42,151,142,43,119,148,142,36,28,8,18
S01008465,742,30,5,25,99,133,61,78,148,113,44,33,11,36
S01008466,744,34,2,32,89,103,46,93,158,148,17,5,12,56
S01008467,785,20,3,17,103,96,90,130,158,130,32,16,16,26
S01008468,615,22,2,20,56,97,47,87,121,105,48,43,5,32
S01008469,577,35,4,31,111,54,59,54,82,109,8,6,2,65
S01008470,728,24,2,22,49,63,40,80,133,236,73,53,20,30
S01008471,858,42,5,37,99,75,46,55,251,197,75,49,26,18
S01008472,714,27,2,25,104,71,64,75,113,140,50,38,12,70
S01008473,700,34,7,27,90,98,38,67,159,156,38,27,11,20
S01008474,779,28,1,27,73,95,34,107,202,163,44,22,22,33
S01008475,610,17,9,8,96,82,24,63,160,115,22,16,6,31
S01008476,699,49,6,43,102,97,43,73,124,158,39,26,13,14
S01008477,773,25,8,17,120,129,39,106,148,168,24,15,9,14
S01008478,803,54,8,46,152,118,45,75,138,123,48,29,19,50
S01008479,755,40,2,38,115,102,40,72,165,154,43,24,19,24
S01008480,607,49,4,45,118,78,13,49,98,89,49,38,11,64
S01008481,983,81,19,62,168,112,87,95,203,199,24,12,12,14
S01008482,607,33,9,24,115,89,36,54,114,118,26,16,10,22
S01008483,598,29,2,27,92,86,65,47,113,108,19,13,6,39
S01008484,754,65,16,49,149,95,102,93,117,98,22,12,10,13
S01008485,1015,73,27,46,313,192,107,70,97,95,19,10,9,49
S01008486,867,64,11,53,203,113,104,81,144,107,23,12,11,28
S01008487,759,163,24,139,187,105,61,59,69,50,9,6,3,56
S01008488,764,91,8,83,149,117,55,75,91,101,10,6,4,75
S01008489,620,52,5,47,110,122,53,48,67,113,22,11,11,33
S01008490,893,107,17,90,193,146,52,86,123,115,23,8,15,48
S01008491,914,142,9,133,161,118,39,44,126,102,24,23,1,158
S01008492,944,112,7,105,234,143,42,61,122,82,57,49,8,91
S01008493,793,64,9,55,146,136,56,40,138,114,26,15,11,73
S01008494,688,54,2,52,141,115,42,55,81,100,37,26,11,63
S01008495,891,109,2,107,205,126,32,67,84,73,33,18,15,162
S01008496,956,161,9,152,225,137,40,74,69,71,34,11,23,145
S01008497,786,129,9,120,189,115,21,51,104,70,24,14,10,83
S01008498,764,116,8,108,167,99,28,87,107,51,28,17,11,81
S01008499,996,157,10,147,187,124,59,67,98,78,35,17,18,191
S01008500,402,44,1,43,60,68,23,21,48,48,35,24,11,55
S01008501,607,164,7,157,163,45,12,29,34,34,12,8,4,114
S01008502,635,107,6,101,168,107,16,24,56,16,20,17,3,121
S01008503,833,193,6,187,265,96,30,62,63,34,5,2,3,85
S01008504,1107,335,36,299,377,104,52,39,56,32,16,7,9,96
S01008505,711,211,29,182,249,56,45,31,38,29,12,1,11,40
S01008506,788,225,32,193,250,90,37,26,70,43,9,7,2,38
S01008507,755,202,12,190,276,85,30,36,37,20,4,4,0,65
S01008508,847,308,30,278,277,78,97,16,37,18,4,2,2,12
S01008509,994,310,52,258,358,118,61,41,54,13,8,6,2,31
S01008510,904,229,48,181,309,85,98,54,51,29,9,9,0,40
S01008511,879,343,49,294,253,60,122,30,32,24,4,2,2,11
S01008512,505,200,48,152,168,43,36,29,11,13,1,1,0,4
S01008513,669,285,61,224,183,63,70,13,35,11,2,2,0,7
S01008514,877,355,39,316,293,82,53,23,26,18,13,10,3,14
S01008515,747,287,38,249,252,59,64,23,31,19,3,0,3,9
S01008516,901,199,14,185,268,96,43,48,69,33,16,5,11,129
S01008517,860,203,19,184,269,109,32,29,40,18,15,13,2,145
S01008518,905,379,41,338,307,63,37,14,36,12,3,3,0,54
S01008519,809,389,41,348,254,47,61,13,32,5,2,2,0,6
S01008520,1076,431,78,353,359,81,123,32,25,5,8,3,5,12
S01008521,902,409,58,351,293,72,75,20,26,5,2,2,0,0
S01008522,532,230,47,183,170,40,58,8,10,0,9,5,4,7
S01008523,967,411,107,304,360,63,60,19,31,7,5,2,3,11
S01008524,863,40,13,27,148,127,66,89,167,123,59,36,23,44
S01008525,775,32,3,29,144,97,44,90,180,133,36,16,20,19
S01008526,846,79,8,71,181,165,69,72,107,131,24,12,12,18
S01008527,726,64,15,49,184,111,46,86,121,87,12,7,5,15
S01008528,720,78,9,69,173,121,71,65,120,67,25,5,20,0
S01008529,724,63,19,44,150,121,53,79,142,89,12,7,5,15
S01008530,724,19,2,17,113,101,45,86,179,127,42,25,17,12
S01008531,748,51,11,40,114,121,56,69,136,144,53,45,8,4
S01008532,443,27,3,24,72,83,42,38,67,72,32,16,16,10
S01008533,541,47,6,41,254,154,25,14,20,16,11,10,1,0
S01008534,723,136,24,112,262,145,64,31,38,28,5,4,1,14
S01008535,709,188,38,150,233,86,78,22,37,57,5,1,4,3
S01008536,569,165,20,145,168,80,63,34,37,16,5,4,1,1
S01008537,673,215,33,182,247,76,62,27,30,12,2,1,1,2
S01008538,542,170,25,145,214,60,66,12,17,0,1,1,0,2
S01008539,833,285,42,243,282,85,83,27,38,25,3,1,2,5
S01008540,861,272,45,227,277,95,125,41,27,11,3,0,3,10
S01008541,886,228,33,195,336,134,71,26,48,25,6,3,3,12
S01008542,942,303,53,250,358,125,69,15,36,19,8,7,1,9
S01008543,740,206,31,175,246,70,101,62,19,33,0,0,0,3
S01008544,653,276,36,240,212,32,47,37,26,15,5,1,4,3
S01008545,898,345,60,285,304,65,104,24,28,9,18,15,3,1
S01008546,806,310,71,239,297,59,85,14,29,9,3,3,0,0
S01008547,1010,140,19,121,266,137,139,98,113,83,16,13,3,18
S01008548,835,101,22,79,226,104,100,81,89,89,22,8,14,23
S01008549,948,104,18,86,249,141,128,91,107,85,30,22,8,13
S01008550,798,172,28,144,278,97,89,33,80,23,23,21,2,3
S01008551,969,157,26,131,243,163,151,66,105,59,11,8,3,14
S01008552,876,146,20,126,261,118,106,68,100,59,17,7,10,1
S01008553,523,76,12,64,103,71,57,34,73,75,26,21,5,8
S01008554,1090,86,13,73,98,80,96,89,211,250,169,119,50,11
S01008555,1027,44,10,34,164,114,64,76,197,222,118,79,39,28
S01008556,778,20,5,15,114,82,44,76,126,195,102,71,31,19
S01008557,914,33,8,25,136,88,45,109,220,198,74,60,14,11
S01008558,912,46,10,36,132,105,71,113,184,176,61,44,17,24
S01008559,715,32,6,26,120,60,60,71,153,165,32,25,7,22
S01008560,699,21,4,17,123,60,53,86,129,155,56,49,7,16
S01008561,674,52,13,39,126,69,56,64,132,142,29,23,6,4
S01008562,675,32,7,25,82,87,39,58,157,152,53,30,23,15
S01008563,805,46,4,42,131,77,46,101,188,159,51,25,26,6
S01008564,587,24,4,20,86,79,58,94,106,118,14,9,5,8
S01008565,928,26,4,22,115,137,93,95,177,182,65,34,31,38
S01008566,1064,46,10,36,164,103,86,140,212,230,76,56,20,7
S01008567,744,62,10,52,123,82,44,75,139,147,39,35,4,33
S01008568,793,70,7,63,192,108,98,69,141,75,30,21,9,10
S01008569,640,33,0,33,59,38,45,62,109,155,103,65,38,36
S01008570,961,40,4,36,117,78,99,104,196,210,86,52,34,31
S01008571,672,44,7,37,91,82,81,55,148,124,32,23,9,15
S01008572,817,75,10,65,146,80,96,85,133,143,27,21,6,32
S01008573,819,170,23,147,186,135,117,64,48,66,13,12,1,20
S01008574,727,172,28,144,189,96,100,67,48,36,5,2,3,14
S01008575,801,208,30,178,239,87,125,40,57,22,9,7,2,14
S01008576,820,135,10,125,198,104,122,43,101,71,10,7,3,36
S01008577,792,188,21,167,253,95,114,35,52,35,9,5,4,11
S01008578,741,321,54,267,209,55,93,10,23,2,5,5,0,23
S01008579,639,187,33,154,219,65,76,38,20,20,12,6,6,2
S01008580,542,118,14,104,110,84,43,42,60,47,13,3,10,25
S01008581,894,61,8,53,179,112,69,87,183,147,29,13,16,27
S01008582,1020,115,9,106,184,132,111,88,123,192,47,27,20,28
S01008583,713,87,8,79,110,80,61,67,114,107,22,16,6,65
S01008584,857,103,14,89,136,90,66,66,142,130,32,19,13,92
S01008585,598,45,5,40,123,77,33,68,110,96,29,26,3,17
S01008586,811,58,7,51,143,91,59,88,122,154,69,47,22,27
S01008587,754,268,40,228,199,70,76,36,35,13,26,25,1,31
S01008588,775,262,16,246,226,87,45,27,38,24,3,3,0,63
S01008589,390,102,10,92,112,70,35,15,31,7,10,8,2,8
S01008590,759,200,30,170,250,96,37,22,47,16,17,14,3,74
S01008591,807,243,12,231,238,52,66,39,54,23,14,9,5,78
S01008592,760,141,15,126,188,57,72,54,77,77,14,8,6,80
S01008593,776,349,48,301,237,43,99,12,7,10,1,1,0,18
S01008594,961,437,46,391,223,68,83,9,36,17,12,10,2,76
S01008595,842,94,13,81,164,108,37,77,110,152,53,45,8,47
S01008596,852,85,3,82,136,113,43,65,121,137,51,40,11,101
S01008597,880,172,30,142,250,152,99,53,81,54,5,2,3,14
S01008598,812,115,3,112,169,71,20,27,72,33,19,11,8,286
S01008599,896,307,54,253,234,37,47,39,38,11,4,4,0,179
S01008600,797,240,27,213,156,47,83,32,32,20,14,7,7,173
S01008601,752,106,11,95,117,37,30,30,64,28,11,11,0,329
S01008602,557,105,11,94,114,37,41,20,32,26,25,16,9,157
S01008603,1121,172,9,163,192,79,45,38,77,41,38,19,19,439
S01008604,863,254,29,225,197,50,81,26,37,20,3,1,2,195
S01008605,702,227,33,194,141,63,28,21,30,17,4,4,0,171
S01008606,763,303,41,262,223,47,62,29,30,17,1,1,0,51
S01008607,628,342,54,288,165,26,45,4,16,12,11,9,2,7
S01008608,706,278,12,266,236,50,48,26,18,8,2,2,0,40
S01008609,900,313,34,279,293,73,99,22,41,11,11,6,5,37
S01008610,848,240,27,213,252,89,70,39,26,18,5,5,0,109
S01008611,1111,244,9,235,226,112,47,42,44,34,14,9,5,348
S01008612,779,150,8,142,131,56,29,31,54,19,17,12,5,292
S01008613,798,244,20,224,186,43,16,19,45,28,22,17,5,195
S01008614,677,162,18,144,87,28,30,18,23,21,8,5,3,300
S01008615,846,199,8,191,148,37,37,19,23,20,7,7,0,356
S01008616,733,126,1,125,132,22,33,6,35,12,12,6,6,355
S01008617,829,131,11,120,145,22,50,18,16,11,3,3,0,433
S01008618,739,134,20,114,86,26,24,18,46,4,9,3,6,392
S01008619,520,100,4,96,118,24,34,11,31,2,7,6,1,193
S01008620,815,146,10,136,144,28,21,33,25,27,4,1,3,387
S01008621,770,136,6,130,109,37,46,8,30,16,13,6,7,375
S01008622,517,146,13,133,114,35,31,13,7,18,1,0,1,152
S01008623,869,255,31,224,198,41,57,6,21,23,3,2,1,265
S01008624,683,252,37,215,200,52,103,18,21,19,4,3,1,14
S01008625,566,303,64,239,160,19,51,0,6,8,10,3,7,9
S01008626,919,407,51,356,261,69,74,30,25,6,8,8,0,39
S01008627,695,277,46,231,277,29,51,13,16,13,4,4,0,15
S01008628,581,189,10,179,186,43,45,6,31,12,5,4,1,64
S01008629,571,154,19,135,183,72,19,10,38,25,11,5,6,59
S01008630,556,100,16,84,161,53,33,9,31,21,16,9,7,132
S01008631,786,230,18,212,229,71,37,25,49,32,21,7,14,92
S01008632,711,191,17,174,272,53,40,25,55,12,9,3,6,54
S01008633,928,361,84,277,270,84,76,21,23,15,19,15,4,59
S01008634,727,264,40,224,187,35,89,12,22,12,3,3,0,103
S01008635,824,292,19,273,215,50,76,23,16,14,11,9,2,127
S01008636,861,263,38,225,235,72,56,20,37,16,6,4,2,156
S01008637,679,241,33,208,188,68,57,16,20,10,2,2,0,77
S01008638,798,148,12,136,169,75,64,42,58,57,20,15,5,165
S01008639,866,259,15,244,232,82,49,44,48,29,8,7,1,115
S01008640,776,242,8,234,172,47,37,14,48,22,7,3,4,187
S01008641,825,171,14,157,198,61,27,32,45,18,4,4,0,269
S01008642,932,297,16,281,259,71,41,14,48,31,3,1,2,168
S01008643,702,211,17,194,242,45,42,35,26,8,7,5,2,86
S01008644,769,132,18,114,207,70,42,38,52,23,32,24,8,173
S01008645,825,144,25,119,220,74,36,41,64,47,4,1,3,195
S01008646,812,192,19,173,225,77,42,35,86,32,12,5,7,111
S01008647,589,156,13,143,145,41,33,30,51,32,7,2,5,94
S01008648,610,117,10,107,112,77,29,51,53,53,10,6,4,108
S01008649,841,148,15,133,232,110,12,59,87,72,9,4,5,112
S01008650,731,168,15,153,161,97,22,52,81,31,7,7,0,112
S01008651,686,140,10,130,138,70,36,35,63,58,42,33,9,104
S01008652,567,86,4,82,94,68,23,40,108,56,27,16,11,65
S01008653,684,101,3,98,139,54,13,60,102,66,29,16,13,120
S01008654,937,159,13,146,222,103,40,38,91,80,29,14,15,175
S01008655,796,171,9,162,180,102,36,37,49,43,17,16,1,161
S01008656,644,70,2,68,139,70,29,39,101,62,32,18,14,102
S01008657,664,100,16,84,159,84,33,41,51,54,45,38,7,97
S01008658,900,142,14,128,170,99,41,67,89,92,50,25,25,150
S01008659,825,91,9,82,131,57,37,73,78,63,23,16,7,272
S01008660,936,202,20,182,175,60,36,46,50,40,54,31,23,273
S01008661,754,83,5,78,120,112,46,59,91,62,27,10,17,154
S01008662,512,80,1,79,80,29,11,34,45,20,18,11,7,195
S01008663,829,78,4,74,157,81,48,32,56,73,24,11,13,280
S01008664,705,155,9,146,136,57,30,27,60,48,19,9,10,173
S01008665,941,164,14,150,235,76,51,64,81,77,37,23,14,156
S01008666,770,143,5,138,157,50,30,40,49,10,11,6,5,280
S01008667,725,135,19,116,148,52,40,35,45,46,17,8,9,207
S01008668,557,90,3,87,89,53,21,18,39,14,13,12,1,220
S01008669,578,28,0,28,59,25,20,10,57,9,13,13,0,357
S01008670,757,48,4,44,96,51,33,21,45,13,16,14,2,434
S01008671,751,72,1,71,78,41,21,27,37,29,9,7,2,437
S01008672,686,114,12,102,80,60,21,17,62,38,5,5,0,289
S01008673,1064,150,14,136,178,61,50,20,84,42,23,14,9,456
S01008674,784,82,0,82,131,53,36,15,61,45,21,11,10,340
S01008675,705,116,22,94,158,51,29,31,71,49,27,14,13,173
S01008676,690,119,8,111,200,63,48,29,42,22,13,10,3,154
S01008677,731,99,6,93,155,56,47,34,51,31,9,7,2,249
S01008678,721,81,16,65,90,46,34,19,42,33,25,18,7,351
S01008679,877,71,10,61,139,53,38,41,94,77,36,25,11,328
S01008680,597,63,6,57,78,53,14,23,50,52,30,17,13,234
S01008681,971,96,7,89,103,62,39,42,77,89,32,22,10,431
S01008682,783,125,11,114,135,47,39,40,93,63,27,19,8,214
S01008683,1074,71,6,65,148,81,44,79,171,151,111,68,43,218
S01008684,923,101,16,85,152,75,53,54,148,131,76,45,31,133
S01008685,777,102,9,93,146,92,49,45,99,71,30,11,19,143
S01008686,955,78,7,71,167,110,61,98,154,141,56,45,11,90
S01008687,648,112,18,94,162,80,30,28,66,60,20,13,7,90
S01008688,807,147,22,125,229,99,51,52,81,51,31,20,11,66
S01008689,860,103,15,88,244,99,43,83,107,96,24,14,10,61
S01008690,990,169,13,156,271,135,74,75,107,67,22,11,11,70
S01008691,1050,139,27,112,320,156,65,94,120,62,30,13,17,64
S01008692,627,71,11,60,163,93,35,58,75,58,22,11,11,52
S01008693,487,36,4,32,101,69,85,72,68,40,11,4,7,5
S01008694,1000,145,14,131,295,171,43,71,133,70,18,7,11,54
S01008695,703,128,11,117,253,106,55,25,54,31,25,13,12,26
S01008696,675,130,24,106,268,90,70,40,26,35,10,4,6,6
S01008697,1055,236,34,202,309,149,126,68,73,68,11,7,4,15
S01008698,492,71,12,59,141,83,80,38,63,11,1,1,0,4
S01008699,905,90,23,67,181,144,83,72,154,111,53,35,18,17
S01008700,569,152,53,99,177,78,71,22,19,24,10,9,1,16
S01008701,396,23,0,23,29,43,21,14,114,79,58,24,34,15
S01008702,584,65,12,53,100,81,38,39,89,53,52,28,24,67
S01008703,961,53,0,53,87,67,93,73,171,243,130,95,35,44
S01008704,700,39,15,24,109,85,49,74,148,124,52,34,18,20
S01008705,494,15,0,15,57,35,30,59,83,155,48,35,13,12
S01008706,577,25,3,22,69,62,27,26,141,133,57,30,27,37
S01008707,862,15,1,14,68,105,73,75,206,190,98,80,18,32
S01008708,859,26,0,26,71,78,40,90,201,191,109,67,42,53
S01008709,763,20,0,20,72,63,70,100,183,171,69,45,24,15
S01008710,494,22,0,22,60,39,29,60,116,87,47,20,27,34
S01008711,706,9,0,9,97,49,34,90,149,205,56,41,15,17
S01008712,1038,53,10,43,66,74,69,155,229,257,90,65,25,45
S01008713,635,14,3,11,41,70,43,65,180,119,84,49,35,19
S01008714,554,41,4,37,94,66,49,43,104,96,55,40,15,6
S01008715,763,35,8,27,112,99,45,89,126,214,34,27,7,9
S01008716,545,16,11,5,84,68,81,41,90,134,21,18,3,10
S01008717,440,12,0,12,69,76,59,29,109,61,16,6,10,9
S01008718,510,45,10,35,81,92,74,48,82,70,7,5,2,11
S01008719,1003,50,5,45,141,138,187,116,175,127,52,41,11,17
S01008720,508,38,1,37,68,63,60,51,91,75,32,22,10,30
S01008721,809,128,18,110,212,121,129,93,47,63,8,0,8,8
S01008722,1057,189,61,128,267,140,183,76,91,88,12,10,2,11
S01008723,625,131,23,108,154,116,95,58,37,30,4,4,0,0
S01008724,934,208,28,180,329,94,123,72,58,31,10,7,3,9
S01008725,749,160,21,139,240,89,89,39,50,54,19,9,10,9
S01008726,576,186,32,154,224,54,54,19,17,19,0,0,0,3
S01008727,1034,299,47,252,330,96,97,61,65,32,20,17,3,34
S01008728,552,66,6,60,128,60,49,47,100,52,44,32,12,6
S01008729,740,226,42,184,233,42,101,22,52,49,9,8,1,6
S01008730,794,147,23,124,244,95,86,47,59,52,50,25,25,14
S01008731,430,34,10,24,99,56,39,38,87,56,15,7,8,6
S01008732,610,35,7,28,120,103,72,55,104,65,44,22,22,12
S01008733,793,109,14,95,180,131,53,64,115,116,9,1,8,16
S01008734,564,104,10,94,194,65,58,25,50,34,25,14,11,9
S01008735,996,212,40,172,340,109,152,56,91,25,11,7,4,0
S01008736,734,119,37,82,218,69,134,69,62,40,11,8,3,12
S01008737,801,137,25,112,259,123,109,50,57,49,9,5,4,8
S01008738,754,177,34,143,211,107,122,60,38,28,11,11,0,0
S01008739,559,62,15,47,114,97,85,62,69,61,7,1,6,2
S01008740,553,43,13,30,153,115,64,60,66,36,11,7,4,5
S01008741,953,111,26,85,222,156,130,114,117,80,18,8,10,5
S01008742,484,45,3,42,125,85,62,30,75,48,10,9,1,4
S01008743,914,62,7,55,196,114,68,89,152,163,40,27,13,30
S01008744,1058,132,18,114,194,164,82,88,195,162,30,13,17,11
S01008745,466,94,6,88,123,80,32,26,51,36,12,9,3,12
S01008746,1062,65,11,54,173,137,73,101,190,195,79,55,24,49
S01008747,501,72,11,61,157,72,67,51,45,24,4,4,0,9
S01008748,667,122,11,111,169,111,88,53,68,49,3,3,0,4
S01008749,983,116,14,102,286,119,175,80,96,85,24,21,3,2
S01008750,703,110,22,88,187,99,112,52,84,42,13,1,12,4
S01008751,622,53,10,43,131,116,64,56,69,91,33,13,20,9
S01008752,787,19,5,14,119,138,30,81,166,142,71,46,25,21
S01008753,536,17,0,17,98,70,41,49,103,114,33,11,22,11
S01008754,590,41,2,39,115,93,54,49,102,108,13,9,4,15
S01008755,941,43,6,37,158,131,64,115,164,166,71,40,31,29
S01008756,708,35,4,31,100,84,41,74,165,138,37,18,19,34
S01008757,638,13,1,12,44,77,58,50,145,181,66,38,28,4
S01008758,823,27,9,18,102,113,78,78,171,186,48,34,14,20
S01008759,564,23,3,20,76,77,49,49,139,102,39,29,10,10
S01008760,941,44,12,32,108,100,57,95,208,231,82,53,29,16
S01008761,690,61,4,57,162,75,75,63,81,114,26,17,9,33
S01008762,608,71,10,61,164,95,57,53,63,85,13,12,1,7
S01008763,925,165,22,143,300,135,88,45,82,93,14,4,10,3
S01008764,714,157,30,127,236,76,71,40,61,55,7,4,3,11
S01008765,850,169,23,146,265,101,96,55,82,55,14,10,4,13
S01008766,1013,159,40,119,261,146,174,83,93,73,14,14,0,10
S01008767,542,52,13,39,146,103,53,48,53,72,4,1,3,11
S01008768,490,51,10,41,134,63,52,45,58,64,13,10,3,10
S01008769,666,175,23,152,240,81,38,36,33,17,18,8,10,28
S01008770,855,217,42,175,201,84,95,46,62,57,28,17,11,65
S01008771,778,181,18,163,203,71,67,40,118,40,22,17,5,36
S01008772,767,176,16,160,234,97,60,47,46,88,2,1,1,17
S01008773,1019,155,31,124,265,142,71,91,138,114,28,11,17,15
S01008774,897,75,8,67,193,114,73,87,109,147,63,29,34,36
S01008775,471,78,7,71,131,51,56,45,40,48,13,9,4,9
S01008776,799,78,7,71,185,112,42,54,134,106,55,39,16,33
S01008777,991,94,11,83,182,86,58,128,197,169,52,26,26,25
S01008778,1086,197,14,183,334,117,77,70,136,66,49,26,23,40
S01008779,718,177,30,147,249,76,58,47,45,24,8,0,8,34
S01008780,583,99,6,93,190,59,56,33,53,50,11,10,1,32
S01008781,891,133,17,116,213,83,44,100,124,108,45,23,22,41
S01008782,749,154,11,143,210,94,46,48,85,59,16,9,7,37
S01008783,417,82,9,73,136,44,22,27,45,31,20,15,5,10
S01008784,442,74,14,60,128,46,34,39,71,25,15,11,4,10
S01008785,867,66,10,56,129,82,56,97,145,156,84,67,17,52
S01008786,894,143,23,120,274,96,40,98,66,90,50,31,19,37
S01008787,374,12,0,12,28,28,17,31,83,95,58,40,18,22
S01008788,690,130,19,111,211,78,25,74,78,52,9,6,3,33
S01008789,654,53,5,48,107,99,54,80,85,141,22,20,2,13
S01008790,624,64,7,57,126,75,52,47,73,90,51,35,16,46
S01008791,877,119,9,110,158,98,77,106,99,124,42,25,17,54
S01008792,774,116,19,97,205,98,52,59,106,81,40,32,8,17
S01008793,427,24,1,23,81,55,29,47,65,73,27,19,8,26
S01008794,857,80,5,75,160,123,53,73,174,151,26,8,18,17
S01008795,1122,141,15,126,259,137,88,98,151,137,36,25,11,75
S01008796,1117,77,5,72,229,130,77,102,188,159,92,67,25,63
S01008797,947,92,7,85,246,112,49,69,167,107,30,21,9,75
S01008798,783,86,12,74,176,106,42,79,135,79,33,13,20,47
S01008799,665,54,0,54,125,67,48,77,104,80,51,32,19,59
S01008800,1035,116,14,102,303,100,79,101,132,123,15,6,9,66
S01008801,936,117,9,108,224,115,49,131,106,97,27,13,14,70
S01008802,958,102,8,94,211,88,65,93,146,129,34,16,18,90
S01008803,952,106,16,90,194,121,69,90,158,114,49,30,19,51
S01008804,535,49,12,37,109,69,28,55,54,75,29,24,5,67
S01008805,623,104,4,100,119,87,29,47,73,31,14,4,10,119
S01008806,1019,182,19,163,294,108,72,83,86,64,26,14,12,104
S01008807,792,111,14,97,217,104,44,82,82,80,19,13,6,53
S01008808,663,153,5,148,163,54,80,47,62,56,17,11,6,31
S01008809,636,163,38,125,165,31,87,23,47,18,25,10,15,77
S01008810,733,162,17,145,236,72,40,45,37,57,13,8,5,71
S01008811,829,159,27,132,223,68,54,57,60,66,18,9,9,124
S01008812,471,105,5,100,130,39,26,21,49,32,2,1,1,67
S01008813,955,98,9,89,228,116,86,94,152,81,60,42,18,40
S01008814,841,129,13,116,195,113,78,90,90,63,20,11,9,63
S01008815,908,106,12,94,257,107,41,72,93,124,46,27,19,62
S01008816,523,88,11,77,139,81,25,35,60,45,33,27,6,17
S01008817,764,112,14,98,156,97,43,90,101,99,46,28,18,20
S01008818,775,136,8,128,231,91,80,73,73,47,26,23,3,18
S01008819,705,153,14,139,257,69,56,33,50,55,7,4,3,25
S01008820,1113,114,9,105,337,131,62,79,147,136,69,33,36,38
S01008821,712,227,31,196,236,51,61,36,46,35,17,8,9,3
S01008822,726,242,42,200,265,43,82,16,46,17,7,2,5,8
S01008823,626,209,51,158,202,61,82,13,27,19,6,3,3,7
S01008824,961,264,45,219,351,111,55,53,74,35,16,9,7,2
S01008825,610,206,40,166,182,84,54,22,27,31,1,1,0,3
S01008826,650,153,22,131,169,74,60,54,64,41,21,14,7,14
S01008827,698,316,41,275,235,40,65,23,7,1,7,4,3,4
S01008828,882,226,40,186,308,94,94,41,64,23,17,10,7,15
S01008829,715,174,29,145,175,76,67,44,62,68,16,16,0,33
S01008830,689,223,34,189,243,82,56,16,36,11,3,0,3,19
S01008831,774,228,31,197,219,110,107,30,44,14,7,3,4,15
S01008832,697,227,60,167,192,63,107,32,37,15,8,3,5,16
S01008833,985,354,43,311,303,94,42,43,51,39,16,16,0,43
S01008834,1078,307,51,256,347,143,124,54,35,50,6,1,5,12
S01008835,813,173,49,124,242,129,51,84,61,56,5,5,0,12
S01008836,675,96,13,83,172,76,43,67,77,88,15,14,1,41
S01008837,1015,285,38,247,293,134,60,49,64,67,27,17,10,36
S01008838,1009,212,26,186,332,142,53,79,86,53,9,5,4,43
S01008839,1024,262,30,232,294,141,84,49,68,69,6,5,1,51
S01008840,1073,267,31,236,343,120,70,64,60,40,13,8,5,96
S01008841,568,108,7,101,150,78,66,32,62,34,7,7,0,31
S01008842,882,177,20,157,217,88,72,47,97,58,34,28,6,92
S01008843,881,235,21,214,240,84,79,46,86,34,14,11,3,63
S01008844,695,170,12,158,217,68,48,22,62,33,15,2,13,60
S01008845,851,227,21,206,220,45,41,25,49,26,11,6,5,207
S01008846,807,190,21,169,205,79,97,36,30,33,5,2,3,132
S01008847,573,173,27,146,139,37,43,23,26,11,1,1,0,120
S01008848,765,224,38,186,219,57,57,10,31,22,17,10,7,128
S01008849,727,233,27,206,216,35,60,19,38,19,3,3,0,104
S01008850,818,315,54,261,239,41,37,14,16,5,8,5,3,143
S01008851,1021,281,45,236,326,79,74,56,68,51,18,6,12,68
S01008852,992,393,79,314,318,44,77,15,28,11,7,5,2,99
S01008853,680,231,24,207,174,56,42,34,24,9,17,8,9,93
S01008854,908,278,51,227,277,55,61,14,20,17,11,6,5,175
S01008855,1056,350,48,302,381,71,70,28,44,10,16,10,6,86
S01008856,562,155,19,136,197,47,34,16,40,23,10,4,6,40
S01008857,764,247,26,221,237,66,52,38,54,24,11,4,7,35
S01008858,552,167,27,140,226,42,48,11,20,18,4,0,4,16
S01008859,1103,303,40,263,353,122,92,60,69,47,14,8,6,43
S01008860,882,229,11,218,271,101,72,33,72,34,13,7,6,57
S01008861,760,297,42,255,287,23,93,7,14,6,8,2,6,25
S01008862,877,307,44,263,255,89,66,37,31,31,15,11,4,46
S01008863,733,230,42,188,277,73,46,19,43,27,2,2,0,16
S01008864,721,235,21,214,290,79,34,20,32,18,2,1,1,11
S01008865,850,281,23,258,262,115,33,24,79,24,4,3,1,28
S01008866,798,304,37,267,275,75,60,12,36,21,6,1,5,9
S01008867,800,338,61,277,299,50,69,11,14,4,6,4,2,9
S01008868,726,206,32,174,224,51,41,45,30,14,8,3,5,107
S01008869,998,332,33,299,327,95,76,33,39,23,10,1,9,63
S01008870,757,288,54,234,255,44,68,24,29,11,12,5,7,26
S01008871,1031,327,63,264,339,62,61,21,46,20,14,9,5,141
S01008872,851,260,32,228,226,60,66,22,36,20,11,11,0,150
S01008873,688,251,55,196,237,59,75,2,19,19,6,2,4,20
S01008874,848,256,32,224,262,76,56,41,53,41,10,6,4,53
S01008875,820,159,27,132,231,117,56,86,81,34,9,6,3,47
S01008876,587,150,29,121,171,98,53,34,48,19,9,6,3,5
S01008877,548,165,32,133,178,69,47,27,33,21,3,0,3,5
S01008878,907,145,26,119,168,167,114,56,110,109,20,14,6,18
S01008879,817,153,19,134,201,133,67,40,88,96,30,12,18,9
S01008880,595,147,24,123,200,78,46,45,31,27,10,7,3,11
S01008881,520,197,51,146,162,56,54,8,10,6,20,12,8,7
S01008882,976,452,84,368,355,68,63,23,12,1,2,2,0,0
S01008883,869,405,104,301,259,63,94,9,13,7,10,8,2,9
S01008884,706,283,42,241,271,50,52,12,12,1,10,9,1,15
S01008885,888,398,70,328,256,75,93,15,34,7,9,7,2,1
S01008886,804,244,26,218,256,96,66,36,39,14,12,3,9,41
S01008887,766,192,22,170,261,93,70,37,51,39,8,8,0,15
S01008888,592,191,30,161,189,93,36,11,14,13,9,3,6,36
S01008889,542,118,32,86,165,61,78,36,30,35,12,7,5,7
S01008890,716,143,13,130,255,96,82,53,40,36,9,1,8,2
S01008891,763,202,45,157,245,110,89,44,44,23,2,1,1,4
S01008892,971,259,58,201,320,120,62,52,79,40,23,12,11,16
S01008893,899,309,36,273,347,70,95,19,26,15,7,4,3,11
S01008894,868,299,51,248,339,60,99,17,25,8,12,9,3,9
S01008895,715,252,43,209,239,69,86,27,25,8,3,3,0,6
S01008896,566,222,62,160,201,49,30,20,27,7,5,5,0,5
S01008897,689,251,31,220,163,91,80,31,38,8,18,17,1,9
S01008898,870,314,67,247,276,73,104,44,29,15,11,11,0,4
S01008899,843,32,3,29,92,78,64,89,192,221,50,28,22,25
S01008900,948,72,12,60,160,114,53,116,182,212,35,25,10,4
S01008901,846,57,14,43,147,91,79,79,134,191,43,21,22,25
S01008902,1012,60,17,43,163,141,70,114,189,189,60,45,15,26
S01008903,962,33,9,24,176,120,75,137,197,187,33,29,4,4
S01008904,1073,36,7,29,110,84,46,121,272,243,91,76,15,70
S01008905,1104,24,1,23,125,103,47,77,265,299,106,67,39,58
S01008906,813,18,5,13,89,86,60,80,202,169,73,38,35,36
S01008907,692,11,0,11,45,38,49,69,177,180,88,77,11,35
S01008908,929,77,9,68,126,107,72,109,130,183,90,72,18,35
S01008909,797,54,13,41,116,98,73,104,150,169,30,8,22,3
S01008910,476,44,7,37,80,48,46,52,67,104,21,21,0,14
S01008911,861,187,17,170,211,113,98,45,68,62,28,9,19,49
S01008912,792,159,21,138,226,110,93,62,65,64,11,6,5,2
S01008913,684,132,12,120,163,66,66,63,61,85,19,13,6,29
S01008914,868,87,16,71,166,140,85,77,113,175,18,15,3,7
S01008915,569,109,23,86,197,59,92,35,33,30,7,0,7,7
S01008916,1085,40,10,30,155,166,61,80,257,249,63,34,29,14
S01008917,681,19,3,16,75,101,49,78,149,147,50,32,18,13
S01008918,584,5,0,5,36,35,39,69,151,153,74,48,26,22
S01008919,544,21,0,21,48,55,25,72,81,129,89,57,32,24
S01008920,1075,214,22,192,315,148,79,56,93,66,31,21,10,73
S01008921,755,20,1,19,71,64,41,110,191,168,80,35,45,10
S01008922,785,32,10,22,122,100,63,89,176,135,54,32,22,14
S01008923,749,31,3,28,82,113,71,70,135,183,48,22,26,16
S01008924,982,31,15,16,87,110,60,122,249,218,75,39,36,30
S01008925,691,23,4,19,95,106,53,75,145,117,53,28,25,24
S01008926,607,48,4,44,113,101,58,57,80,119,25,16,9,6
S01008927,799,72,11,61,182,157,58,67,94,120,17,9,8,32
S01008928,609,62,13,49,103,63,57,72,97,107,21,9,12,27
S01008929,762,11,5,6,66,41,25,64,172,212,141,83,58,30
S01008930,913,15,0,15,83,87,46,95,184,284,103,52,51,16
S01008931,776,5,0,5,126,59,33,71,181,221,75,49,26,5
S01008932,885,75,5,70,178,109,91,104,141,116,34,19,15,37
S01008933,686,27,5,22,78,68,33,64,138,158,104,63,41,16
S01008934,792,85,16,69,122,70,71,67,139,152,66,49,17,20
S01008935,893,151,29,122,250,190,73,76,75,62,10,4,6,6
S01008936,397,124,27,97,138,25,50,29,15,9,3,3,0,4
S01008937,831,145,23,122,227,148,75,70,73,72,11,6,5,10
S01008938,750,195,16,179,213,77,113,53,42,41,12,3,9,4
S01008939,781,124,28,96,229,152,102,65,61,28,17,3,14,3
S01008940,636,223,40,183,246,49,71,12,8,16,7,6,1,4
S01008941,881,307,66,241,325,95,86,6,25,25,3,0,3,9
S01008942,727,224,34,190,222,103,71,42,36,14,12,5,7,3
S01008943,826,311,84,227,282,81,101,8,17,8,15,9,6,3
S01008944,1013,347,80,267,335,92,133,26,39,21,5,3,2,15
S01008945,782,260,43,217,274,76,118,16,16,8,9,4,5,5
S01008946,912,309,57,252,295,80,114,27,47,19,21,8,13,0
S01008947,1063,387,77,310,306,137,108,45,45,24,8,4,4,3
S01008948,699,195,39,156,206,78,80,56,35,39,5,2,3,5
S01008949,924,76,26,50,198,143,93,78,148,180,5,4,1,3
S01008950,935,101,18,83,197,133,110,72,154,134,20,15,5,14
S01008951,822,53,14,39,138,140,55,105,133,142,41,36,5,15
S01008952,803,41,10,31,87,106,62,66,193,178,54,35,19,16
S01008953,903,66,13,53,180,125,88,76,156,164,28,14,14,20
S01008954,839,73,15,58,159,108,81,78,147,141,40,23,17,12
S01008955,637,145,45,100,172,98,91,42,56,32,0,0,0,1
S01008956,878,148,35,113,220,165,75,70,104,77,6,2,4,13
S01008957,1010,171,49,122,254,130,82,86,142,87,33,17,16,25
S01008958,722,70,8,62,194,119,48,66,86,88,37,35,2,14
S01008959,859,105,14,91,185,173,82,72,107,112,17,17,0,6
S01008960,916,315,73,242,329,61,103,31,53,9,9,8,1,6
S01008961,715,137,27,110,222,102,68,47,75,36,18,13,5,10
S01008962,616,114,19,95,191,113,67,29,42,44,7,3,4,9
S01008963,783,164,33,131,283,105,76,68,50,28,5,4,1,4
S01008964,525,158,44,114,166,62,43,40,41,10,5,3,2,0
S01008965,742,195,26,169,261,89,99,40,36,14,5,5,0,3
S01008966,590,131,33,98,136,110,77,45,32,35,11,11,0,13
S01008967,1045,284,32,252,341,128,124,58,59,36,13,11,2,2
S01008968,997,297,61,236,309,147,115,54,43,23,5,3,2,4
S01008969,1088,247,36,211,290,180,89,89,99,72,16,13,3,6
S01008970,1014,288,40,248,406,124,81,32,50,23,8,7,1,2
S01008971,697,258,34,224,258,54,56,34,25,11,1,0,1,0
S01008972,765,341,55,286,241,71,60,19,20,7,3,1,2,3
S01008973,708,169,31,138,209,129,73,24,57,38,7,2,5,2
S01008974,803,145,36,109,252,122,33,50,91,67,28,22,6,15
S01008975,728,116,9,107,159,141,47,44,109,70,17,9,8,25
S01008976,525,169,19,150,154,63,62,13,25,20,1,0,1,18
S01008977,605,136,32,104,214,92,55,36,26,22,10,2,8,14
S01008978,580,50,9,41,157,93,55,41,101,69,8,2,6,6
S01008979,743,95,7,88,191,134,66,55,97,59,22,15,7,24
S01008980,834,80,6,74,195,151,68,93,101,82,45,21,24,19
S01008981,708,134,22,112,204,103,90,56,72,39,6,2,4,4
S01008982,789,62,15,47,129,189,72,99,110,54,42,27,15,32
S01008983,650,41,4,37,136,108,43,98,87,100,21,18,3,16
S01008984,518,55,8,47,94,108,26,52,76,80,26,20,6,1
S01008985,679,64,7,57,152,126,59,70,97,88,13,8,5,10
S01008986,802,81,10,71,209,138,97,88,112,61,13,5,8,3
S01008987,822,85,11,74,207,201,121,62,88,48,10,4,6,0
S01008988,941,134,16,118,219,178,88,93,121,69,20,13,7,19
S01008989,653,112,7,105,182,133,46,48,58,61,6,1,5,7
S01008990,737,113,5,108,208,157,63,63,46,75,4,0,4,8
S01008991,935,173,25,148,316,124,92,89,69,44,3,3,0,25
S01008992,562,76,10,66,149,77,35,63,83,51,15,9,6,13
S01008993,1068,238,80,158,300,141,138,86,80,53,18,9,9,14
S01008994,773,55,3,52,146,74,84,88,95,183,40,34,6,8
S01008995,861,240,45,195,303,79,75,42,71,36,14,8,6,1
S01008996,562,43,12,31,94,71,52,73,103,102,20,7,13,4
S01008997,984,189,35,154,226,118,130,83,105,101,22,7,15,10
S01008998,628,40,1,39,108,57,40,88,123,117,39,23,16,16
S01008999,854,109,16,93,207,114,72,67,106,159,20,12,8,0
S01009000,911,192,34,158,242,136,107,80,92,44,15,10,5,3
S01009001,880,223,40,183,254,131,84,79,65,41,0,0,0,3
S01009002,807,199,74,125,244,70,83,54,79,67,10,7,3,1
S01009003,960,253,22,231,389,73,86,47,62,29,4,4,0,17
S01009004,680,90,26,64,160,119,84,76,73,73,2,2,0,3
S01009005,730,92,13,79,181,120,68,115,78,57,11,3,8,8
S01009006,766,115,8,107,169,115,48,81,92,120,19,14,5,7
S01009007,701,43,4,39,159,130,35,89,114,106,15,6,9,10
S01009008,916,235,59,176,262,107,68,59,88,67,24,7,17,6
S01009009,476,17,3,14,74,76,40,60,94,89,22,14,8,4
S01009010,1021,198,51,147,333,139,64,89,99,85,10,3,7,4
S01009011,869,191,45,146,317,117,73,60,54,45,4,0,4,8
S01009012,752,132,9,123,250,128,91,49,49,41,0,0,0,12
S01009013,893,174,34,140,297,109,61,64,94,78,6,0,6,10
S01009014,609,32,26,6,103,59,143,86,102,75,8,2,6,1
S01009015,637,32,13,19,168,59,106,63,95,87,27,8,19,0
S01009016,528,26,10,16,133,51,86,68,67,80,17,11,6,0
S01009017,604,32,6,26,126,66,94,71,96,88,31,17,14,0
S01009018,743,53,7,46,174,64,102,93,91,131,11,6,5,24
S01009019,517,29,7,22,115,66,54,89,61,88,11,6,5,4
S01009020,807,58,10,48,201,94,92,88,119,120,34,14,20,1
S01009021,731,56,20,36,172,44,176,64,108,96,15,13,2,0
S01009022,873,59,13,46,221,54,153,82,130,143,26,10,16,5
S01009023,908,72,20,52,190,73,200,84,139,113,25,12,13,12
S01009024,959,63,11,52,212,77,180,107,144,150,24,20,4,2
S01009025,918,59,15,44,205,58,162,135,152,120,19,10,9,8
S01009026,892,84,15,69,195,60,122,79,125,183,24,11,13,20
S01009027,768,69,29,40,186,55,149,84,104,89,31,14,17,1
S01009028,494,27,0,27,105,44,118,80,56,60,4,2,2,0
S01009029,617,67,6,61,153,32,130,52,63,90,25,9,16,5
S01009030,733,28,5,23,146,54,146,73,105,160,15,4,11,6
S01009031,761,21,10,11,193,80,91,91,146,123,16,9,7,0
S01009032,656,53,13,40,128,52,90,69,118,125,14,8,6,7
S01009033,795,52,17,35,186,50,126,82,150,133,13,7,6,3
S01009034,709,83,31,52,160,70,69,85,87,145,9,4,5,1
S01009035,927,87,21,66,212,113,142,108,110,137,18,11,7,0
S01009036,1074,85,17,68,257,99,157,112,126,213,16,5,11,9
S01009037,893,76,20,56,205,124,119,104,98,151,12,4,8,4
S01009038,1081,92,25,67,273,99,142,128,116,203,25,7,18,3
S01009039,656,39,12,27,116,54,78,90,118,130,21,10,11,10
S01009040,620,32,3,29,129,70,79,57,98,122,25,18,7,8
S01009041,846,115,31,84,191,85,117,97,96,116,21,12,9,8
S01009042,808,79,14,65,178,76,61,86,133,155,29,9,20,11
S01009043,600,72,3,69,98,53,62,63,118,117,17,4,13,0
S01009044,801,71,21,50,193,91,86,76,133,128,21,12,9,2
S01009045,630,52,6,46,122,55,93,81,94,117,9,7,2,7
S01009046,868,69,9,60,247,52,109,97,119,163,9,3,6,3
S01009047,802,60,9,51,196,91,92,97,133,128,5,3,2,0
S01009048,837,84,36,48,230,82,68,96,140,122,5,2,3,10
S01009049,616,48,3,45,186,48,87,63,89,91,2,2,0,2
S01009050,775,78,15,63,168,114,62,95,99,134,21,19,2,4
S01009051,761,29,1,28,139,84,86,107,116,184,11,4,7,5
S01009052,598,29,20,9,140,88,82,69,80,100,6,2,4,4
S01009053,532,7,1,6,63,64,29,48,103,154,62,17,45,2
S01009054,583,22,5,17,116,53,55,87,80,153,14,7,7,3
S01009055,807,84,21,63,174,78,140,98,88,124,17,5,12,4
S01009056,554,24,12,12,55,49,76,59,104,152,22,7,15,13
S01009057,554,23,2,21,80,47,41,46,130,138,43,18,25,6
S01009058,786,37,2,35,148,101,40,110,128,191,19,7,12,12
S01009059,881,133,34,99,198,94,93,103,101,115,42,23,19,2
S01009060,560,87,19,68,180,50,107,53,24,56,0,0,0,3
S01009061,810,46,10,36,152,104,46,92,143,194,27,11,16,6
S01009062,647,16,7,9,72,128,44,94,115,141,26,16,10,11
S01009063,733,85,16,69,168,98,76,89,80,135,0,0,0,2
S01009064,583,35,2,33,103,78,26,58,93,148,31,11,20,11
S01009065,686,31,3,28,79,83,55,80,130,162,56,27,29,10
S01009066,693,32,10,22,112,61,56,86,119,197,29,13,16,1
S01009067,863,114,44,70,228,113,133,106,75,80,14,11,3,0
S01009068,895,58,14,44,155,163,71,131,111,167,32,14,18,7
S01009069,631,74,10,64,211,72,74,85,54,59,1,0,1,1
S01009070,627,55,13,42,141,99,74,78,73,85,13,9,4,9
S01009071,508,49,16,33,122,57,94,54,31,64,24,16,8,13
S01009072,528,50,13,37,129,42,91,61,58,82,4,2,2,11
S01009073,585,22,14,8,75,43,62,77,133,136,31,10,21,6
S01009074,721,24,6,18,85,70,64,100,106,194,59,35,24,19
S01009075,536,26,7,19,71,60,57,74,94,133,18,7,11,3
S01009076,918,101,25,76,209,174,107,92,83,138,6,2,4,8
S01009077,626,55,18,37,166,70,53,86,81,88,24,21,3,3
S01009078,821,175,25,150,304,106,67,53,54,50,7,5,2,5
S01009079,837,31,10,21,101,100,59,108,167,240,29,14,15,2
S01009080,934,37,9,28,139,103,101,159,156,195,33,19,14,11
S01009081,654,40,22,18,166,70,78,78,89,122,8,8,0,3
S01009082,974,54,20,34,147,141,128,118,151,181,39,17,22,15
S01009083,774,43,11,32,163,93,43,106,116,170,28,21,7,12
S01009084,490,44,17,27,138,29,101,41,57,65,13,13,0,2
S01009085,834,106,26,80,243,136,69,98,53,111,14,4,10,4
S01009086,715,26,7,19,153,101,66,109,95,134,23,12,11,8
S01009087,571,39,6,33,86,42,42,57,159,125,18,10,8,3
S01009088,1012,146,36,110,296,115,124,111,97,107,16,11,5,0
S01009089,977,237,68,169,325,95,127,98,51,36,4,1,3,4
S01009090,764,188,29,159,272,103,77,32,49,29,2,2,0,12
S01009091,711,216,41,175,276,48,62,58,27,16,3,0,3,5
S01009092,1047,130,45,85,270,135,87,129,140,135,15,3,12,6
S01009093,775,21,2,19,164,95,59,99,134,167,25,5,20,11
S01009094,682,121,24,97,295,81,33,70,45,31,6,5,1,0
S01009095,763,116,15,101,220,93,101,69,86,66,12,11,1,0
S01009096,942,187,43,144,311,118,99,68,88,57,10,10,0,4
S01009097,900,151,37,114,344,109,68,108,71,48,1,0,1,0
S01009098,509,102,27,75,206,57,37,52,18,21,16,0,16,0
S01009099,755,58,13,45,179,81,53,98,106,138,38,35,3,4
S01009100,745,40,21,19,140,84,73,88,136,145,26,20,6,13
S01009101,935,33,14,19,143,101,74,125,211,216,26,9,17,6
S01009102,819,21,8,13,89,101,49,118,179,192,55,25,30,15
S01009103,570,77,15,62,180,77,38,66,65,48,15,9,6,4
S01009104,775,32,12,20,175,108,44,111,149,129,13,5,8,14
S01009105,796,70,26,44,248,112,82,93,75,91,16,11,5,9
S01009106,551,25,4,21,102,95,37,61,96,113,19,6,13,3
S01009107,845,145,37,108,227,118,37,104,98,94,18,15,3,4
S01009108,714,89,24,65,202,99,70,112,75,63,1,1,0,3
S01009109,670,92,18,74,217,83,56,77,76,59,1,1,0,9
S01009110,607,37,0,37,129,94,60,91,74,109,9,6,3,4
S01009111,848,97,28,69,225,146,84,93,76,115,4,3,1,8
S01009112,560,95,27,68,198,62,52,67,55,31,0,0,0,0
S01009113,852,115,29,86,284,102,102,107,60,77,4,3,1,1
S01009114,786,90,31,59,192,70,71,104,99,148,12,5,7,0
S01009115,582,54,7,47,183,67,44,82,70,67,5,2,3,10
S01009116,464,60,18,42,140,62,29,76,64,27,6,3,3,0
S01009117,857,67,10,57,177,123,55,123,112,152,43,15,28,5
S01009118,632,81,15,66,172,84,51,120,43,66,11,7,4,4
S01009119,752,27,0,27,88,70,64,137,137,180,46,26,20,3
S01009120,530,32,4,28,90,39,34,64,118,122,20,7,13,11
S01009121,811,38,1,37,132,79,48,119,151,209,25,6,19,10
S01009122,919,103,21,82,226,83,120,101,114,125,34,9,25,13
S01009123,574,106,32,74,180,60,42,54,36,88,6,3,3,2
S01009124,584,60,10,50,160,67,67,64,70,96,0,0,0,0
S01009125,659,44,12,32,142,50,54,97,98,148,25,13,12,1
S01009126,579,7,1,6,68,35,28,67,141,157,68,41,27,8
S01009127,626,17,4,13,88,61,40,90,136,120,57,11,46,17
S01009128,806,21,4,17,88,78,41,100,153,218,102,65,37,5
S01009129,486,6,4,2,59,51,16,52,138,133,31,18,13,0
S01009130,661,52,16,36,145,65,62,69,96,126,42,26,16,4
S01009131,482,14,2,12,66,61,26,63,97,121,27,17,10,7
S01009132,822,139,39,100,247,104,45,87,95,71,22,8,14,12
S01009133,567,11,6,5,74,48,42,83,112,167,29,13,16,1
S01009134,920,103,48,55,201,136,64,123,127,143,13,1,12,10
S01009135,565,61,5,56,157,72,45,88,53,60,26,18,8,3
S01009136,691,81,12,69,228,95,78,58,64,68,11,6,5,8
S01009137,616,126,44,82,249,62,57,54,45,20,1,1,0,2
S01009138,861,124,35,89,283,89,107,86,66,76,10,5,5,20
S01009139,406,23,0,23,70,55,23,30,77,72,43,17,26,13
S01009140,700,56,13,43,120,74,43,124,97,141,23,16,7,22
S01009141,780,47,9,38,128,94,54,120,137,146,47,23,24,7
S01009142,600,27,3,24,141,69,42,59,99,124,30,9,21,9
S01009143,600,16,5,11,88,58,45,60,120,163,38,23,15,12
S01009144,668,101,15,86,168,98,64,71,62,77,3,1,2,24
S01009145,1056,34,17,17,191,109,76,154,211,226,45,29,16,10
S01009146,904,26,3,23,177,83,67,93,167,204,61,28,33,26
S01009147,832,43,2,41,94,88,68,98,175,213,45,27,18,8
S01009148,694,21,19,2,87,42,37,125,132,196,43,13,30,11
S01009149,799,83,11,72,212,124,82,128,82,75,9,6,3,4
S01009150,747,27,4,23,85,105,46,94,163,203,24,18,6,0
S01009151,890,108,23,85,230,105,88,86,130,121,15,11,4,7
S01009152,667,49,6,43,111,121,46,80,97,123,27,14,13,13
S01009153,472,53,2,51,124,68,49,45,55,53,12,4,8,13
S01009154,899,173,39,134,262,104,145,55,81,53,18,13,5,8
S01009155,550,154,28,126,180,39,54,42,48,28,2,0,2,3
S01009156,548,132,15,117,170,63,87,34,20,36,6,3,3,0
S01009157,838,70,13,57,146,85,97,137,144,151,5,2,3,3
S01009158,558,19,2,17,141,83,24,69,109,89,19,9,10,5
S01009159,511,8,0,8,40,47,43,67,118,128,51,32,19,9
S01009160,618,31,9,22,75,74,55,104,124,122,25,6,19,8
S01009161,647,8,1,7,61,73,34,94,146,180,46,10,36,5
S01009162,709,26,5,21,125,88,33,90,123,168,48,29,19,8
S01009163,465,45,9,36,111,47,22,70,82,66,20,12,8,2
S01009164,750,28,12,16,84,86,51,131,155,193,16,2,14,6
S01009165,720,25,2,23,123,61,51,113,126,160,56,29,27,5
S01009166,839,30,10,20,102,78,38,94,180,240,64,36,28,13
S01009167,548,14,5,9,58,61,59,65,106,131,38,20,18,16
S01009168,634,119,42,77,181,80,46,76,73,50,8,1,7,1
S01009169,746,33,15,18,113,90,53,155,140,134,23,14,9,5
S01009170,677,28,2,26,93,99,51,82,125,137,51,14,37,11
S01009171,664,39,11,28,124,61,65,102,98,119,49,13,36,7
S01009172,656,224,47,177,229,55,56,36,23,26,5,4,1,2
S01009173,768,184,48,136,216,82,75,107,38,56,2,1,1,8
S01009174,487,111,35,76,170,60,52,41,24,28,0,0,0,1
S01009175,848,208,50,158,286,99,89,91,22,43,6,0,6,4
S01009176,984,261,65,196,316,107,100,94,67,21,18,6,12,0
S01009177,817,28,8,20,124,120,99,118,120,144,44,24,20,20
S01009178,743,28,13,15,106,87,58,101,131,163,49,21,28,20
S01009179,683,32,2,30,147,92,49,59,152,120,22,3,19,10
S01009180,984,33,10,23,139,102,82,190,206,198,30,19,11,4
S01009181,855,32,16,16,108,77,98,114,172,210,29,21,8,15
S01009182,1002,84,12,72,259,110,144,112,134,138,19,3,16,2
S01009183,737,80,16,64,262,97,76,96,60,57,4,0,4,5
S01009184,858,82,38,44,105,67,149,112,131,153,51,18,33,8
S01009185,888,63,10,53,128,82,118,120,175,159,40,25,15,3
S01009186,810,67,12,55,147,65,113,96,144,144,27,8,19,7
S01009187,512,87,20,67,145,38,84,49,48,57,4,4,0,0
S01009188,890,71,11,60,168,55,121,115,153,157,43,26,17,7
S01009189,776,41,5,36,105,46,62,101,164,203,53,35,18,1
S01009190,796,145,28,117,217,102,104,103,74,45,5,2,3,1
S01009191,746,178,50,128,267,84,67,69,38,33,5,2,3,5
S01009192,625,56,19,37,191,97,65,56,62,85,13,0,13,0
S01009193,309,39,15,24,124,32,17,47,18,29,3,3,0,0
S01009194,788,130,33,97,274,108,81,89,57,44,5,0,5,0
S01009195,860,168,35,133,322,98,49,86,65,58,10,3,7,4
S01009196,693,65,7,58,144,92,95,88,76,102,16,12,4,15
S01009197,1027,193,26,167,389,111,92,81,67,81,6,2,4,7
S01009198,730,101,15,86,232,84,75,96,61,65,12,3,9,4
S01009199,616,95,20,75,207,67,58,57,67,49,15,10,5,1
S01009200,1121,249,61,188,332,104,80,134,92,115,9,5,4,6
S01009201,630,27,6,21,126,53,54,85,119,133,25,2,23,8
S01009202,525,78,16,62,205,49,47,51,51,41,1,1,0,2
S01009203,633,15,1,14,80,50,69,92,118,153,51,22,29,5
S01009204,895,81,20,61,205,98,92,83,150,152,21,13,8,13
S01009205,702,104,31,73,215,109,53,77,49,92,2,1,1,1
S01009206,807,137,38,99,260,124,44,84,94,49,13,7,6,2
S01009207,760,118,23,95,252,106,40,111,79,49,2,1,1,3
S01009208,631,85,22,63,193,95,54,66,72,50,8,3,5,8
S01009209,597,96,25,71,222,73,41,46,58,55,1,0,1,5
S01009210,569,94,13,81,193,80,57,47,45,43,10,3,7,0
S01009211,628,51,12,39,119,73,68,97,96,101,16,7,9,7
S01009212,829,47,24,23,115,93,63,107,177,194,25,15,10,8
S01009213,836,32,12,20,137,71,79,128,146,199,33,20,13,11
S01009214,972,130,24,106,294,135,65,94,123,113,12,4,8,6
S01009215,926,54,9,45,178,79,81,109,177,185,46,21,25,17
S01009216,886,35,11,24,142,102,69,142,154,195,37,34,3,10
S01009217,623,18,0,18,89,61,58,70,141,135,42,27,15,9
S01009218,821,79,32,47,178,115,75,116,103,141,9,4,5,5
S01009219,630,21,8,13,97,67,46,94,114,152,34,12,22,5
S01009220,550,30,6,24,76,75,40,69,96,124,30,12,18,10
S01009221,574,13,4,9,75,68,33,90,89,171,35,16,19,0
S01009222,538,15,2,13,35,38,32,83,124,171,29,7,22,11
S01009223,556,23,2,21,79,70,39,85,105,139,12,9,3,4
S01009224,627,21,8,13,64,74,39,90,107,192,37,16,21,3
S01009225,536,14,4,10,64,52,22,92,111,167,9,3,6,5
S01009226,909,25,9,16,183,94,44,111,153,252,41,21,20,6
S01009227,589,19,10,9,109,83,36,102,109,114,12,3,9,5
S01009228,602,24,2,22,79,48,33,78,102,179,53,13,40,6
S01009229,579,34,4,30,157,48,57,92,81,84,13,11,2,13
S01009230,558,31,7,24,121,107,52,66,71,98,8,5,3,4
S01009231,958,81,19,62,236,111,81,172,99,146,26,3,23,6
S01009232,581,16,5,11,78,77,10,65,106,136,72,32,40,21
S01009233,567,27,4,23,91,42,35,100,95,160,16,6,10,1
S01009234,1021,26,5,21,80,101,40,162,235,260,85,47,38,32
S01009235,921,34,6,28,147,109,46,135,144,212,77,21,56,17
S01009236,483,38,10,28,120,78,39,92,44,64,8,2,6,0
S01009237,847,74,30,44,266,128,89,154,83,44,7,4,3,2
S01009238,726,18,0,18,121,100,32,118,113,193,31,7,24,0
S01009239,866,23,11,12,154,111,33,180,141,173,38,15,23,13
S01009240,672,12,8,4,56,69,26,99,150,168,67,29,38,25
S01009241,895,29,8,21,112,88,45,102,171,270,64,25,39,14
S01009242,725,70,26,44,185,66,59,145,113,76,11,2,9,0
S01009243,1003,64,13,51,171,113,92,188,189,151,24,8,16,11
S01009244,809,108,32,76,233,80,84,122,98,76,1,1,0,7
S01009245,830,84,23,61,235,124,70,102,113,90,12,9,3,0
S01009246,803,35,14,21,109,85,69,139,172,160,30,15,15,4
S01009247,1010,55,20,35,162,86,43,191,185,239,43,6,37,6
S01009248,688,49,17,32,177,70,80,114,103,82,8,5,3,5
S01009249,810,40,16,24,95,88,84,112,146,206,36,19,17,3
S01009250,638,40,9,31,93,56,50,81,129,172,17,7,10,0
S01009251,553,62,6,56,142,48,49,76,70,78,24,5,19,4
S01009252,478,84,19,65,179,51,37,62,32,29,4,1,3,0
S01009253,476,9,2,7,62,52,42,97,86,109,14,6,8,5
S01009254,822,23,2,21,86,57,53,113,176,221,78,39,39,15
S01009255,633,57,26,31,98,64,39,80,126,129,33,10,23,7
S01009256,478,55,22,33,135,62,29,65,57,64,7,4,3,4
S01009257,640,91,25,66,118,82,63,54,116,91,19,9,10,6
S01009258,633,115,21,94,160,60,99,49,62,78,10,5,5,0
S01009259,942,175,54,121,291,83,111,89,78,101,6,4,2,8
S01009260,1121,90,25,65,235,162,108,103,197,176,38,23,15,12
S01009261,738,61,13,48,104,70,52,92,145,172,32,9,23,10
S01009262,604,24,5,19,65,57,31,82,137,157,40,16,24,11
S01009263,817,153,17,136,265,72,77,86,84,63,12,6,6,5
S01009264,517,60,17,43,143,47,69,84,63,45,3,3,0,3
S01009265,791,43,11,32,173,76,30,139,153,125,39,8,31,13
S01009266,853,54,18,36,145,85,70,151,160,162,26,20,6,0
S01009267,790,81,6,75,161,79,70,124,143,104,20,11,9,8
S01009268,1002,68,22,46,221,77,71,135,147,221,42,12,30,20
S01009269,892,28,8,20,108,134,37,102,168,240,64,28,36,11
S01009270,595,15,8,7,51,59,41,69,143,168,43,23,20,6
S01009271,885,75,17,58,284,128,91,104,68,127,8,3,5,0
S01009272,704,10,0,10,91,60,44,96,154,201,34,20,14,14
S01009273,466,113,43,70,134,65,44,51,29,26,1,1,0,3
S01009274,631,76,9,67,147,66,70,87,92,78,9,4,5,6
S01009275,579,85,32,53,125,62,125,51,49,70,11,6,5,1
S01009276,889,147,43,104,241,90,90,110,107,82,21,9,12,1
S01009277,527,112,25,87,133,68,131,27,24,14,11,1,10,7
S01009278,559,117,18,99,203,66,34,37,37,59,5,5,0,1
S01009279,584,69,23,46,134,48,85,67,57,103,19,12,7,2
S01009280,898,11,0,11,79,76,35,111,195,281,99,59,40,11
S01009281,826,52,16,36,102,78,30,114,144,252,48,24,24,6
S01009282,737,121,24,97,208,65,105,73,79,56,26,18,8,4
S01009283,444,81,28,53,108,58,40,44,49,55,9,2,7,0
S01009284,822,160,48,112,250,122,101,62,65,52,3,3,0,7
S01009285,906,77,14,63,233,181,67,119,113,95,13,6,7,8
S01009286,737,110,33,77,262,82,81,72,71,48,6,3,3,5
S01009287,754,173,31,142,267,92,93,24,51,52,1,1,0,1
S01009288,829,199,61,138,266,60,108,61,52,55,14,12,2,14
S01009289,871,187,45,142,242,105,108,79,68,62,14,4,10,6
S01009290,646,156,43,113,203,89,63,52,44,29,3,3,0,7
S01009291,979,145,32,113,291,166,99,112,74,86,0,0,0,6
S01009292,511,17,0,17,89,45,39,80,83,134,10,2,8,14
S01009293,723,87,25,62,205,81,87,57,91,94,10,2,8,11
S01009294,506,94,18,76,186,55,50,58,32,27,4,0,4,0
S01009295,611,105,22,83,137,84,63,94,59,69,0,0,0,0
S01009296,506,60,21,39,141,54,67,88,39,50,5,3,2,2
S01009297,826,201,51,150,308,99,51,49,49,51,10,4,6,8
S01009298,971,64,7,57,178,100,65,116,192,185,64,37,27,7
S01009299,972,155,25,130,269,141,101,79,105,94,16,11,5,12
S01009300,510,68,6,62,127,69,34,60,56,50,36,20,16,10
S01009301,921,85,11,74,161,126,62,98,138,140,94,39,55,17
S01009302,845,35,5,30,125,79,41,52,220,217,62,35,27,14
S01009303,717,140,41,99,276,63,41,60,68,51,18,7,11,0
S01009304,964,104,30,74,225,148,99,120,121,113,24,10,14,10
S01009305,736,79,13,66,200,114,44,69,118,90,19,7,12,3
S01009306,1094,128,23,105,276,139,66,110,159,136,61,34,27,19
S01009307,979,145,27,118,292,125,81,100,100,78,32,13,19,26
S01009308,513,94,19,75,127,73,54,32,49,50,21,9,12,13
S01009309,726,144,26,118,207,90,60,60,79,46,34,9,25,6
S01009310,891,204,42,162,251,108,74,90,80,65,14,8,6,5
S01009311,753,24,0,24,140,76,44,116,131,170,50,29,21,2
S01009312,650,85,20,65,210,92,34,41,69,79,31,12,19,9
S01009313,542,7,1,6,119,75,30,72,88,116,30,23,7,5
S01009314,650,125,26,99,149,101,40,62,76,86,8,7,1,3
S01009315,616,37,11,26,108,86,64,80,66,136,36,22,14,3
S01009316,749,229,43,186,231,88,48,67,45,30,11,1,10,0
S01009317,847,149,34,115,300,114,80,86,68,39,2,1,1,9
S01009318,619,162,29,133,246,84,33,28,50,12,0,0,0,4
S01009319,903,190,38,152,302,119,70,79,79,62,2,2,0,0
S01009320,704,102,11,91,185,87,52,62,95,95,16,15,1,10
S01009321,676,131,33,98,208,83,56,64,67,59,0,0,0,8
S01009322,798,95,26,69,194,135,82,74,70,118,19,11,8,11
S01009323,622,31,3,28,157,73,67,52,104,104,23,12,11,11
S01009324,528,28,3,25,102,66,45,48,96,114,23,10,13,6
S01009325,730,137,24,113,242,92,65,79,49,56,8,6,2,2
S01009326,602,103,23,80,213,59,16,48,62,68,23,13,10,10
S01009327,579,99,18,81,159,87,46,45,59,68,9,3,6,7
S01009328,683,172,20,152,259,81,49,57,30,31,0,0,0,4
S01009329,442,55,4,51,165,82,32,47,26,19,13,4,9,3
S01009330,503,43,11,32,166,73,23,38,86,52,19,12,7,3
S01009331,573,170,17,153,184,86,38,39,26,30,0,0,0,0
S01009332,867,174,39,135,315,135,71,60,52,49,4,1,3,7
S01009333,738,39,10,29,129,142,55,80,113,139,24,17,7,17
S01009334,636,27,8,19,101,105,24,54,110,150,51,16,35,14
S01009335,772,30,6,24,119,87,36,103,129,219,40,18,22,9
S01009336,655,10,0,10,100,74,40,105,119,103,80,30,50,24
S01009337,743,27,1,26,125,90,44,93,132,150,70,32,38,12
S01009338,725,35,9,26,105,71,32,68,169,180,58,25,33,7
S01009339,853,10,7,3,123,82,37,154,177,173,90,28,62,7
S01009340,596,8,0,8,66,65,32,59,142,194,24,12,12,6
S01009341,583,26,9,17,68,82,51,88,101,126,37,11,26,4
S01009342,742,44,7,37,123,121,33,100,94,181,45,12,33,1
S01009343,574,27,3,24,141,74,24,57,133,97,12,9,3,9
S01009344,630,17,2,15,85,92,35,80,143,145,30,21,9,3
S01009345,942,40,1,39,229,113,63,119,179,161,29,10,19,9
S01009346,719,173,32,141,297,57,101,31,30,23,7,3,4,0
S01009347,691,239,57,182,257,47,72,36,19,12,6,0,6,3
S01009348,510,132,23,109,179,57,41,34,34,28,0,0,0,5
S01009349,830,192,26,166,297,117,49,55,36,67,9,1,8,8
S01009350,622,85,8,77,209,96,46,56,46,57,20,8,12,7
S01009351,527,114,29,85,189,67,35,38,36,35,2,2,0,11
S01009352,797,171,28,143,372,76,39,51,45,30,11,0,11,2
S01009353,403,74,13,61,148,45,48,42,20,14,7,0,7,5
S01009354,925,191,40,151,362,109,90,67,48,54,0,0,0,4
S01009355,866,128,28,100,215,139,82,138,97,60,2,2,0,5
S01009356,963,124,30,94,321,153,74,108,65,106,8,4,4,4
S01009357,485,139,35,104,142,60,39,42,31,24,2,0,2,6
S01009358,725,278,69,209,253,65,51,44,16,18,0,0,0,0
S01009359,774,170,25,145,278,101,81,35,67,26,9,0,9,7
S01009360,835,151,43,108,235,122,59,91,87,76,5,4,1,9
S01009361,768,98,11,87,201,104,60,81,116,85,16,16,0,7
S01009362,1015,149,28,121,317,169,69,132,106,72,1,1,0,0
S01009363,833,52,15,37,145,121,50,144,147,142,26,12,14,6
S01009364,860,62,8,54,204,142,62,127,129,112,16,6,10,6
S01009365,565,35,3,32,126,102,34,69,69,109,16,11,5,5
S01009366,758,29,7,22,125,87,81,89,147,152,39,17,22,9
S01009367,628,34,5,29,122,83,37,98,113,115,17,4,13,9
S01009368,581,24,0,24,80,98,41,54,120,115,25,6,19,24
S01009369,598,30,0,30,117,86,39,89,92,116,22,16,6,7
S01009370,828,65,13,52,168,122,46,94,151,147,26,20,6,9
S01009371,526,34,9,25,116,61,16,65,102,102,22,13,9,8
S01009372,521,30,3,27,82,74,45,74,122,79,14,9,5,1
S01009373,799,29,2,27,141,110,38,100,188,143,45,24,21,5
S01009374,846,74,18,56,116,129,35,124,151,172,31,18,13,14
S01009375,797,33,8,25,142,70,27,120,184,170,38,10,28,13
S01009376,577,27,9,18,76,97,19,75,104,155,20,12,8,4
S01009377,971,76,6,70,291,127,48,121,153,111,41,9,32,3
S01009378,994,40,4,36,199,144,101,86,190,170,30,9,21,34
S01009379,981,150,25,125,261,154,73,119,97,75,31,9,22,21
S01009380,554,50,37,13,146,73,30,62,71,95,6,0,6,21
S01009381,632,104,28,76,165,102,65,56,59,59,14,4,10,8
S01009382,782,60,20,40,148,86,62,83,139,176,19,10,9,9
S01009383,811,47,3,44,157,105,65,84,150,138,49,17,32,16
S01009384,560,141,32,109,211,58,57,41,28,11,13,7,6,0
S01009385,512,96,17,79,134,67,51,61,50,36,17,11,6,0
S01009386,670,30,10,20,125,80,43,96,134,127,26,9,17,9
S01009387,604,54,11,43,91,82,41,69,115,118,28,8,20,6
S01009388,929,35,8,27,139,114,41,102,190,193,90,34,56,25
S01009389,902,129,24,105,245,118,94,96,95,90,25,9,16,10
S01009390,777,225,54,171,308,63,57,46,33,41,0,0,0,4
S01009391,695,127,35,92,260,116,57,48,50,36,0,0,0,1
S01009392,581,143,23,120,194,86,51,40,33,31,0,0,0,3
S01009393,686,120,12,108,244,101,90,43,42,39,7,3,4,0
S01009394,891,236,30,206,274,97,67,75,68,48,12,1,11,14
S01009395,677,194,42,152,216,78,52,46,40,44,7,3,4,0
S01009396,736,220,59,161,268,82,63,39,31,27,4,2,2,2
S01009397,703,164,37,127,197,93,77,54,75,32,9,2,7,2
S01009398,688,91,21,70,202,107,72,84,83,41,4,1,3,4
S01009399,705,114,29,85,216,92,38,59,93,65,18,4,14,10
S01009400,519,42,22,20,114,94,45,68,74,70,9,3,6,3
S01009401,681,163,40,123,186,112,44,87,54,31,1,0,1,3
S01009402,944,164,27,137,384,96,92,82,74,43,9,7,2,0
S01009403,539,83,21,62,173,96,36,61,52,33,4,4,0,1
S01009404,546,32,11,21,88,45,57,85,68,120,37,24,13,14
S01009405,401,36,13,23,118,43,71,63,34,34,2,0,2,0
S01009406,904,64,16,48,177,115,100,91,147,171,24,14,10,15
S01009407,502,37,7,30,138,40,74,53,62,96,2,0,2,0
S01009408,739,94,23,71,214,102,78,92,64,81,7,0,7,7
S01009409,665,34,9,25,90,63,50,106,123,156,37,16,21,6
S01009410,877,27,19,8,129,82,65,107,209,205,48,37,11,5
S01009411,875,22,6,16,117,77,92,126,158,233,46,17,29,4
S01009412,848,24,12,12,94,83,63,132,174,239,39,24,15,0
S01009413,988,51,13,38,177,93,103,154,140,235,26,10,16,9
S01009414,682,31,12,19,134,83,44,78,113,164,21,8,13,14
S01009415,791,52,22,30,114,103,80,105,108,163,63,41,22,3
S01009416,528,54,15,39,139,87,63,69,63,49,4,0,4,0
S01009417,304,23,4,19,77,32,75,29,29,31,2,1,1,6
S01009418,1078,53,8,45,148,89,64,171,185,308,49,24,25,11
S01009419,574,21,10,11,77,75,31,79,119,150,17,13,4,5
S01009420,632,7,1,6,80,33,20,55,155,232,38,19,19,12
S01009421,722,28,8,20,85,65,51,111,124,200,50,21,29,8
S01009422,810,43,10,33,126,94,47,117,133,203,35,20,15,12
S01009423,932,135,18,117,302,115,83,109,60,109,9,0,9,10
S01009424,551,79,23,56,119,70,39,52,73,96,15,10,5,8
S01009425,739,44,12,32,152,84,61,94,113,137,43,18,25,11
S01009426,776,22,7,15,103,100,46,90,148,198,59,31,28,10
S01009427,608,29,10,19,68,77,44,63,116,147,58,36,22,6
S01009428,588,21,0,21,100,58,54,72,78,148,47,24,23,10
S01009429,704,20,5,15,92,64,26,107,132,210,45,35,10,8
S01009430,737,37,17,20,109,77,51,71,182,164,35,27,8,11
S01009431,672,17,0,17,130,40,71,116,76,166,45,32,13,11
S01009432,809,3,2,1,76,62,30,108,246,207,59,37,22,18
S01009433,824,29,3,26,62,90,47,84,196,212,93,50,43,11
S01009434,543,4,4,0,64,63,42,77,86,151,41,25,16,15
S01009435,774,18,2,16,80,57,49,107,166,215,71,42,29,11
S01009436,701,40,18,22,120,51,41,97,178,127,42,18,24,5
S01009437,678,33,13,20,85,59,88,79,129,184,16,8,8,5
S01009438,872,40,6,34,93,72,92,121,167,223,48,31,17,16
S01009439,923,15,3,12,141,57,49,144,173,265,60,37,23,19
S01009440,638,33,8,25,68,63,52,79,151,157,31,21,10,4
S01009441,836,22,4,18,98,78,49,108,197,213,56,26,30,15
S01009442,563,40,3,37,144,68,96,76,53,63,15,13,2,8
S01009443,666,48,11,37,160,51,120,92,82,91,14,2,12,8
S01009444,846,130,28,102,195,109,94,116,106,85,11,9,2,0
S01009445,778,18,7,11,113,66,78,120,148,210,17,11,6,8
S01009446,878,16,2,14,105,100,64,81,211,206,79,42,37,16
S01009447,486,27,7,20,78,68,33,54,85,108,28,15,13,5
S01009448,808,65,22,43,166,97,77,97,126,144,29,11,18,7
S01009449,528,22,10,12,87,68,42,52,106,126,18,16,2,7
S01009450,596,4,0,4,72,68,38,68,119,176,51,25,26,0
S01009451,1014,13,3,10,121,97,113,129,201,247,86,49,37,7
S01009452,503,18,3,15,55,54,33,51,121,122,41,20,21,8
S01009453,981,25,10,15,140,112,52,165,161,261,57,30,27,8
S01009454,878,242,41,201,285,85,69,47,81,48,18,11,7,3
S01009455,847,239,55,184,294,90,112,24,36,43,4,4,0,5
S01009456,664,30,11,19,137,67,69,84,107,138,22,14,8,10
S01009457,587,66,20,46,150,50,115,53,71,68,10,5,5,4
S01009458,661,61,12,49,169,89,60,80,73,96,27,16,11,6
S01009459,865,52,11,41,210,72,91,107,127,139,44,11,33,23
S01009460,854,27,8,19,111,77,38,95,169,229,91,30,61,17
S01009461,576,158,36,122,205,65,46,23,27,48,2,2,0,2
S01009462,694,101,20,81,149,68,49,77,86,151,12,6,6,1
S01009463,667,71,22,49,147,88,76,68,84,113,12,4,8,8
S01009464,842,79,14,65,215,151,73,109,97,91,23,11,12,4
S01009465,609,38,13,25,170,57,49,82,103,88,19,10,9,3
S01009466,569,147,34,113,159,60,65,56,50,25,4,2,2,3
S01009467,770,149,33,116,284,74,67,48,56,73,12,4,8,7
S01009468,748,60,20,40,147,75,57,94,145,142,26,7,19,2
S01009469,791,128,35,93,238,105,52,83,94,68,15,5,10,8
S01009470,473,39,11,28,118,52,43,51,91,67,12,3,9,0
S01009471,659,40,9,31,124,59,28,72,105,158,55,30,25,18
S01009472,932,74,22,52,242,58,68,78,163,142,104,40,64,3
S01009473,902,36,3,33,120,72,54,142,171,187,87,27,60,33
S01009474,900,82,15,67,152,91,82,105,141,130,100,33,67,17
S01009475,585,119,37,82,173,66,98,40,44,35,3,3,0,7
S01009476,479,131,37,94,167,22,55,32,20,42,6,6,0,4
S01009477,701,115,12,103,230,79,68,61,64,64,11,5,6,9
S01009478,832,53,18,35,225,109,62,67,151,102,34,22,12,29
S01009479,777,120,26,94,184,78,69,86,93,83,42,18,24,22
S01009480,822,126,24,102,266,102,104,63,72,58,13,8,5,18
S01009481,895,78,20,58,202,121,68,82,178,130,20,14,6,16
S01009482,584,58,6,52,124,63,43,71,111,78,21,15,6,15
S01009483,724,79,3,76,242,79,70,68,86,62,24,6,18,14
S01009484,739,80,19,61,162,103,51,76,128,84,43,17,26,12
S01009485,786,54,9,45,128,76,72,96,145,152,42,15,27,21
S01009486,650,100,35,65,177,73,60,69,91,66,10,8,2,4
S01009487,789,28,10,18,138,99,55,114,146,163,31,23,8,15
S01009488,705,48,15,33,138,79,59,94,142,119,24,7,17,2
S01009489,775,61,15,46,87,77,56,105,135,186,57,33,24,11
S01009490,853,30,2,28,78,95,36,105,178,210,92,37,55,29
S01009491,677,39,5,34,99,77,58,67,126,172,31,18,13,8
S01009492,740,21,7,14,128,83,59,91,124,218,11,5,6,5
S01009493,821,238,31,207,299,74,82,47,38,37,6,4,2,0
S01009494,947,161,41,120,290,117,119,112,87,54,4,1,3,3
S01009495,871,130,33,97,255,126,98,97,87,69,9,2,7,0
S01009496,785,24,3,21,110,114,70,117,137,187,20,20,0,6
S01009497,955,48,6,42,208,121,69,145,181,164,14,8,6,5
S01009498,643,84,19,65,201,82,66,80,65,55,6,0,6,4
S01009499,796,91,25,66,161,90,69,97,124,127,32,16,16,5
S01009500,778,11,1,10,133,93,51,77,170,157,74,38,36,12
S01009501,654,20,7,13,83,61,46,94,140,154,53,19,34,3
S01009502,823,13,5,8,117,95,52,99,180,219,30,11,19,18
S01009503,729,21,5,16,135,103,60,86,147,147,23,14,9,7
S01009504,695,11,2,9,74,57,33,115,162,171,63,32,31,9
S01009505,817,24,2,22,81,94,23,95,180,189,120,60,60,11
S01009506,735,11,2,9,91,64,57,91,189,149,62,21,41,21
S01009507,889,50,25,25,184,126,62,124,137,163,34,17,17,9
S01009508,876,21,4,17,92,81,73,120,192,206,75,25,50,16
S01009509,1006,35,7,28,156,101,91,125,225,205,49,30,19,19
S01009510,700,59,12,47,167,134,70,97,90,67,11,6,5,5
S01009511,597,85,28,57,187,79,76,58,67,35,10,0,10,0
S01009512,771,94,15,79,197,126,79,102,70,91,6,0,6,6
S01009513,575,75,22,53,206,82,36,46,59,56,6,3,3,9
S01009514,706,81,9,72,231,96,54,94,73,67,10,4,6,0
S01009515,738,35,5,30,77,94,40,130,139,171,44,26,18,8
S01009516,839,30,6,24,144,104,68,130,159,184,17,13,4,3
S01009517,982,160,26,134,309,141,78,109,111,63,10,0,10,1
S01009518,936,138,37,101,336,125,112,83,86,53,3,0,3,0
S01009519,487,33,7,26,93,50,63,67,67,91,23,13,10,0
S01009520,837,140,48,92,212,95,89,70,94,104,19,16,3,14
S01009521,873,22,3,19,112,81,88,102,155,255,44,27,17,14
S01009522,1013,47,7,40,118,104,104,112,213,225,74,35,39,16
S01009523,581,28,0,28,93,53,27,51,140,142,38,19,19,9
S01009524,668,29,4,25,150,61,35,67,137,113,58,33,25,18
S01009525,532,25,4,21,103,46,35,65,90,116,42,29,13,10
S01009526,650,78,7,71,208,77,50,75,72,53,18,6,12,19
S01009527,639,56,9,47,122,92,33,65,105,114,32,14,18,20
S01009528,520,47,13,34,99,64,36,51,118,93,11,7,4,1
S01009529,535,81,33,48,150,47,81,43,67,54,5,1,4,7
S01009530,575,104,32,72,190,97,53,49,51,20,5,5,0,6
S01009531,795,15,0,15,84,86,40,111,171,218,53,28,25,17
S01009532,779,14,8,6,118,77,38,116,143,221,47,25,22,5
S01009533,783,19,10,9,113,102,50,85,169,185,36,16,20,24
S01009534,856,22,9,13,84,55,40,96,189,190,150,85,65,30
S01009535,629,8,0,8,76,36,63,87,118,151,78,47,31,12
S01009536,548,36,22,14,85,45,56,67,96,123,30,12,18,10
S01009537,539,46,2,44,92,58,48,74,87,95,29,6,23,10
S01009538,708,48,7,41,131,59,47,93,147,107,54,29,25,22
S01009539,865,31,13,18,171,119,69,140,127,187,10,4,6,11
S01009540,815,22,11,11,138,58,54,113,186,180,58,27,31,6
S01009541,725,52,23,29,154,74,91,95,107,138,9,0,9,5
S01009542,753,17,0,17,82,80,73,87,157,183,65,19,46,9
S01009543,523,27,8,19,93,47,63,70,77,129,11,3,8,6
S01009544,855,43,2,41,185,95,94,105,145,152,24,11,13,12
S01009545,789,23,16,7,145,79,83,93,145,162,55,31,24,4
S01009546,967,43,13,30,184,84,77,151,172,206,48,17,31,2
S01009547,744,58,14,44,127,55,79,92,137,135,37,26,11,24
S01009548,694,53,24,29,117,74,66,90,135,130,21,3,18,8
S01009549,778,58,26,32,155,73,80,105,144,135,21,5,16,7
S01009550,515,71,28,43,117,82,39,63,81,47,13,11,2,2
S01009551,533,24,11,13,92,62,50,74,127,78,25,12,13,1
S01009552,862,65,16,49,167,72,112,101,153,174,15,5,10,3
S01009553,852,38,12,26,96,49,46,157,186,189,80,30,50,11
S01009554,651,45,26,19,106,41,86,81,141,103,45,11,34,3
S01009555,735,53,13,40,143,75,119,73,111,109,45,18,27,7
S01009556,767,21,4,17,109,86,48,89,204,144,50,12,38,16
S01009557,675,23,9,14,81,52,48,71,184,145,69,17,52,2
S01009558,673,14,4,10,64,63,36,72,186,155,62,20,42,21
S01009559,857,14,1,13,106,78,63,112,215,196,68,35,33,5
S01009560,748,21,7,14,149,62,35,63,173,169,65,35,30,11
S01009561,536,21,0,21,100,45,35,73,127,92,34,13,21,9
S01009562,715,36,3,33,140,76,41,101,151,133,21,9,12,16
S01009563,793,34,13,21,139,78,53,114,156,175,36,22,14,8
S01009564,681,54,19,35,175,88,50,93,102,106,9,6,3,4
S01009565,588,30,7,23,102,69,27,82,102,146,23,12,11,7
S01009566,1070,57,14,43,241,90,90,142,232,167,28,10,18,23
S01009567,882,43,5,38,140,126,60,130,168,152,46,17,29,17
S01009568,736,24,4,20,147,82,60,105,146,124,31,13,18,17
S01009569,812,32,8,24,148,100,28,99,181,188,29,16,13,7
S01009570,559,9,4,5,119,54,30,87,110,120,22,16,6,8
S01009571,686,4,1,3,105,56,41,94,158,120,88,48,40,20
S01009572,1030,35,14,21,157,107,53,107,250,213,88,40,48,20
S01009573,743,21,3,18,65,70,21,120,173,180,75,32,43,18
S01009574,970,40,9,31,151,68,64,131,201,271,31,11,20,13
S01009575,523,23,9,14,106,80,33,91,80,81,25,13,12,4
S01009576,516,80,22,58,120,80,58,58,77,25,10,10,0,8
S01009577,660,80,25,55,220,56,78,78,70,65,13,13,0,0
S01009578,771,39,13,26,155,98,57,76,138,164,38,25,13,6
S01009579,1029,118,47,71,266,100,90,141,135,128,46,23,23,5
S01009580,970,123,36,87,270,128,88,118,120,98,16,6,10,9
S01009581,553,33,11,22,116,68,44,63,96,94,25,5,20,14
S01009582,533,31,6,25,91,84,50,85,108,64,16,1,15,4
S01009583,812,35,5,30,139,106,60,101,180,125,51,26,25,15
S01009584,537,65,21,44,165,48,84,60,67,38,8,1,7,2
S01009585,969,33,14,19,161,125,71,141,240,159,27,7,20,12
S01009586,647,36,18,18,137,79,48,126,100,95,26,21,5,0
S01009587,684,48,17,31,108,77,39,105,158,110,33,17,16,6
S01009588,977,49,8,41,185,88,58,153,218,188,23,10,13,15
S01009589,954,26,14,12,161,98,56,171,192,189,43,25,18,18
S01009590,718,107,23,84,263,88,67,61,82,47,0,0,0,3
S01009591,643,90,21,69,187,71,68,68,103,46,2,0,2,8
S01009592,554,104,20,84,167,39,77,65,57,40,2,0,2,3
S01009593,592,129,37,92,166,66,69,71,52,28,11,9,2,0
S01009594,675,120,33,87,206,85,51,102,67,43,1,0,1,0
S01009595,514,101,44,57,176,70,53,52,41,15,6,0,6,0
S01009596,783,44,16,28,127,81,70,97,189,129,28,15,13,18
S01009597,875,24,3,21,103,88,73,125,206,155,69,26,43,32
S01009598,664,15,3,12,80,61,65,70,170,133,52,17,35,18
S01009599,888,55,22,33,144,129,54,122,189,137,41,23,18,17
S01009600,634,13,3,10,101,66,43,62,158,136,47,23,24,8
S01009601,672,14,6,8,104,77,39,140,141,112,41,16,25,4
S01009602,770,132,41,91,288,67,53,62,100,59,9,2,7,0
S01009603,560,84,32,52,159,63,70,46,72,42,20,17,3,4
S01009604,857,65,22,43,266,97,46,117,128,102,22,17,5,14
S01009605,765,62,19,43,120,84,60,134,138,106,53,39,14,8
S01009606,545,110,19,91,214,48,38,51,55,19,10,6,4,0
S01009607,528,96,40,56,186,45,65,50,30,45,6,1,5,5
S01009608,606,45,13,32,117,76,51,73,123,95,22,9,13,4
S01009609,808,79,21,58,207,87,83,93,117,105,19,9,10,18
S01009610,982,62,11,51,249,111,65,129,166,162,30,14,16,8
S01009611,520,90,29,61,100,78,94,56,61,33,4,4,0,4
S01009612,597,50,16,34,108,52,58,79,116,107,21,17,4,6
S01009613,462,37,8,29,165,41,99,45,56,18,1,1,0,0
S01009614,506,52,20,32,126,24,81,75,79,64,5,3,2,0
S01009615,398,36,6,30,93,51,43,52,52,61,3,1,2,7
S01009616,725,50,15,35,106,67,70,119,159,121,27,6,21,6
S01009617,724,77,13,64,162,70,69,128,109,98,9,2,7,2
S01009618,682,12,4,8,111,67,59,98,137,145,46,24,22,7
S01009619,609,26,1,25,86,51,48,105,141,100,37,23,14,15
S01009620,797,19,4,15,90,53,42,145,194,200,44,25,19,10
S01009621,768,30,10,20,108,77,78,117,144,140,74,35,39,0
S01009622,729,13,2,11,77,82,63,67,153,167,93,47,46,14
S01009623,495,11,2,9,34,53,35,83,118,113,32,21,11,16
S01009624,876,24,7,17,112,70,56,140,216,220,38,16,22,0
S01009625,868,22,8,14,79,73,44,115,226,212,74,34,40,23
S01009626,601,15,3,12,46,30,39,44,182,176,64,20,44,5
S01009627,825,21,2,19,109,62,69,107,177,231,45,24,21,4
S01009628,495,22,6,16,25,51,22,42,137,160,33,18,15,3
S01009629,1082,32,14,18,112,96,72,167,229,252,108,66,42,14
S01009630,811,26,13,13,96,84,28,70,191,211,89,43,46,16
S01009631,677,6,0,6,58,33,33,81,191,194,73,47,26,8
S01009632,558,12,7,5,43,41,33,66,155,139,69,40,29,0
S01009633,755,10,2,8,50,55,53,76,173,218,98,47,51,22
S01009634,485,9,2,7,47,49,16,66,135,119,33,16,17,11
S01009635,842,40,5,35,120,78,58,119,188,190,45,19,26,4
S01009636,904,14,6,8,65,66,70,135,208,196,139,77,62,11
S01009637,705,40,4,36,103,53,48,110,166,140,32,23,9,13
S01009638,781,24,3,21,103,41,45,74,190,187,110,49,61,7
S01009639,755,92,22,70,244,94,77,89,75,58,26,20,6,0
S01009640,586,15,0,15,101,55,28,105,127,112,34,19,15,9
S01009641,770,31,2,29,135,92,58,88,156,133,71,45,26,6
S01009642,910,65,15,50,201,116,72,115,159,149,26,19,7,7
S01009643,584,53,21,32,175,75,41,87,91,52,0,0,0,10
S01009644,815,50,7,43,112,87,66,126,128,193,49,25,24,4
S01009645,649,25,7,18,96,76,56,118,112,126,30,21,9,10
S01009646,592,16,4,12,96,37,46,61,161,129,37,21,16,9
S01009647,562,16,1,15,60,50,55,57,118,128,64,31,33,14
S01009648,872,25,3,22,156,74,64,149,182,171,43,17,26,8
S01009649,1037,50,18,32,256,97,70,124,219,157,60,32,28,4
S01009650,755,95,20,75,267,77,76,92,67,70,11,4,7,0
S01009651,913,125,9,116,249,64,179,82,96,90,27,15,12,1
S01009652,760,184,29,155,233,80,105,44,58,43,11,10,1,2
S01009653,530,99,40,59,176,40,64,53,47,43,4,4,0,4
S01009654,583,55,5,50,172,84,76,30,75,68,9,5,4,14
S01009655,846,16,4,12,110,48,46,100,234,241,45,25,20,6
S01009656,728,28,13,15,76,36,48,90,148,218,76,44,32,8
S01009657,763,56,6,50,156,54,95,123,133,98,34,12,22,14
S01009658,738,22,5,17,100,55,46,107,190,175,43,30,13,0
S01009659,480,28,4,24,94,43,42,56,86,92,38,14,24,1
S01009660,1085,40,9,31,221,107,70,126,261,195,41,28,13,24
S01009661,774,114,29,85,219,54,198,49,47,59,15,6,9,19
S01009662,708,82,20,62,188,76,103,100,61,76,12,8,4,10
S01009663,641,99,21,78,222,68,56,65,57,51,15,4,11,8
S01009664,889,186,47,139,209,98,129,66,82,99,13,9,4,7
S01009665,662,90,36,54,134,57,83,50,85,125,24,13,11,14
S01009666,758,92,19,73,189,87,112,83,75,85,27,8,19,8
S01009667,523,82,25,57,160,52,87,57,52,30,3,3,0,0
S01009668,586,100,20,80,188,55,57,62,47,66,11,4,7,0
S01009669,502,70,8,62,119,51,77,70,53,60,2,2,0,0
S01009670,777,144,34,110,206,59,90,78,81,75,28,11,17,16
S01009671,607,72,20,52,192,78,81,53,78,40,11,3,8,2
S01009672,807,60,23,37,133,76,85,124,157,157,11,4,7,4
S01009673,779,96,34,62,192,76,120,71,78,118,12,11,1,16
S01009674,875,155,46,109,233,82,138,75,78,91,16,9,7,7
S01009675,882,138,39,99,242,86,123,82,86,106,16,8,8,3
S01009676,833,89,33,56,219,70,127,106,114,100,8,8,0,0
S01009677,592,123,20,103,123,36,159,46,57,36,7,1,6,5
S01009678,591,54,4,50,84,68,86,109,106,71,3,3,0,10
S01009679,875,61,13,48,195,95,86,95,134,167,32,21,11,10
S01009680,817,77,26,51,193,71,91,106,147,103,22,10,12,7
S01009681,558,52,14,38,133,51,50,85,69,105,7,3,4,6
S01009682,624,97,14,83,221,71,58,43,62,65,3,0,3,4
S01009683,765,145,32,113,252,88,60,70,83,47,8,4,4,12
S01009684,1085,247,56,191,330,106,176,66,73,63,20,10,10,4
S01009685,608,48,13,35,127,43,73,105,94,101,14,4,10,3
S01009686,1123,131,19,112,261,73,87,119,187,168,45,29,16,52
S01009687,723,66,10,56,203,86,82,75,74,116,16,6,10,5
S01009688,904,35,5,30,113,66,57,134,209,200,70,45,25,20
S01009689,605,77,15,62,147,48,51,61,89,80,26,10,16,26
S01009690,701,93,16,77,190,71,65,77,94,84,26,11,15,1
S01009691,611,119,27,92,212,65,61,45,54,38,7,1,6,10
S01009692,1034,157,33,124,301,101,120,108,135,97,8,5,3,7
S01009693,632,101,22,79,218,92,54,76,55,23,9,5,4,4
S01009694,962,206,45,161,310,124,80,73,87,69,9,9,0,4
S01009695,623,115,41,74,207,51,97,38,40,62,9,5,4,4
S01009696,945,203,40,163,259,66,157,77,101,61,19,11,8,2
S01009697,702,159,24,135,171,59,125,70,48,45,8,3,5,17
S01009698,564,120,43,77,147,30,138,47,50,17,0,0,0,15
S01009699,468,71,22,49,117,41,81,54,55,43,4,4,0,2
S01009700,649,73,8,65,125,50,119,80,86,100,7,7,0,9
S01009701,426,95,24,71,112,32,77,37,31,32,6,3,3,4
S01009702,631,103,11,92,137,29,166,62,50,67,12,2,10,5
S01009703,569,62,18,44,126,61,82,71,83,73,8,8,0,3
S01009704,917,116,20,96,220,68,200,105,99,89,11,6,5,9
S01009705,732,36,5,31,127,50,121,107,131,126,20,9,11,14
S01009706,625,62,27,35,123,61,133,54,78,78,23,15,8,13
S01009707,477,75,21,54,135,47,70,51,48,35,5,5,0,11
S01009708,573,81,22,59,119,45,121,67,69,56,6,4,2,9
S01009709,794,102,16,86,163,60,123,97,96,120,22,4,18,11
S01009710,567,55,6,49,133,37,125,91,50,57,15,6,9,4
S01009711,760,60,13,47,118,60,189,68,125,106,23,14,9,11
S01009712,593,75,4,71,143,29,126,74,72,55,14,7,7,5
S01009713,887,142,30,112,188,55,196,90,93,90,18,7,11,15
S01009714,915,186,36,150,237,91,133,88,99,54,20,8,12,7
S01009715,638,132,22,110,148,45,127,42,84,33,17,5,12,10
S01009716,726,166,22,144,162,50,78,65,71,54,4,0,4,76
S01009717,701,49,3,46,101,30,56,64,103,88,25,10,15,185
S01009718,731,59,4,55,116,39,41,91,93,159,14,3,11,119
S01009719,745,54,13,41,111,60,75,98,115,145,16,9,7,71
S01009720,797,79,6,73,121,42,36,116,123,175,12,5,7,93
S01009721,580,30,1,29,24,11,16,15,11,10,6,3,3,457
S01009722,831,89,11,78,81,23,38,22,27,29,3,3,0,519
S01009723,638,61,3,58,53,31,17,23,17,25,6,5,1,405
S01009724,959,81,2,79,108,42,56,80,118,139,19,13,6,316
S01009725,680,50,4,46,44,19,17,45,35,12,18,10,8,440
S01009726,557,52,5,47,44,11,42,4,11,2,3,1,2,388
S01009727,853,221,56,165,196,34,104,51,85,57,16,3,13,89
S01009728,727,192,36,156,249,70,86,35,25,37,3,3,0,30
S01009729,620,170,18,152,207,55,61,41,30,21,6,6,0,29
S01009730,522,73,10,63,84,70,47,52,52,61,8,4,4,75
S01009731,585,157,17,140,168,71,55,20,25,17,3,1,2,69
S01009732,798,139,15,124,124,29,82,29,34,21,11,6,5,329
S01009733,485,120,22,98,114,24,84,31,44,62,2,0,2,4
S01009734,875,227,48,179,228,80,117,84,50,38,5,3,2,46
S01009735,741,279,55,224,230,52,97,12,9,7,4,4,0,51
S01009736,710,91,10,81,89,42,40,13,26,8,5,5,0,396
S01009737,782,28,10,18,280,135,57,70,88,110,3,1,2,11
S01009738,420,39,10,29,79,38,56,72,68,49,9,5,4,10
S01009739,761,161,108,53,334,62,41,52,38,57,4,0,4,12
S01009740,541,31,17,14,131,51,59,96,59,75,25,12,13,14
S01009741,583,13,8,5,385,87,8,22,33,28,3,0,3,4
S01009742,495,138,32,106,159,45,60,33,33,25,1,1,0,1
S01009743,946,191,31,160,246,97,133,106,71,74,17,6,11,11
S01009744,698,126,27,99,213,99,94,64,45,48,5,4,1,4
S01009745,1078,196,55,141,334,136,118,99,120,58,6,5,1,11
S01009746,557,118,18,100,144,26,145,27,58,35,1,1,0,3
S01009747,656,72,15,57,171,88,60,64,82,80,27,4,23,12
S01009748,703,167,26,141,210,72,60,60,70,52,3,2,1,9
S01009749,954,207,39,168,271,89,80,94,74,115,16,10,6,8
S01009750,679,57,6,51,181,69,59,78,105,108,19,4,15,3
S01009751,778,71,12,59,136,112,55,86,138,147,19,7,12,14
S01009752,596,234,13,221,205,49,50,18,25,8,5,4,1,2
S01009753,694,153,15,138,203,79,86,33,75,52,9,6,3,4
S01009754,804,204,32,172,216,91,76,52,82,57,18,8,10,8
S01009755,660,191,35,156,204,68,44,54,41,41,14,12,2,3
S01009756,740,230,57,173,224,59,60,50,43,66,4,4,0,4
S01009757,665,246,24,222,207,45,74,36,36,8,6,1,5,7
S01009758,547,53,10,43,118,109,48,61,76,58,12,7,5,12
S01009759,927,11,2,9,58,59,55,72,263,250,117,67,50,42
S01009760,893,28,0,28,77,121,74,91,209,211,71,40,31,11
S01009761,910,76,16,60,178,115,98,124,149,132,35,24,11,3
S01009762,921,10,4,6,91,57,28,101,230,246,106,63,43,52
S01009763,772,183,42,141,213,74,162,23,47,44,16,9,7,10
S01009764,674,31,4,27,109,54,35,68,179,112,72,35,37,14
S01009765,970,39,0,39,184,140,113,141,168,113,54,32,22,18
S01009766,563,37,2,35,132,74,42,94,99,66,7,1,6,12
S01009767,509,11,3,8,64,59,33,45,102,127,60,42,18,8
S01009768,610,49,4,45,97,75,80,44,105,90,56,27,29,14
S01009769,606,48,7,41,161,56,65,66,117,64,17,7,10,12
S01009770,711,54,12,42,180,89,83,100,131,46,19,17,2,9
S01009771,888,73,20,53,207,104,162,108,112,86,28,19,9,8
S01009772,635,56,11,45,135,112,54,60,90,106,13,2,11,9
S01009773,629,95,9,86,164,39,143,60,59,21,15,14,1,33
S01009774,563,96,5,91,177,24,105,63,31,42,19,13,6,6
S01009775,797,32,10,22,64,55,20,115,207,188,70,49,21,46
S01009776,659,10,0,10,54,53,10,67,184,151,120,66,54,10
S01009777,482,13,0,13,49,62,32,55,122,93,32,18,14,24
S01009778,822,11,8,3,68,48,39,98,235,253,49,42,7,21
S01009779,551,3,2,1,32,48,28,62,132,167,51,24,27,28
S01009780,608,9,3,6,35,20,23,40,180,168,112,62,50,21
S01009781,548,1,0,1,57,55,16,44,164,144,60,38,22,7
S01009782,556,48,0,48,79,62,81,59,86,62,68,29,39,11
S01009783,741,13,0,13,101,64,29,71,202,159,94,63,31,8
S01009784,749,18,4,14,67,78,17,85,195,204,66,25,41,19
S01009785,801,10,5,5,51,91,33,63,189,245,105,89,16,14
S01009786,925,20,5,15,92,112,44,64,254,231,95,39,56,13
S01009787,867,17,10,7,86,90,47,79,208,208,128,78,50,4
S01009788,832,29,1,28,102,117,63,81,171,218,41,21,20,10
S01009789,896,29,8,21,93,105,59,113,220,209,55,32,23,13
S01009790,629,21,11,10,73,91,20,71,135,157,54,34,20,7
S01009791,661,22,5,17,72,53,52,54,143,154,98,53,45,13
S01009792,958,154,30,124,269,98,140,79,105,57,35,30,5,21
S01009793,885,72,19,53,204,144,90,125,120,92,16,8,8,22
S01009794,516,76,13,63,155,90,29,49,50,50,10,8,2,7
S01009795,842,149,44,105,278,121,105,55,65,52,13,3,10,4
S01009796,768,73,22,51,200,88,140,91,107,50,19,15,4,0
S01009797,776,93,10,83,243,101,88,86,75,61,23,16,7,6
S01009798,722,92,19,73,235,93,101,82,44,53,11,6,5,11
S01009799,834,12,0,12,42,94,49,58,233,228,104,59,45,14
S01009800,1107,27,6,21,133,155,89,98,270,198,102,73,29,35
S01009801,894,12,1,11,116,125,32,97,193,225,78,51,27,16
S01009802,1022,41,5,36,170,139,59,137,206,172,84,58,26,14
S01009803,801,7,4,3,105,94,52,59,179,174,87,55,32,44
S01009804,385,80,10,70,122,42,23,45,37,22,7,6,1,7
S01009805,956,78,7,71,101,118,29,56,223,210,104,62,42,37
S01009806,828,39,7,32,141,130,60,77,199,144,31,22,9,7
S01009807,1008,33,5,28,129,149,56,149,220,136,107,75,32,29
S01009808,889,11,4,7,95,93,73,70,208,161,127,92,35,51
S01009809,685,46,4,42,124,89,33,69,161,118,32,23,9,13
S01009810,855,24,6,18,123,117,29,98,196,155,89,49,40,24
S01009811,1048,27,10,17,155,130,66,81,248,224,106,87,19,11
S01009812,744,21,5,16,114,111,76,64,146,151,56,40,16,5
S01009813,769,7,0,7,75,84,56,60,167,125,165,119,46,30
S01009814,840,85,13,72,186,98,61,105,94,154,41,35,6,16
S01009815,710,40,12,28,174,113,32,67,99,127,42,33,9,16
S01009816,705,39,4,35,140,129,53,102,137,85,10,5,5,10
S01009817,690,35,10,25,140,98,34,87,123,122,44,29,15,7
S01009818,926,92,13,79,276,174,95,82,92,94,18,16,2,3
S01009819,619,63,10,53,132,115,80,46,78,84,9,3,6,12
S01009820,958,93,31,62,228,160,72,82,158,128,26,17,9,11
S01009821,662,94,18,76,186,93,59,38,74,92,20,13,7,6
S01009822,479,34,4,30,89,75,11,63,85,87,29,15,14,6
S01009823,680,23,9,14,62,77,37,75,160,150,69,55,14,27
S01009824,893,40,0,40,128,97,61,145,196,189,32,26,6,5
S01009825,1006,49,17,32,151,136,43,100,183,270,56,35,21,18
S01009826,582,11,3,8,72,57,32,62,167,119,59,34,25,3
S01009827,854,15,5,10,100,82,51,101,213,235,40,25,15,17
S01009828,767,20,3,17,111,81,41,95,141,189,80,53,27,9
S01009829,967,55,11,44,155,166,57,109,181,171,60,34,26,13
S01009830,770,15,6,9,116,156,26,75,176,152,43,27,16,11
S01009831,779,33,5,28,141,154,33,82,150,140,27,17,10,19
S01009832,1003,88,13,75,209,169,57,104,158,157,40,25,15,21
S01009833,525,24,2,22,165,62,45,48,62,91,16,5,11,12
S01009834,841,38,8,30,142,135,40,73,165,146,76,37,39,26
S01009835,526,11,5,6,48,66,27,32,135,149,39,26,13,19
S01009836,951,54,27,27,187,112,55,127,176,191,42,29,13,7
S01009837,652,10,5,5,85,81,20,71,157,159,54,41,13,15
S01009838,757,22,2,20,118,88,36,64,134,174,86,37,49,35
S01009839,974,35,5,30,120,144,23,83,222,196,118,65,53,33
S01009840,965,43,3,40,130,118,45,103,185,250,85,51,34,6
S01009841,759,25,7,18,105,90,36,86,145,142,103,74,29,27
S01009842,662,28,2,26,82,52,34,60,114,139,110,77,33,43
S01009843,640,12,0,12,61,62,4,94,100,165,134,94,40,8
S01009844,573,12,0,12,50,65,28,59,98,136,112,77,35,13
S01009845,744,31,8,23,61,69,33,77,151,143,143,90,53,36
S01009846,862,24,1,23,121,96,51,77,175,207,85,59,26,26
S01009847,582,11,2,9,67,77,16,57,134,142,53,36,17,25
S01009848,866,24,6,18,89,103,44,109,208,186,83,71,12,20
S01009849,734,45,5,40,138,85,17,78,157,160,37,24,13,17
S01009850,879,53,8,45,146,131,45,84,196,175,38,29,9,11
S01009851,824,32,4,28,121,97,56,97,173,183,53,28,25,12
S01009852,599,42,17,25,131,107,31,59,114,69,39,38,1,7
S01009853,876,49,9,40,147,174,73,66,162,145,49,24,25,11
S01009854,896,43,14,29,171,102,43,76,181,194,63,31,32,23
S01009855,572,56,6,50,138,96,37,73,83,60,7,3,4,22
S01009856,635,44,7,37,160,100,51,33,117,84,22,11,11,24
S01009857,907,86,4,82,222,131,72,61,161,136,30,24,6,8
S01009858,746,35,7,28,141,102,50,101,154,111,35,21,14,17
S01009859,1038,33,4,29,120,103,33,67,229,276,154,114,40,23
S01009860,920,19,0,19,75,106,25,86,184,263,129,104,25,33
S01009861,1024,28,2,26,128,76,47,81,194,271,166,114,52,33
S01009862,1007,37,7,30,125,137,71,101,178,203,103,55,48,52
S01009863,790,49,9,40,112,110,54,65,169,107,81,61,20,43
S01009864,594,63,1,62,90,55,33,32,91,97,86,71,15,47
S01009865,448,28,2,26,68,63,56,51,74,54,39,21,18,15
S01009866,882,46,5,41,163,106,71,106,166,139,55,41,14,30
S01009867,994,151,13,138,218,171,89,63,101,102,40,27,13,59
S01009868,644,78,3,75,143,61,41,52,70,116,33,21,12,50
S01009869,530,45,4,41,102,72,41,66,64,45,24,15,9,71
S01009870,599,30,0,30,91,67,64,61,88,93,65,58,7,40
S01009871,984,100,9,91,138,113,130,71,168,152,55,36,19,57
S01009872,724,48,5,43,139,86,94,69,103,85,34,22,12,66
S01009873,913,191,20,171,187,85,148,49,96,92,52,33,19,13
S01009874,1044,161,25,136,209,130,130,54,172,113,52,29,23,23
S01009875,707,51,7,44,102,76,77,47,93,73,130,104,26,58
S01009876,729,10,0,10,101,70,33,50,179,112,128,92,36,46
S01009877,876,256,28,228,264,41,146,35,54,36,35,22,13,9
S01009878,705,58,10,48,91,45,154,97,89,76,52,42,10,43
S01009879,892,353,76,277,227,37,156,32,33,26,12,5,7,16
S01009880,788,182,32,150,144,53,188,42,89,39,28,19,9,23
S01009881,528,22,1,21,87,53,93,58,62,54,56,47,9,43
S01009882,1089,185,12,173,269,98,103,64,135,47,78,52,26,110
S01009883,824,65,12,53,129,66,138,78,125,58,105,87,18,60
S01009884,815,73,4,69,175,70,131,90,110,71,66,48,18,29
S01009885,870,114,11,103,158,59,225,63,106,38,69,64,5,38
S01009886,813,109,1,108,138,72,118,57,122,63,93,84,9,41
S01009887,976,39,3,36,163,84,113,68,154,123,108,78,30,124
S01009888,719,61,7,54,105,45,115,66,109,93,70,51,19,55
S01009889,805,44,1,43,170,62,120,72,109,92,93,88,5,43
S01009890,535,25,3,22,56,44,43,55,113,99,71,38,33,29
S01009891,733,37,4,33,147,82,73,74,88,117,77,49,28,38
S01009892,781,35,10,25,114,63,30,96,157,173,86,66,20,27
S01009893,837,53,3,50,140,75,95,99,116,129,78,59,19,52
S01009894,823,25,4,21,108,95,61,78,172,164,65,44,21,55
S01009895,717,48,6,42,98,74,45,58,151,136,64,39,25,43
S01009896,959,29,3,26,113,83,124,80,207,177,109,85,24,37
S01009897,940,46,5,41,195,125,77,102,170,138,52,30,22,35
S01009898,611,17,1,16,55,64,107,58,131,103,66,39,27,10
S01009899,776,86,4,82,224,133,53,56,82,86,26,13,13,30
S01009900,829,136,12,124,322,110,41,35,106,45,18,6,12,16
S01009901,864,160,10,150,327,125,68,48,61,25,41,25,16,9
S01009902,908,59,3,56,169,102,96,84,155,149,73,47,26,21
S01009903,813,156,22,134,256,56,131,65,59,39,40,39,1,11
S01009904,784,122,16,106,260,111,65,42,66,61,28,26,2,29
S01009905,749,71,2,69,183,71,58,53,115,53,64,45,19,81
S01009906,667,99,9,90,138,82,48,64,90,74,30,24,6,42
S01009907,779,44,5,39,153,95,50,54,96,78,68,44,24,141
S01009908,1027,202,19,183,359,66,105,75,108,43,35,29,6,34
S01009909,821,138,12,126,231,106,77,37,98,50,44,25,19,40
S01009910,532,75,16,59,166,81,36,20,65,46,23,17,6,20
S01009911,945,214,30,184,327,79,85,53,71,65,30,21,9,21
S01009912,873,267,33,234,235,51,157,54,48,27,23,22,1,11
S01009913,719,162,10,152,162,57,206,24,46,50,9,9,0,3
S01009914,978,287,46,241,280,62,223,30,32,25,32,30,2,7
S01009915,861,227,36,191,259,74,142,30,63,33,16,14,2,17
S01009916,985,149,20,129,219,57,331,67,100,27,35,28,7,0
S01009917,709,188,32,156,232,76,70,30,69,29,12,11,1,3
S01009918,709,184,24,160,223,62,100,28,63,28,12,4,8,9
S01009919,1099,118,10,108,250,148,91,73,187,123,52,35,17,57
S01009920,831,192,15,177,251,111,45,77,63,59,16,9,7,17
S01009921,627,116,9,107,214,100,32,42,60,18,21,13,8,24
S01009922,1016,216,21,195,333,143,63,67,89,32,29,23,6,44
S01009923,855,96,3,93,255,130,68,66,94,91,27,16,11,28
S01009924,1007,168,25,143,273,170,70,59,114,85,27,22,5,41
S01009925,658,134,11,123,207,110,25,29,59,34,37,18,19,23
S01009926,773,119,12,107,228,87,71,40,92,73,38,33,5,25
S01009927,511,98,16,82,120,62,42,41,73,41,20,10,10,14
S01009928,797,280,34,246,264,79,86,26,24,17,13,6,7,8
S01009929,499,132,22,110,158,61,62,28,20,25,8,8,0,5
S01009930,850,143,16,127,274,109,83,53,96,45,29,2,27,18
S01009931,751,177,23,154,267,120,47,31,38,35,11,6,5,25
S01009932,619,108,13,95,195,88,48,41,57,46,12,8,4,24
S01009933,909,61,5,56,158,94,38,76,129,188,116,78,38,49
S01009934,924,189,35,154,272,98,74,68,98,60,34,26,8,31
S01009935,544,25,1,24,54,76,24,61,121,119,56,42,14,8
S01009936,627,55,5,50,152,77,37,53,82,117,27,13,14,27
S01009937,531,13,6,7,54,54,22,48,98,100,120,86,34,22
S01009938,938,57,5,52,127,105,68,104,177,213,65,47,18,22
S01009939,901,11,0,11,51,54,39,76,163,185,295,212,83,27
S01009940,837,8,2,6,72,90,47,84,234,205,86,57,29,11
S01009941,1033,64,4,60,235,111,192,113,134,110,47,29,18,27
S01009942,1022,10,0,10,123,91,51,66,219,320,119,94,25,23
S01009943,841,23,11,12,68,77,47,56,200,230,115,68,47,25
S01009944,799,50,3,47,155,113,59,78,174,123,27,17,10,20
S01009945,963,45,8,37,150,146,51,90,217,155,74,33,41,35
S01009946,815,48,21,27,151,130,61,74,144,144,49,39,10,14
S01009947,567,39,2,37,94,56,42,85,98,108,44,21,23,1
S01009948,812,31,4,27,118,83,52,68,164,183,69,45,24,44
S01009949,821,80,4,76,176,110,36,92,152,108,57,30,27,10
S01009950,727,243,41,202,244,46,86,26,45,20,12,7,5,5
S01009951,769,324,24,300,202,32,146,10,40,11,3,3,0,1
S01009952,733,198,39,159,236,76,68,35,69,34,17,14,3,0
S01009953,889,203,40,163,250,101,100,53,76,86,14,14,0,6
S01009954,632,132,32,100,136,64,162,29,39,39,18,11,7,13
S01009955,948,195,22,173,219,115,110,75,110,79,37,29,8,8
S01009956,750,78,15,63,154,124,80,92,102,80,32,19,13,8
S01009957,760,296,36,260,178,68,99,46,49,14,5,3,2,5
S01009958,915,206,18,188,302,123,108,45,79,36,10,4,6,6
S01009959,657,210,30,180,162,70,93,29,24,36,22,21,1,11
S01009960,902,204,36,168,297,138,111,35,53,36,22,22,0,6
S01009961,674,54,15,39,177,114,84,58,80,70,27,20,7,10
S01009962,991,124,12,112,248,188,63,100,120,92,36,24,12,20
S01009963,802,108,21,87,270,129,116,70,58,40,6,5,1,5
S01009964,925,189,32,157,263,98,130,59,83,72,23,17,6,8
S01009965,718,78,18,60,205,111,96,79,73,69,5,3,2,2
S01009966,776,104,37,67,201,115,72,80,100,75,21,6,15,8
S01009967,801,180,42,138,344,86,74,32,44,25,4,3,1,12
S01009968,608,32,12,20,139,126,83,61,78,79,8,8,0,2
S01009969,857,241,55,186,240,92,92,55,54,51,21,10,11,11
S01009970,946,14,3,11,65,128,33,80,216,271,114,61,53,25
S01009971,1093,40,9,31,159,100,107,81,227,256,108,54,54,15
S01009972,814,62,11,51,187,93,97,78,116,115,51,42,9,15
S01009973,725,37,4,33,134,61,49,88,106,197,47,37,10,6
S01009974,615,7,0,7,30,89,38,46,139,167,91,54,37,8
S01009975,800,8,0,8,45,75,48,48,205,206,151,111,40,14
S01009976,490,3,0,3,40,32,16,51,105,174,64,50,14,5
S01009977,926,29,3,26,76,58,22,79,189,295,160,95,65,18
S01009978,1019,26,11,15,111,90,43,92,248,256,120,77,43,33
S01009979,481,4,0,4,39,32,17,41,109,179,55,39,16,5
S01009980,567,7,2,5,59,34,18,38,134,171,95,63,32,11
S01009981,694,31,2,29,79,54,33,78,133,201,79,47,32,6
S01009982,1030,32,2,30,147,112,92,76,208,234,98,68,30,31
S01009983,579,17,0,17,39,56,15,27,147,131,129,80,49,18
S01009984,750,27,4,23,80,78,69,99,124,185,74,39,35,14
S01009985,611,7,3,4,36,48,29,73,172,129,105,57,48,12
S01009986,552,11,0,11,44,67,12,28,129,154,107,66,41,0
S01009987,880,16,2,14,70,145,42,84,225,231,55,35,20,12
S01009988,497,4,0,4,44,48,15,42,124,148,65,40,25,7
S01009989,803,28,8,20,131,148,91,45,178,143,34,17,17,5
S01009990,673,31,8,23,127,115,27,70,124,143,23,10,13,13
S01009991,800,47,21,26,132,172,55,96,131,117,37,27,10,13
S01009992,695,5,0,5,72,75,37,76,189,137,90,56,34,14
S01009993,826,65,11,54,158,107,82,92,152,141,8,0,8,21
S01009994,725,36,9,27,154,112,75,82,129,107,27,19,8,3
S01009995,653,44,4,40,131,142,48,87,105,85,7,6,1,4
S01009996,744,63,21,42,135,110,54,87,109,139,37,20,17,10
S01009997,575,27,2,25,144,104,34,49,112,61,25,12,13,19
S01009998,634,101,37,64,176,68,135,54,31,47,17,16,1,5
S01009999,733,98,22,76,186,131,48,87,90,72,11,8,3,10
S01010000,616,21,0,21,155,87,48,61,119,100,18,5,13,7
S01010001,798,80,14,66,158,119,61,79,120,128,40,20,20,13
S01010002,779,42,3,39,157,153,63,97,136,99,25,14,11,7
S01010003,712,93,23,70,179,105,46,116,86,73,13,9,4,1
S01010004,730,98,22,76,267,75,103,43,76,44,16,10,6,8
S01010005,748,60,9,51,160,145,46,69,109,86,50,29,21,23
S01010006,874,89,11,78,223,144,23,68,128,132,48,23,25,19
S01010007,959,179,31,148,330,156,76,58,61,74,14,4,10,11
S01010008,618,88,15,73,196,96,43,30,81,50,18,9,9,16
S01010009,555,57,7,50,143,88,29,52,80,59,27,16,11,20
S01010010,1043,209,47,162,333,112,125,59,108,74,15,10,5,8
S01010011,730,78,16,62,194,118,35,70,97,90,37,20,17,11
S01010012,843,81,11,70,193,124,111,65,103,109,31,27,4,26
S01010013,781,109,26,83,232,114,51,71,88,64,34,10,24,18
S01010014,1003,151,31,120,340,133,92,69,84,80,35,25,10,19
S01010015,790,129,17,112,230,108,81,70,86,43,26,12,14,17
S01010016,723,15,4,11,117,91,53,84,173,137,42,28,14,11
S01010017,748,25,9,16,66,68,45,79,180,188,90,41,49,7
S01010018,945,44,10,34,153,142,45,100,170,217,60,42,18,14
S01010019,725,3,2,1,87,81,24,79,156,168,117,78,39,10
S01010020,742,21,8,13,93,102,56,85,170,185,25,19,6,5
S01010021,806,28,1,27,54,55,62,66,158,172,163,107,56,48
S01010022,956,49,5,44,138,104,47,93,188,205,101,53,48,31
S01010023,640,10,4,6,51,48,18,63,149,202,98,68,30,1
S01010024,718,38,2,36,109,74,19,53,185,134,72,50,22,34
S01010025,534,18,0,18,78,42,46,42,84,129,72,44,28,23
S01010026,876,67,12,55,167,73,43,54,159,169,92,63,29,52
S01010027,904,73,9,64,198,96,53,56,129,122,88,64,24,89
S01010028,639,41,0,41,91,53,29,65,114,141,69,43,26,36
S01010029,668,17,5,12,74,62,22,88,125,198,62,50,12,20
S01010030,815,163,16,147,180,83,22,77,95,119,22,11,11,54
S01010031,692,138,10,128,188,85,26,32,33,27,17,15,2,146
S01010032,518,88,4,84,130,68,15,29,50,13,34,27,7,91
S01010033,905,74,6,68,166,89,63,58,160,137,85,51,34,73
S01010034,852,54,11,43,119,65,25,79,153,216,109,84,25,32
S01010035,686,20,2,18,46,44,19,98,122,144,117,90,27,76
S01010036,796,82,5,77,126,78,30,35,76,32,22,14,8,315
S01010037,642,19,0,19,53,61,36,74,128,196,63,43,20,12
S01010038,990,46,1,45,125,68,43,74,228,229,93,66,27,84
S01010039,945,164,13,151,226,69,40,49,52,43,24,21,3,278
S01010040,725,91,9,82,188,89,49,52,97,75,29,20,9,55
S01010041,649,89,6,83,125,52,25,50,54,75,50,41,9,129
S01010042,1095,92,7,85,219,166,62,76,129,144,67,38,29,140
S01010043,770,48,3,45,103,88,27,70,139,161,100,57,43,34
S01010044,1100,67,14,53,166,137,53,122,172,239,97,73,24,47
S01010045,550,8,2,6,33,34,13,44,146,167,92,67,25,13
S01010046,747,16,1,15,103,88,39,64,147,193,81,53,28,16
S01010047,828,12,6,6,61,76,47,70,188,259,100,68,32,15
S01010048,950,20,1,19,77,79,19,98,222,313,88,59,29,34
S01010049,807,12,4,8,34,45,38,62,225,266,105,66,39,20
S01010050,979,29,4,25,63,102,31,78,231,256,147,104,43,42
S01010051,699,6,2,4,53,62,37,56,121,221,111,77,34,32
S01010052,627,22,2,20,71,77,17,48,138,136,95,65,30,23
S01010053,859,28,5,23,70,78,41,85,203,211,89,73,16,54
S01010054,573,8,0,8,41,23,12,25,148,159,140,105,35,17
S01010055,948,35,6,29,144,100,42,76,204,205,94,49,45,48
S01010056,451,6,0,6,33,49,12,49,106,111,73,53,20,12
S01010057,407,15,4,11,54,47,15,44,86,87,43,36,7,16
S01010058,781,37,20,17,69,71,36,75,188,196,90,61,29,19
S01010059,604,36,2,34,102,75,37,56,116,120,32,14,18,30
S01010060,901,33,9,24,117,80,66,65,185,235,95,68,27,25
S01010061,510,15,0,15,105,79,42,46,100,72,24,9,15,27
S01010062,750,9,0,9,103,64,41,71,194,184,72,42,30,12
S01010063,925,29,8,21,90,91,40,103,210,219,114,70,44,29
S01010064,544,13,3,10,78,50,44,64,109,117,51,30,21,18
S01010065,839,12,6,6,90,64,49,75,178,275,84,63,21,12
S01010066,753,4,0,4,56,67,38,64,171,231,92,75,17,30
S01010067,608,5,1,4,35,38,24,39,162,186,108,65,43,11
S01010068,641,35,4,31,88,71,41,78,146,124,24,12,12,34
S01010069,829,38,14,24,180,143,121,63,138,130,6,3,3,10
S01010070,665,67,23,44,130,83,110,66,112,78,9,7,2,10
S01010071,793,33,13,20,162,103,106,88,115,149,27,15,12,10
S01010072,796,57,15,42,126,86,64,93,184,156,22,10,12,8
S01010073,780,44,11,33,181,101,71,95,121,135,16,10,6,16
S01010074,711,49,10,39,237,89,75,79,90,66,18,9,9,8
S01010075,624,26,9,17,74,71,40,45,151,184,26,16,10,7
S01010076,686,24,5,19,92,73,68,65,166,153,35,25,10,10
S01010077,614,8,2,6,97,65,52,60,156,119,44,37,7,13
S01010078,631,57,19,38,178,106,62,66,76,60,22,12,10,4
S01010079,923,175,50,125,259,78,169,82,53,74,11,5,6,22
S01010080,651,89,21,68,167,91,84,77,75,58,6,2,4,4
S01010081,701,103,25,78,179,95,161,45,34,53,16,15,1,15
S01010082,854,118,29,89,229,125,124,62,82,79,11,7,4,24
S01010083,716,21,0,21,95,95,45,73,162,161,46,29,17,18
S01010084,878,10,5,5,104,126,40,121,176,229,68,44,24,4
S01010085,760,60,21,39,187,115,82,119,95,91,11,3,8,0
S01010086,915,14,2,12,130,78,52,92,247,243,46,35,11,13
S01010087,573,86,25,61,132,71,100,47,80,51,6,3,3,0
S01010088,821,160,29,131,298,64,131,52,58,39,9,6,3,10
S01010089,683,36,4,32,92,93,72,81,120,116,37,12,25,36
S01010090,1054,79,35,44,258,170,102,112,129,148,25,16,9,31
S01010091,866,65,11,54,252,107,96,97,117,90,23,12,11,19
S01010092,958,47,16,31,121,113,62,90,184,223,89,67,22,29
S01010093,869,78,33,45,186,132,91,127,101,104,25,13,12,25
S01010094,687,45,7,38,192,124,56,77,65,98,27,12,15,3
S01010095,696,65,8,57,165,121,76,85,77,89,15,5,10,3
S01010096,752,48,10,38,249,113,69,84,88,93,6,5,1,2
S01010097,731,71,17,54,140,103,80,77,124,101,31,24,7,4
S01010098,727,84,10,74,214,101,84,72,75,87,7,4,3,3
S01010099,699,66,8,58,201,115,83,89,82,55,6,4,2,2
S01010100,886,70,12,58,224,86,89,109,171,121,13,12,1,3
S01010101,719,46,14,32,182,90,95,68,107,112,13,6,7,6
S01010102,939,118,23,95,335,107,92,115,46,93,11,7,4,22
S01010103,974,59,3,56,260,112,166,153,93,110,7,7,0,14
S01010104,755,68,9,59,218,109,84,105,65,88,9,4,5,9
S01010105,406,10,4,6,41,32,10,28,112,108,56,30,26,9
S01010106,442,4,0,4,55,28,22,45,94,139,50,32,18,5
S01010107,793,11,0,11,76,68,55,82,184,189,69,36,33,59
S01010108,733,24,2,22,72,70,75,106,140,191,46,31,15,9
S01010109,731,48,4,44,104,72,55,67,120,158,67,52,15,40
S01010110,805,11,5,6,63,76,28,69,206,252,84,56,28,16
S01010111,986,11,1,10,112,63,32,87,197,304,151,104,47,29
S01010112,949,13,4,9,90,64,35,73,249,232,172,107,65,21
S01010113,551,16,7,9,35,50,26,27,131,144,102,68,34,20
S01010114,777,13,4,9,44,65,21,61,208,238,114,80,34,13
S01010115,632,15,0,15,116,66,56,85,129,97,55,32,23,13
S01010116,1020,68,6,62,214,130,77,134,173,149,39,11,28,36
S01010117,653,81,13,68,161,74,75,67,78,89,15,7,8,13
S01010118,678,3,0,3,55,59,17,59,180,152,146,105,41,7
S01010119,543,9,0,9,58,31,22,50,150,152,57,33,24,14
S01010120,1045,10,8,2,87,80,37,75,235,275,204,134,70,42
S01010121,675,5,0,5,57,62,35,53,204,145,98,67,31,16
S01010122,425,6,3,3,20,18,22,40,90,140,78,53,25,11
S01010123,733,21,5,16,56,76,30,31,196,214,95,81,14,14
S01010124,646,16,4,12,108,82,54,98,116,104,45,20,25,23
S01010125,548,18,7,11,57,52,43,57,119,124,69,43,26,9
S01010126,730,44,15,29,98,56,83,78,144,180,46,34,12,1
S01010127,620,24,4,20,62,82,28,60,135,166,51,34,17,12
S01010128,492,5,5,0,29,58,27,25,145,106,84,52,32,13
S01010129,719,5,0,5,74,56,25,53,164,189,125,67,58,28
S01010130,416,3,0,3,41,43,25,49,109,112,30,18,12,4
S01010131,908,66,15,51,213,132,129,110,85,141,24,7,17,8
S01010132,969,22,9,13,70,111,61,80,219,264,109,66,43,33
S01010133,713,6,0,6,80,64,41,83,182,195,48,30,18,14
S01010134,995,25,2,23,118,116,67,113,192,286,66,32,34,12
S01010135,768,14,5,9,97,74,31,77,186,231,54,39,15,4
S01010136,809,34,10,24,145,91,81,104,144,149,44,21,23,17
S01010137,967,32,6,26,144,140,54,121,201,206,52,40,12,17
S01010138,941,34,23,11,89,92,60,93,199,214,141,79,62,19
S01010139,1024,26,3,23,124,139,64,139,194,243,76,45,31,19
S01010140,753,44,10,34,133,132,39,68,111,149,57,33,24,20
S01010141,807,21,6,15,66,64,43,69,191,209,125,98,27,19
S01010142,572,10,4,6,74,49,62,56,119,129,58,42,16,15
S01010143,739,16,4,12,92,83,53,80,176,185,42,31,11,12
S01010144,700,13,2,11,110,78,40,70,144,156,63,43,20,26
S01010145,778,25,2,23,115,99,57,74,177,160,61,35,26,10
S01010146,765,15,1,14,91,60,47,68,171,188,99,55,44,26
S01010147,953,12,8,4,77,105,43,74,238,210,178,106,72,16
S01010148,784,11,0,11,59,75,33,89,191,170,132,73,59,24
S01010149,499,22,0,22,106,70,64,46,73,86,26,18,8,6
S01010150,604,11,2,9,50,65,33,70,135,162,67,56,11,11
S01010151,625,18,2,16,66,87,30,41,148,163,57,34,23,15
S01010152,851,21,8,13,79,122,49,102,165,248,37,24,13,28
S01010153,908,42,20,22,145,84,62,104,189,213,47,32,15,22
S01010154,832,24,3,21,107,114,32,66,203,202,67,51,16,17
S01010155,700,23,4,19,89,107,27,95,147,167,42,27,15,3
S01010156,565,26,6,20,37,47,62,30,139,162,56,28,28,6
S01010157,569,11,2,9,61,59,20,42,142,157,77,41,36,0
S01010158,913,30,7,23,101,138,51,97,190,246,42,33,9,18
S01010159,723,18,3,15,98,66,60,86,168,192,27,21,6,8
S01010160,605,6,0,6,27,38,54,77,107,167,99,59,40,30
S01010161,636,26,9,17,84,44,62,66,163,143,46,39,7,2
S01010162,769,11,2,9,38,72,34,49,195,183,167,108,59,20
S01010163,597,11,5,6,48,71,23,47,128,179,69,48,21,21
S01010164,749,13,7,6,75,68,62,93,171,169,87,58,29,11
S01010165,627,0,0,0,59,48,14,42,174,153,122,102,20,15
S01010166,714,7,5,2,74,66,41,87,191,190,47,35,12,11
S01010167,792,8,2,6,45,94,42,62,181,260,84,51,33,16
S01010168,506,8,4,4,68,68,39,45,119,101,58,33,25,0
S01010169,842,11,0,11,144,61,48,68,217,168,109,73,36,16
S01010170,533,3,0,3,62,41,30,46,130,147,63,37,26,11
S01010171,1038,11,3,8,67,90,58,114,225,244,217,155,62,12
S01010172,696,15,0,15,107,115,35,79,105,162,74,51,23,4
S01010173,764,27,4,23,86,102,66,103,163,163,50,39,11,4
S01010174,583,31,10,21,104,91,55,83,67,112,33,24,9,7
S01010175,480,19,8,11,74,82,38,34,76,131,26,16,10,0
S01010176,705,25,6,19,90,98,54,68,147,146,58,40,18,19
S01010177,776,16,7,9,65,86,37,66,161,195,124,86,38,26
S01010178,1033,17,5,12,86,110,35,83,244,255,192,139,53,11
S01010179,837,7,0,7,56,90,31,65,172,291,99,80,19,26
S01010180,560,28,1,27,99,75,48,51,114,83,45,38,7,17
S01010181,631,8,1,7,70,60,40,38,147,133,130,80,50,5
S01010182,667,68,27,41,137,71,87,63,116,96,19,13,6,10
S01010183,463,16,0,16,50,51,16,57,108,120,36,26,10,9
S01010184,624,10,3,7,56,80,21,66,172,148,63,27,36,8
S01010185,633,6,2,4,67,40,30,72,176,161,64,30,34,17
S01010186,647,31,12,19,159,88,88,67,87,109,16,8,8,2
S01010187,635,32,9,23,146,97,50,86,94,99,14,7,7,17
S01010188,681,89,28,61,161,88,92,69,74,69,29,26,3,10
S01010189,976,115,14,101,288,141,113,121,64,115,10,9,1,9
S01010190,740,184,47,137,181,46,147,66,59,19,16,7,9,22
S01010191,736,102,5,97,217,86,87,79,76,77,8,4,4,4
S01010192,869,148,23,125,214,106,97,112,83,81,21,16,5,7
S01010193,739,92,19,73,203,93,114,90,94,33,12,10,2,8
S01010194,628,18,0,18,99,90,34,78,122,153,30,25,5,4
S01010195,531,22,5,17,46,89,36,48,106,144,38,30,8,2
S01010196,690,17,5,12,75,93,21,68,142,219,48,40,8,7
S01010197,660,6,0,6,79,67,19,53,174,214,40,24,16,8
S01010198,949,19,3,16,110,105,72,96,226,246,58,45,13,17
S01010199,521,19,0,19,49,51,26,37,104,148,82,58,24,5
S01010200,690,7,2,5,101,99,54,67,141,185,32,25,7,4
S01010201,643,22,18,4,66,83,45,94,123,169,35,15,20,6
S01010202,783,16,0,16,68,79,35,48,208,159,139,101,38,31
S01010203,671,67,19,48,125,83,55,95,103,102,26,22,4,15
S01010204,800,3,0,3,59,77,30,83,208,215,114,93,21,11
S01010205,658,24,2,22,96,51,36,61,116,176,73,52,21,25
S01010206,497,18,2,16,12,20,18,23,54,47,259,240,19,46
S01010207,778,19,5,14,86,20,55,40,114,121,268,241,27,55
S01010208,903,37,4,33,184,146,58,84,122,172,65,38,27,35
S01010209,880,54,7,47,110,119,38,109,169,175,94,46,48,12
S01010210,885,41,0,41,158,107,55,83,176,206,43,27,16,16
S01010211,858,15,4,11,92,111,30,104,203,203,90,59,31,10
S01010212,1030,26,0,26,81,101,22,105,236,240,168,112,56,51
S01010213,924,21,8,13,89,131,20,124,229,245,59,46,13,6
S01010214,967,55,4,51,170,120,95,154,168,167,35,17,18,3
S01010215,842,10,2,8,64,106,37,104,198,199,99,54,45,25
S01010216,621,14,2,12,68,57,43,32,168,130,92,62,30,17
S01010217,817,23,8,15,72,62,9,76,178,180,176,112,64,41
S01010218,1018,35,5,30,153,129,55,91,240,164,126,81,45,25
S01010219,503,15,6,9,47,49,12,44,123,77,83,62,21,53
S01010220,476,99,2,97,105,54,32,20,43,33,9,6,3,81
S01010221,465,9,3,6,43,41,10,56,125,94,73,57,16,14
S01010222,492,23,9,14,46,61,26,69,98,95,42,24,18,32
S01010223,552,26,6,20,65,55,29,72,104,118,56,48,8,27
S01010224,989,40,6,34,106,71,26,67,206,240,188,134,54,45
S01010225,812,30,3,27,138,80,19,54,157,155,127,109,18,52
S01010226,816,35,0,35,65,48,73,81,181,128,144,108,36,61
S01010227,692,38,4,34,46,20,30,53,119,128,209,181,28,49
S01010228,642,9,3,6,37,60,35,43,168,200,82,71,11,8
S01010229,1016,40,5,35,145,85,49,104,219,253,90,75,15,31
S01010230,1005,42,6,36,73,69,37,71,206,207,169,130,39,131
S01010231,1013,49,0,49,101,122,41,67,292,185,114,73,41,42
S01010232,1074,47,10,37,79,104,53,63,216,248,185,128,57,79
S01010233,970,22,0,22,97,59,52,72,202,180,231,167,64,55
S01010234,940,106,7,99,202,110,61,57,150,115,42,29,13,97
S01010235,782,157,10,147,201,64,14,52,56,25,18,9,9,195
S01010236,725,80,13,67,190,83,45,82,96,55,30,25,5,64
S01010237,644,75,10,65,165,77,41,55,92,68,17,5,12,54
S01010238,826,67,5,62,161,103,58,67,112,95,51,29,22,112
S01010239,790,33,3,30,75,102,20,50,196,186,78,34,44,50
S01010240,691,53,6,47,145,105,13,52,125,115,35,26,9,48
S01010241,980,70,19,51,183,126,53,69,170,183,58,31,27,68
S01010242,793,43,0,43,103,97,45,46,137,158,100,69,31,64
S01010243,1019,27,5,22,126,149,34,67,184,196,170,99,71,66
S01010244,735,23,2,21,75,68,26,64,137,153,125,83,42,64
S01010245,952,8,5,3,52,51,30,48,205,334,191,146,45,33
S01010246,841,11,0,11,84,63,32,95,208,202,99,67,32,47
S01010247,728,18,3,15,117,121,58,106,107,163,29,23,6,9
S01010248,834,129,6,123,245,72,52,60,86,81,12,5,7,97
S01010249,668,64,12,52,169,74,16,59,82,64,25,16,9,115
S01010250,771,111,13,98,195,71,39,50,69,61,19,18,1,156
S01010251,665,109,1,108,164,74,40,43,52,45,18,12,6,120
S01010252,614,81,0,81,179,68,55,30,68,74,22,19,3,37
S01010253,631,14,2,12,69,63,22,66,125,121,94,69,25,57
S01010254,1054,54,7,47,156,137,41,71,222,227,73,63,10,73
S01010255,718,16,2,14,70,80,36,63,130,186,98,65,33,39
S01010256,859,20,0,20,111,97,44,51,218,180,92,49,43,46
S01010257,773,68,7,61,115,33,21,24,57,82,39,29,10,334
S01010258,728,109,14,95,115,40,9,19,23,21,11,6,5,381
S01010259,766,32,3,29,51,63,44,51,143,162,97,65,32,123
S01010260,1012,141,7,134,169,96,51,78,95,77,50,38,12,255
S01010261,905,24,3,21,67,89,16,67,119,175,85,66,19,263
S01010262,844,29,7,22,60,57,30,73,167,216,74,52,22,138
S01010263,651,127,11,116,163,44,24,24,38,29,16,6,10,186
S01010264,762,144,9,135,153,68,26,32,66,59,27,17,10,187
S01010265,860,200,23,177,191,61,30,40,31,12,6,2,4,289
S01010266,521,85,10,75,97,30,37,35,33,33,25,17,8,146
S01010267,608,73,3,70,82,23,29,39,37,32,9,3,6,284
S01010268,728,79,5,74,148,63,55,38,75,50,37,32,5,183
S01010269,528,69,8,61,66,47,31,36,43,19,29,20,9,188
S01010270,1100,81,12,69,167,97,56,96,156,188,73,53,20,186
S01010271,723,66,8,58,109,48,36,28,60,29,34,27,7,313
S01010272,1013,101,5,96,160,94,43,59,151,106,144,102,42,155
S01010273,655,120,10,110,144,75,24,26,17,14,20,14,6,215
S01010274,536,124,9,115,97,41,25,20,33,17,4,3,1,175
S01010275,592,107,10,97,109,35,31,41,23,18,10,8,2,218
S01010276,993,281,32,249,273,82,53,47,38,23,26,14,12,170
S01010277,610,24,3,21,77,68,14,62,101,184,32,27,5,48
S01010278,650,29,3,26,102,54,43,78,146,104,59,41,18,35
S01010279,605,66,12,54,103,69,24,55,77,54,27,12,15,130
S01010280,782,131,13,118,170,103,31,40,64,65,18,14,4,160
S01010281,779,127,6,121,175,61,44,35,65,43,9,5,4,220
S01010282,976,128,9,119,203,73,37,80,103,143,47,32,15,162
S01010283,539,112,7,105,114,54,17,25,56,33,36,24,12,92
S01010284,1002,187,4,183,270,115,41,42,45,50,34,21,13,218
S01010285,838,92,8,84,185,65,48,48,64,66,50,26,24,220
S01010286,736,126,9,117,131,58,41,45,61,61,22,21,1,191
S01010287,874,115,15,100,172,58,48,60,33,30,17,13,4,341
S01010288,810,158,18,140,179,51,84,23,45,11,12,8,4,247
S01010289,717,264,31,233,203,35,69,38,22,11,4,3,1,71
S01010290,546,73,10,63,129,53,27,35,29,29,22,20,2,149
S01010291,1003,88,4,84,190,93,26,53,114,51,36,22,14,352
S01010292,890,141,8,133,196,71,45,44,51,40,23,13,10,279
S01010293,839,89,4,85,135,55,60,65,81,32,58,36,22,264
S01010294,690,57,1,56,116,47,23,53,32,37,20,20,0,305
S01010295,974,106,8,98,135,60,74,65,95,47,36,27,9,356
S01010296,664,75,2,73,103,43,37,52,83,76,34,28,6,161
S01010297,1066,78,7,71,139,109,60,99,155,174,100,78,22,152
S01010298,843,92,9,83,155,107,42,59,127,90,46,35,11,125
S01010299,536,33,2,31,65,51,46,70,100,83,58,42,16,30
S01010300,889,78,15,63,154,100,31,41,128,109,61,56,5,187
S01010301,516,64,9,55,88,40,33,33,33,40,36,21,15,149
S01010302,658,23,1,22,55,49,33,100,98,105,142,102,40,53
S01010303,579,10,0,10,55,28,42,57,95,89,164,142,22,39
S01010304,542,42,1,41,74,43,17,59,95,68,67,39,28,77
S01010305,797,72,9,63,131,90,54,69,100,121,64,51,13,96
S01010306,752,120,10,110,186,63,27,46,81,33,42,21,21,154
S01010307,821,179,6,173,237,76,45,27,66,34,19,5,14,138
S01010308,959,229,18,211,244,54,45,34,82,42,31,21,10,198
S01010309,419,8,2,6,45,39,8,33,97,111,61,45,16,17
S01010310,706,18,4,14,56,57,24,92,145,139,112,77,35,63
S01010311,714,8,0,8,48,54,22,80,144,176,136,101,35,46
S01010312,857,2,1,1,70,65,27,69,214,218,162,108,54,30
S01010313,636,26,7,19,39,37,26,47,167,163,100,67,33,31
S01010314,955,38,5,33,155,98,42,46,187,168,111,74,37,110
S01010315,911,80,8,72,141,94,57,82,155,168,96,77,19,38
S01010316,512,41,3,38,64,47,15,29,128,89,62,56,6,37
S01010317,725,112,4,108,191,70,40,44,42,39,17,12,5,170
S01010318,505,24,2,22,72,60,34,32,119,64,47,13,34,53
S01010319,711,134,14,120,124,97,48,48,90,66,19,11,8,85
S01010320,670,87,4,83,125,64,19,39,83,90,57,40,17,106
S01010321,695,61,1,60,139,82,33,51,113,84,56,25,31,76
S01010322,1028,282,15,267,292,75,67,41,62,41,12,8,4,156
S01010323,603,16,4,12,37,41,3,47,167,145,123,101,22,24
S01010324,759,8,0,8,84,76,42,57,181,240,58,38,20,13
S01010325,939,9,6,3,81,101,37,95,247,290,76,45,31,3
S01010326,986,14,0,14,70,75,44,88,258,201,207,134,73,29
S01010327,865,65,10,55,94,68,78,95,165,178,90,50,40,32
S01010328,969,46,6,40,156,95,87,119,165,209,53,30,23,39
S01010329,573,14,0,14,78,71,41,66,128,132,34,29,5,9
S01010330,663,13,0,13,50,57,37,69,154,180,97,57,40,6
S01010331,923,19,11,8,92,108,33,105,223,239,92,57,35,12
S01010332,708,1,1,0,88,56,27,86,200,143,91,67,24,16
S01010333,962,25,4,21,104,116,72,96,222,214,73,47,26,40
S01010334,927,30,3,27,140,129,49,99,224,190,56,43,13,10
S01010335,793,18,3,15,81,89,49,74,170,221,72,39,33,19
S01010336,657,17,0,17,39,66,30,44,160,155,110,65,45,36
S01010337,623,6,0,6,50,80,26,64,161,177,55,37,18,4
S01010338,751,6,1,5,71,73,38,79,159,192,115,86,29,18
S01010339,692,27,4,23,83,78,37,91,160,134,79,62,17,3
S01010340,752,30,7,23,94,94,48,93,181,117,79,33,46,16
S01010341,591,11,0,11,119,72,45,57,123,133,25,9,16,6
S01010342,633,39,10,29,135,67,55,99,106,109,9,3,6,14
S01010343,938,48,9,39,238,158,95,155,148,76,8,5,3,12
S01010344,690,15,2,13,59,72,30,80,156,179,88,38,50,11
S01010345,489,84,27,57,147,27,79,29,64,40,2,0,2,17
S01010346,981,142,26,116,222,144,86,97,164,97,17,14,3,12
S01010347,919,47,8,39,132,102,49,122,176,149,120,64,56,22
S01010348,980,34,2,32,141,139,50,128,245,176,53,30,23,14
S01010349,883,18,1,17,129,93,45,112,233,210,35,18,17,8
S01010350,950,21,11,10,109,109,35,88,240,214,113,63,50,21
S01010351,878,46,8,38,151,113,63,117,139,151,47,30,17,51
S01010352,506,20,1,19,66,52,16,50,108,125,54,29,25,15
S01010353,961,41,1,40,79,76,49,108,211,203,176,125,51,18
S01010354,733,39,10,29,91,73,35,74,182,134,72,41,31,33
S01010355,742,51,3,48,83,79,46,80,146,133,104,75,29,20
S01010356,682,56,4,52,143,69,48,86,101,95,60,26,34,24
S01010357,585,28,5,23,90,50,24,45,124,135,67,29,38,22
S01010358,842,28,12,16,75,76,38,81,204,204,104,53,51,32
S01010359,816,23,7,16,82,70,40,62,211,198,113,78,35,17
S01010360,567,21,0,21,97,54,26,62,100,116,66,35,31,25
S01010361,611,26,0,26,61,57,15,68,122,125,99,51,48,38
S01010362,783,34,5,29,61,78,10,74,142,199,131,82,49,54
S01010363,758,159,14,145,245,81,47,42,70,45,24,8,16,45
S01010364,915,226,37,189,307,114,109,67,48,28,9,9,0,7
S01010365,976,311,44,267,335,80,98,36,46,14,28,23,5,28
S01010366,1025,282,24,258,319,85,84,43,69,48,20,5,15,75
S01010367,1021,340,44,296,324,86,93,25,53,30,9,3,6,61
S01010368,676,281,48,233,202,52,52,20,31,5,1,0,1,32
S01010369,767,167,18,149,202,79,61,32,58,61,33,23,10,74
S01010370,725,223,29,194,213,48,76,39,7,27,6,5,1,86
S01010371,992,270,38,232,293,68,84,31,33,24,7,5,2,182
S01010372,529,139,28,111,174,56,40,29,25,29,4,4,0,33
S01010373,761,174,17,157,243,55,49,26,49,51,10,6,4,104
S01010374,950,289,24,265,280,46,73,36,28,20,8,4,4,170
S01010375,531,81,5,76,79,13,26,11,32,18,5,2,3,266
S01010376,708,94,8,86,168,26,35,23,31,21,20,17,3,290
S01010377,858,133,6,127,135,51,46,19,61,37,36,32,4,340
S01010378,730,137,11,126,85,32,39,12,22,4,25,7,18,374
S01010379,997,145,11,134,187,56,41,32,70,23,16,10,6,427
S01010380,958,220,32,188,286,80,54,20,63,50,16,5,11,169
S01010381,605,118,7,111,88,43,19,21,40,30,20,13,7,226
S01010382,850,141,8,133,187,80,45,49,84,46,24,13,11,194
S01010383,656,38,7,31,107,87,49,26,82,80,55,31,24,132
S01010384,812,181,22,159,202,54,42,44,44,53,18,11,7,174
S01010385,844,120,3,117,192,83,47,60,91,78,30,20,10,143
S01010386,889,68,7,61,168,95,51,55,140,120,58,37,21,134
S01010387,1040,190,9,181,259,83,33,48,104,88,40,20,20,195
S01010388,1008,77,1,76,199,137,59,73,146,165,58,25,33,94
S01010389,1022,281,36,245,282,70,49,35,48,43,17,8,9,197
S01010390,1076,184,14,170,292,144,53,66,99,90,39,11,28,109
S01010391,793,86,8,78,217,108,45,68,96,62,29,19,10,82
S01010392,695,221,21,200,226,58,44,14,17,19,9,3,6,87
S01010393,984,152,13,139,293,135,52,65,90,61,30,18,12,106
S01010394,807,89,5,84,155,91,59,48,133,118,78,47,31,36
S01010395,1006,148,14,134,256,121,45,81,107,88,40,20,20,120
S01010396,1033,203,12,191,216,114,52,63,120,112,37,19,18,116
S01010397,542,154,20,134,138,44,22,5,41,19,20,13,7,99
S01010398,1052,276,44,232,334,97,62,60,56,30,16,8,8,121
S01010399,1036,387,36,351,342,67,38,26,32,14,15,5,10,115
S01010400,1101,374,31,343,354,61,75,29,54,30,23,20,3,101
S01010401,717,219,21,198,177,70,46,23,37,35,6,2,4,104
S01010402,1031,407,39,368,304,77,68,24,36,31,17,6,11,67
S01010403,990,423,42,381,279,70,73,27,28,3,3,3,0,84
S01010404,783,243,27,216,266,44,103,25,28,38,9,8,1,27
S01010405,789,317,30,287,265,51,56,18,23,14,11,5,6,34
S01010406,822,226,23,203,213,53,76,23,45,27,11,4,7,148
S01010407,897,145,29,116,208,43,28,20,38,27,16,7,9,372
S01010408,547,129,21,108,128,79,49,24,48,63,15,13,2,12
S01010409,706,209,22,187,223,67,92,37,26,38,13,10,3,1
S01010410,595,222,36,186,169,61,61,24,22,16,9,4,5,11
S01010411,1104,467,54,413,351,63,110,41,18,18,20,16,4,16
S01010412,759,227,39,188,263,62,58,24,39,31,5,4,1,50
S01010413,714,241,28,213,231,68,72,29,27,12,20,16,4,14
S01010414,1066,289,27,262,376,125,70,50,66,46,14,12,2,30
S01010415,1004,127,17,110,208,113,106,94,114,146,44,19,25,52
S01010416,684,204,27,177,220,83,55,37,35,32,3,1,2,15
S01010417,580,190,18,172,187,61,48,20,38,15,5,4,1,16
S01010418,1056,382,26,356,361,76,81,33,57,19,19,11,8,28
S01010419,993,383,49,334,328,99,69,30,39,28,6,2,4,11
S01010420,717,211,23,188,229,54,64,49,50,47,11,8,3,2
S01010421,882,357,32,325,316,58,57,34,28,14,12,4,8,6
S01010422,1085,256,42,214,387,99,86,63,96,61,21,11,10,16
S01010423,831,61,9,52,136,103,31,47,152,145,98,64,34,58
S01010424,834,54,4,50,136,114,38,73,142,162,80,48,32,35
S01010425,1032,47,10,37,190,121,45,95,215,168,102,61,41,49
S01010426,708,55,9,46,162,80,46,69,125,83,63,36,27,25
S01010427,1053,61,4,57,142,86,89,96,197,156,198,139,59,28
S01010428,730,190,32,158,244,87,37,50,47,48,13,10,3,14
S01010429,967,257,39,218,384,85,54,48,69,20,26,13,13,24
S01010430,854,19,5,14,88,102,58,53,175,196,102,66,36,61
S01010431,700,211,41,170,261,59,57,40,23,32,8,8,0,9
S01010432,880,28,10,18,116,130,33,84,198,144,90,68,22,57
S01010433,803,20,0,20,51,30,75,63,166,126,214,167,47,58
S01010434,623,28,5,23,75,56,23,76,111,120,87,57,30,47
S01010435,634,28,2,26,102,87,28,91,128,138,22,17,5,10
S01010436,778,40,1,39,115,110,53,60,136,128,96,54,42,40
S01010437,557,17,8,9,108,72,27,31,120,128,35,21,14,19
S01010438,854,26,2,24,149,69,54,94,193,146,91,67,24,32
S01010439,973,38,6,32,197,140,38,84,136,206,61,40,21,73
S01010440,650,44,10,34,99,83,35,63,110,111,93,71,22,12
S01010441,783,85,11,74,200,148,33,84,91,73,39,11,28,30
S01010442,741,24,2,22,138,102,35,87,151,121,62,35,27,21
S01010443,550,23,2,21,96,101,50,70,108,75,21,5,16,6
S01010444,685,35,4,31,77,104,48,55,137,174,50,26,24,5
S01010445,777,32,4,28,100,66,54,77,155,199,80,69,11,14
S01010446,838,60,12,48,197,89,119,109,104,134,17,12,5,9
S01010447,1028,35,1,34,138,148,67,118,202,194,91,48,43,35
S01010448,859,90,30,60,187,121,82,89,138,127,23,15,8,2
S01010449,779,39,1,38,124,117,33,74,146,204,32,28,4,10
S01010450,783,40,8,32,156,98,44,94,151,140,48,33,15,12
S01010451,829,60,9,51,115,96,62,56,178,146,98,55,43,18
S01010452,813,35,6,29,171,137,37,110,135,143,37,21,16,8
S01010453,664,37,0,37,94,71,42,65,106,92,132,81,51,25
S01010454,789,40,5,35,118,113,58,109,128,180,25,19,6,18
S01010455,942,36,1,35,132,134,51,84,192,199,94,63,31,20
S01010456,565,30,5,25,99,83,30,78,101,109,26,18,8,9
S01010457,642,45,7,38,94,73,52,62,127,117,60,44,16,12
S01010458,771,24,9,15,125,118,40,90,179,110,57,44,13,28
S01010459,539,41,3,38,85,75,49,41,107,93,34,30,4,14
S01010460,741,220,33,187,202,63,86,39,47,57,12,11,1,15
S01010461,732,28,3,25,152,83,52,48,146,136,68,43,25,19
S01010462,899,9,2,7,55,25,47,53,137,184,314,228,86,75
S01010463,796,105,18,87,177,123,81,65,107,88,46,16,30,4
S01010464,524,42,12,30,132,84,37,62,78,66,17,9,8,6
S01010465,947,108,12,96,350,145,35,71,115,83,20,11,9,20
S01010466,879,186,32,154,278,96,66,45,64,42,30,17,13,72
S01010467,837,166,23,143,265,100,76,49,87,31,23,19,4,40
S01010468,949,210,19,191,273,131,101,28,88,57,19,15,4,42
S01010469,559,72,6,66,140,85,27,59,50,54,33,14,19,39
S01010470,718,38,10,28,181,115,70,76,103,97,29,17,12,9
S01010471,666,50,6,44,110,59,17,80,104,157,81,62,19,8
S01010472,514,119,13,106,125,61,25,42,45,39,18,6,12,40
S01010473,756,89,7,82,204,103,46,57,101,96,23,11,12,37
S01010474,820,93,8,85,191,93,46,61,105,89,52,34,18,90
S01010475,677,124,10,114,226,108,34,42,55,44,5,4,1,39
S01010476,1015,148,11,137,228,144,79,74,126,135,30,19,11,51
S01010477,724,51,7,44,144,121,31,87,128,133,20,17,3,9
S01010478,991,34,8,26,175,138,54,84,208,219,63,47,16,16
S01010479,1022,46,13,33,200,153,70,99,211,187,37,14,23,19
S01010480,616,78,28,50,86,103,56,62,109,84,29,25,4,9
S01010481,667,7,1,6,75,67,49,82,122,158,101,69,32,6
S01010482,794,50,20,30,136,152,57,74,158,129,33,25,8,5
S01010483,1036,72,12,60,180,123,98,81,233,197,40,31,9,12
S01010484,550,27,6,21,82,79,41,84,106,90,34,24,10,7
S01010485,986,76,29,47,264,155,68,90,116,134,70,45,25,13
S01010486,930,81,16,65,244,161,147,90,100,85,21,16,5,1
S01010487,1010,55,13,42,208,169,72,117,150,194,39,18,21,6
S01010488,822,29,5,24,55,91,32,59,231,180,136,81,55,9
S01010489,932,28,7,21,127,129,43,112,214,182,82,52,30,15
S01010490,749,22,0,22,45,97,37,69,179,158,113,66,47,29
S01010491,906,11,8,3,70,106,38,55,264,185,160,110,50,17
S01010492,575,11,5,6,36,56,21,52,133,153,97,75,22,16
S01010493,719,14,2,12,20,65,37,61,165,180,145,68,77,32
S01010494,628,26,9,17,70,58,43,73,131,131,74,47,27,22
S01010495,858,15,8,7,90,106,33,81,182,204,135,87,48,12
S01010496,812,10,0,10,76,81,29,66,161,200,171,134,37,18
S01010497,749,10,1,9,82,72,51,67,168,167,125,93,32,7
S01010498,839,13,2,11,44,83,28,70,184,262,131,84,47,24
S01010499,804,8,0,8,44,51,32,65,199,184,192,142,50,29
S01010500,1078,60,14,46,122,88,43,67,247,239,193,110,83,19
S01010501,928,22,5,17,105,111,54,111,200,225,94,62,32,6
S01010502,803,14,1,13,102,129,60,93,185,146,52,45,7,22
S01010503,655,7,0,7,70,87,27,60,158,166,70,55,15,10
S01010504,531,51,1,50,118,40,213,29,42,35,3,2,1,0
S01010505,558,43,2,41,121,13,173,38,94,55,16,9,7,5
S01010506,828,48,7,41,221,53,231,78,91,87,10,8,2,9
S01010507,794,44,14,30,164,48,142,111,169,89,23,8,15,4
S01010508,962,97,28,69,218,73,165,114,176,99,13,9,4,7
S01010509,922,74,12,62,236,73,190,136,138,60,15,4,11,0
S01010510,777,58,11,47,177,95,108,118,124,91,6,4,2,0
S01010511,870,32,8,24,154,47,67,165,182,205,15,9,6,3
S01010512,611,25,5,20,130,44,73,98,103,125,13,5,8,0
S01010513,757,88,31,57,162,48,137,143,90,79,7,4,3,3
S01010514,709,33,16,17,119,63,71,113,125,170,14,8,6,1
S01010515,799,22,8,14,120,50,55,146,164,225,15,4,11,2
S01010516,557,55,13,42,146,36,124,52,71,54,14,1,13,5
S01010517,858,78,24,54,186,70,74,111,138,140,48,19,29,13
S01010518,656,47,26,21,130,60,78,94,104,116,12,5,7,15
S01010519,748,44,11,33,166,54,55,91,141,139,55,20,35,3
S01010520,945,65,24,41,184,92,96,167,157,165,8,5,3,11
S01010521,750,31,6,25,187,46,97,117,134,124,9,6,3,5
S01010522,581,34,17,17,93,55,78,65,111,107,30,26,4,8
S01010523,644,15,0,15,93,50,48,76,175,164,23,7,16,0
S01010524,504,51,12,39,112,28,131,73,60,42,4,4,0,3
S01010525,624,73,25,48,134,61,159,66,77,48,6,2,4,0
S01010526,787,76,17,59,138,80,165,108,122,87,6,4,2,5
S01010527,889,43,15,28,205,76,68,156,156,152,16,9,7,17
S01010528,611,71,5,66,150,30,137,74,86,41,6,5,1,16
S01010529,698,77,12,65,177,37,127,86,85,104,4,0,4,1
S01010530,645,59,22,37,135,45,184,71,75,71,5,2,3,0
S01010531,1067,116,38,78,217,103,242,140,132,108,5,5,0,4
S01010532,545,75,27,48,90,34,122,106,51,58,6,5,1,3
S01010533,561,71,27,44,145,28,103,65,81,58,9,4,5,1
S01010534,882,92,25,67,184,78,141,118,148,107,14,9,5,0
S01010535,699,76,22,54,205,50,145,87,62,56,5,3,2,13
S01010536,840,48,23,25,163,89,91,148,131,152,18,7,11,0
S01010537,668,45,10,35,128,63,103,125,91,99,11,3,8,3
S01010538,849,72,15,57,175,93,105,145,130,116,6,3,3,7
S01010539,1005,85,22,63,286,110,151,147,116,89,15,3,12,6
S01010540,626,106,33,73,126,52,113,69,76,72,7,3,4,5
S01010541,819,72,17,55,221,85,131,121,87,92,6,2,4,4
S01010542,880,96,23,73,221,58,185,125,94,78,19,12,7,4
S01010543,600,64,21,43,132,46,204,29,68,57,0,0,0,0
S01010544,864,51,7,44,169,45,133,122,146,161,36,6,30,1
S01010545,727,86,24,62,184,59,123,55,81,116,19,7,12,4
S01010546,733,78,18,60,140,65,117,90,106,119,18,7,11,0
S01010547,754,75,29,46,162,55,177,125,79,62,11,5,6,8
S01010548,677,78,19,59,168,72,136,78,71,62,9,5,4,3
S01010549,941,110,23,87,326,75,70,144,106,91,4,2,2,15
S01010550,535,60,11,49,116,57,60,69,78,81,8,6,2,6
S01010551,685,125,25,100,159,37,162,65,49,77,8,0,8,3
S01010552,783,128,28,100,148,62,157,94,74,106,11,7,4,3
S01010553,621,89,30,59,140,66,157,62,71,24,4,4,0,8
S01010554,776,47,13,34,210,83,109,84,106,105,29,15,14,3
S01010555,924,90,22,68,207,90,106,98,138,146,36,14,22,13
S01010556,926,56,17,39,137,78,84,148,194,190,33,11,22,6
S01010557,641,68,16,52,130,43,43,86,121,122,24,13,11,4
S01010558,800,68,26,42,183,66,108,114,114,123,24,12,12,0
S01010559,728,147,23,124,247,61,96,57,59,47,10,5,5,4
S01010560,663,118,7,111,178,57,66,107,65,55,14,6,8,3
S01010561,697,128,25,103,194,79,105,49,65,63,10,5,5,4
S01010562,731,41,5,36,204,96,73,140,90,76,11,5,6,0
S01010563,519,49,18,31,112,34,53,61,67,118,20,0,20,5
S01010564,500,14,1,13,77,35,59,72,96,113,30,14,16,4
S01010565,654,61,18,43,152,55,51,109,109,94,16,7,9,7
S01010566,1088,164,68,96,256,61,204,169,120,86,9,5,4,19
S01010567,983,169,49,120,320,69,198,85,65,73,4,0,4,0
S01010568,977,154,27,127,218,86,164,115,123,105,10,6,4,2
S01010569,712,110,22,88,141,58,164,71,80,78,10,9,1,0
S01010570,1089,72,7,65,177,100,103,152,232,210,33,15,18,10
S01010571,776,73,14,59,191,126,60,117,96,105,5,2,3,3
S01010572,765,49,5,44,131,94,66,100,139,157,24,2,22,5
S01010573,534,40,23,17,99,34,35,96,108,113,4,2,2,5
S01010574,609,109,26,83,210,57,71,56,42,58,2,1,1,4
S01010575,686,95,32,63,214,118,62,60,75,49,11,4,7,2
S01010576,822,145,16,129,270,94,100,77,84,40,7,5,2,5
S01010577,901,26,7,19,143,80,86,126,208,193,27,24,3,12
S01010578,576,27,10,17,118,67,68,90,93,100,9,9,0,4
S01010579,736,59,12,47,204,85,85,127,96,74,3,2,1,3
S01010580,513,43,1,42,106,76,34,60,83,84,19,18,1,8
S01010581,522,47,14,33,157,56,42,78,53,69,13,9,4,7
S01010582,451,85,22,63,113,53,60,71,36,32,0,0,0,1
S01010583,986,91,15,76,355,148,69,116,110,89,3,1,2,5
S01010584,819,109,37,72,226,99,110,99,87,65,18,13,5,6
S01010585,844,120,40,80,236,121,96,129,84,44,13,4,9,1
S01010586,783,154,57,97,264,71,78,101,70,38,4,0,4,3
S01010587,687,91,22,69,230,74,83,88,67,42,5,5,0,7
S01010588,649,101,30,71,203,85,58,57,76,55,11,10,1,3
S01010589,620,34,3,31,105,89,38,71,133,113,27,23,4,10
S01010590,889,257,74,183,309,75,89,65,46,41,7,3,4,0
S01010591,767,71,17,54,248,88,59,117,67,67,34,10,24,16
S01010592,509,46,4,42,144,77,25,48,89,57,19,11,8,4
S01010593,651,120,34,86,221,61,101,56,43,47,2,2,0,0
S01010594,668,61,11,50,195,81,59,120,79,58,12,8,4,3
S01010595,837,135,23,112,266,73,68,107,75,84,15,2,13,14
S01010596,834,164,35,129,228,82,135,82,69,62,5,1,4,7
S01010597,644,67,19,48,231,62,73,79,64,45,16,13,3,7
S01010598,1041,181,35,146,351,113,83,107,105,70,16,14,2,15
S01010599,607,118,32,86,172,91,45,66,53,52,5,3,2,5
S01010600,911,140,31,109,308,93,116,77,100,67,8,7,1,2
S01010601,676,103,4,99,210,81,71,84,48,66,13,6,7,0
S01010602,522,72,17,55,138,42,61,79,69,57,3,3,0,1
S01010603,809,115,37,78,275,110,59,95,58,83,13,5,8,1
S01010604,494,95,14,81,176,48,66,51,32,15,8,5,3,3
S01010605,891,138,34,104,246,111,123,105,91,60,14,14,0,3
S01010606,816,35,12,23,132,73,103,131,121,184,18,8,10,19
S01010607,846,160,59,101,279,89,118,54,82,60,2,1,1,2
S01010608,673,42,7,35,78,71,41,84,164,116,61,11,50,16
S01010609,570,24,1,23,98,49,39,69,104,163,15,7,8,9
S01010610,639,130,23,107,198,78,71,56,50,39,6,5,1,11
S01010611,925,23,0,23,210,97,57,172,188,150,23,13,10,5
S01010612,781,41,4,37,164,98,60,119,139,153,7,3,4,0
S01010613,698,90,16,74,185,88,49,77,73,114,10,9,1,12
S01010614,542,2,1,1,85,57,30,78,133,130,19,8,11,8
S01010615,824,84,11,73,234,109,66,111,87,118,7,0,7,8
S01010616,856,91,18,73,260,118,72,123,93,87,3,3,0,9
S01010617,904,79,24,55,327,121,55,96,145,78,0,0,0,3
S01010618,756,63,12,51,206,116,86,84,101,89,3,0,3,8
S01010619,619,34,5,29,106,52,49,75,111,158,14,11,3,20
S01010620,614,48,5,43,94,64,26,67,135,112,48,28,20,20
S01010621,904,204,25,179,212,58,77,78,127,101,26,16,10,21
S01010622,648,15,0,15,134,55,34,77,151,146,29,3,26,7
S01010623,867,67,40,27,364,179,58,57,80,43,9,5,4,10
S01010624,546,43,2,41,140,62,30,67,70,110,20,1,19,4
S01010625,761,205,36,169,249,87,105,42,43,22,8,2,6,0
S01010626,818,209,36,173,250,70,101,49,60,67,12,8,4,0
S01010627,778,116,13,103,206,56,92,71,119,85,20,15,5,13
S01010628,904,131,19,112,247,104,80,91,117,112,8,4,4,14
S01010629,914,189,34,155,267,79,108,64,104,80,15,2,13,8
S01010630,551,38,7,31,102,66,73,55,99,77,39,27,12,2
S01010631,588,72,6,66,118,90,52,76,91,70,15,13,2,4
S01010632,956,42,9,33,166,101,99,131,197,186,24,8,16,10
S01010633,1035,28,3,25,144,108,79,166,192,256,38,18,20,24
S01010634,665,28,8,20,84,57,68,110,131,174,9,4,5,4
S01010635,803,26,9,17,150,100,56,99,148,171,35,17,18,18
S01010636,808,88,22,66,187,89,102,64,131,130,12,7,5,5
S01010637,519,45,10,35,87,51,35,74,101,90,27,19,8,9
S01010638,785,54,8,46,157,64,107,86,134,171,8,3,5,4
S01010639,1121,61,8,53,150,105,72,195,246,230,41,22,19,21
S01010640,792,83,14,69,161,47,98,109,157,93,28,12,16,16
S01010641,1015,63,7,56,122,96,72,64,285,227,77,40,37,9
S01010642,978,20,10,10,96,62,73,139,222,258,95,51,44,13
S01010643,741,0,0,0,96,67,48,103,174,176,74,38,36,3
S01010644,665,11,0,11,65,34,29,59,184,199,69,34,35,15
S01010645,534,60,13,47,103,67,52,78,71,89,8,5,3,6
S01010646,669,92,26,66,205,91,53,81,69,67,7,3,4,4
S01010647,616,63,15,48,169,67,54,93,67,91,8,2,6,4
S01010648,651,63,11,52,147,96,64,67,93,101,16,5,11,4
S01010649,556,57,19,38,168,65,55,52,74,69,7,3,4,9
S01010650,452,30,2,28,119,48,74,25,77,58,15,7,8,6
S01010651,665,20,8,12,101,105,77,82,135,134,7,5,2,4
S01010652,718,70,18,52,225,87,60,79,85,83,25,9,16,4
S01010653,584,37,5,32,137,89,60,86,67,101,7,6,1,0
S01010654,763,13,3,10,143,104,71,81,185,140,16,9,7,10
S01010655,909,126,35,91,241,72,235,65,105,56,9,2,7,0
S01010656,475,44,10,34,101,31,82,57,86,67,5,1,4,2
S01010657,639,118,30,88,144,60,139,76,45,46,7,0,7,4
S01010658,732,146,26,120,190,62,110,78,74,69,3,0,3,0
S01010659,648,131,29,102,158,54,122,47,67,54,15,14,1,0
S01010660,606,44,7,37,170,59,103,66,68,88,6,6,0,2
S01010661,568,28,11,17,130,65,85,85,86,67,15,12,3,7
S01010662,758,117,27,90,173,74,153,79,70,77,11,10,1,4
S01010663,953,119,17,102,267,79,212,80,97,87,6,4,2,6
S01010664,819,134,25,109,207,80,221,69,45,52,8,2,6,3
S01010665,952,118,37,81,221,96,186,117,98,104,7,4,3,5
S01010666,941,104,30,74,221,80,163,144,135,79,10,4,6,5
S01010667,695,97,14,83,172,54,182,54,45,72,15,9,6,4
S01010668,1082,80,26,54,267,85,239,179,107,108,9,4,5,8
S01010669,602,96,28,68,152,39,122,71,71,45,5,4,1,1
S01010670,683,70,22,48,153,60,133,69,97,83,18,8,10,0
S01010671,723,87,6,81,153,50,156,58,129,70,18,10,8,2
S01010672,648,30,9,21,92,73,129,83,122,100,14,2,12,5
S01010673,880,92,7,85,214,70,191,76,113,98,23,5,18,3
S01010674,951,99,8,91,221,60,240,82,130,93,9,0,9,17
S01010675,627,44,13,31,115,32,198,64,102,61,11,2,9,0
S01010676,846,108,26,82,210,86,174,78,90,88,7,6,1,5
S01010677,499,70,15,55,123,24,129,54,48,48,2,1,1,1
S01010678,610,39,8,31,141,30,144,75,65,103,13,10,3,0
S01010679,552,39,7,32,143,59,109,57,62,68,13,6,7,2
S01010680,621,34,1,33,142,57,98,52,88,123,24,5,19,3
S01010681,1067,47,14,33,254,79,194,124,180,135,52,21,31,2
S01010682,963,96,10,86,229,104,240,71,75,132,15,10,5,1
S01010683,956,69,10,59,213,74,229,109,113,124,18,6,12,7
S01010684,756,67,17,50,180,76,214,64,93,58,4,2,2,0
S01010685,609,64,14,50,136,44,155,66,62,66,16,6,10,0
S01010686,690,53,6,47,142,29,171,103,96,81,13,5,8,2
S01010687,805,85,18,67,187,80,159,88,111,86,5,3,2,4
S01010688,692,78,13,65,198,57,191,43,65,54,3,1,2,3
S01010689,754,114,10,104,174,53,170,59,104,70,7,6,1,3
S01010690,651,30,7,23,140,71,151,80,72,78,27,10,17,2
S01010691,743,98,22,76,161,59,248,65,61,44,7,4,3,0
S01010692,711,67,8,59,145,56,141,112,131,54,2,2,0,3
S01010693,472,69,27,42,120,27,145,45,37,28,1,1,0,0
S01010694,554,76,14,62,121,37,115,71,62,65,5,0,5,2
S01010695,707,105,14,91,166,71,179,76,66,41,2,0,2,1
S01010696,970,133,17,116,182,97,151,105,114,166,13,9,4,9
S01010697,1072,162,24,138,226,72,212,139,109,135,10,6,4,7
S01010698,757,70,11,59,134,59,162,78,123,115,12,7,5,4
S01010699,605,76,29,47,126,32,125,106,73,57,5,0,5,5
S01010700,611,93,17,76,160,41,118,64,68,58,6,4,2,3
S01010701,1063,117,12,105,251,108,147,130,134,160,14,9,5,2
S01010702,957,117,22,95,209,80,199,125,95,114,12,5,7,6
S01010703,824,98,16,82,193,60,191,92,72,103,7,4,3,8
S01010704,658,59,12,47,121,74,63,84,97,149,8,8,0,3
S01010705,1121,118,26,92,244,103,175,150,121,167,35,16,19,8
S01010706,671,32,13,19,111,58,84,99,132,128,22,14,8,5
S01010707,676,83,14,69,171,57,154,72,72,60,4,4,0,3
S01010708,546,38,0,38,120,68,85,72,76,64,23,12,11,0
S01010709,745,104,33,71,178,71,87,83,97,112,12,3,9,1
S01010710,766,35,0,35,122,89,77,101,117,178,36,25,11,11
S01010711,778,160,39,121,253,82,87,40,83,60,5,4,1,8
S01010712,723,45,14,31,118,75,70,105,109,175,14,7,7,12
S01010713,799,49,20,29,121,78,74,140,141,185,8,5,3,3
S01010714,748,30,8,22,111,82,54,98,156,179,30,18,12,8
S01010715,701,47,10,37,107,82,71,93,159,118,21,5,16,3
S01010716,834,96,17,79,177,86,67,86,135,158,21,9,12,8
S01010717,621,112,25,87,175,83,66,56,83,39,7,7,0,0
S01010718,945,91,9,82,264,95,116,107,124,113,30,18,12,5
S01010719,634,104,17,87,168,57,68,89,59,67,14,7,7,8
S01010720,731,177,32,145,203,36,99,82,72,54,8,8,0,0
S01010721,630,98,15,83,197,69,110,49,53,48,4,3,1,2
S01010722,867,98,31,67,239,72,123,89,116,99,22,16,6,9
S01010723,901,162,43,119,262,57,229,81,53,52,5,4,1,0
S01010724,887,131,46,85,236,63,192,75,93,79,18,7,11,0
S01010725,691,155,33,122,177,43,174,38,47,49,8,4,4,0
S01010726,921,125,44,81,253,100,164,92,83,94,10,1,9,0
S01010727,645,117,20,97,148,69,146,49,51,55,10,10,0,0
S01010728,521,93,36,57,165,67,71,56,34,27,7,3,4,1
S01010729,723,114,23,91,158,82,148,81,54,84,0,0,0,2
S01010730,845,117,17,100,251,62,210,78,50,65,8,6,2,4
S01010731,891,105,21,84,221,83,149,89,129,95,15,2,13,5
S01010732,840,48,2,46,88,55,72,122,180,204,57,39,18,14
S01010733,580,10,0,10,80,76,49,86,122,110,36,31,5,11
S01010734,894,46,15,31,128,65,89,63,193,245,60,49,11,5
S01010735,644,28,12,16,97,44,39,70,125,167,67,42,25,7
S01010736,500,60,13,47,134,34,51,75,87,55,4,4,0,0
S01010737,1012,76,10,66,211,75,117,128,160,215,29,16,13,1
S01010738,548,13,1,12,78,45,50,84,126,129,21,21,0,2
S01010739,870,44,2,42,165,65,83,125,142,199,43,19,24,4
S01010740,507,11,2,9,65,56,19,60,113,133,49,23,26,1
S01010741,573,54,12,42,103,32,87,76,86,121,14,9,5,0
S01010742,730,57,14,43,96,61,27,131,169,143,43,30,13,3
S01010743,761,26,4,22,92,46,58,124,187,164,62,28,34,2
S01010744,1041,63,16,47,254,65,88,163,196,182,23,9,14,7
S01010745,612,37,3,34,114,55,45,101,111,115,30,14,16,4
S01010746,1016,102,34,68,201,99,187,151,148,110,17,12,5,1
S01010747,827,58,13,45,133,59,95,142,156,151,25,20,5,8
S01010748,631,70,14,56,128,48,120,66,78,98,18,13,5,5
S01010749,614,66,21,45,121,63,114,79,54,101,8,2,6,8
S01010750,624,61,13,48,141,39,120,66,89,84,24,14,10,0
S01010751,745,35,5,30,94,69,80,82,116,196,69,38,31,4
S01010752,756,36,4,32,145,60,91,119,114,165,22,10,12,4
S01010753,1047,65,10,55,206,49,151,147,210,160,53,32,21,6
S01010754,695,52,18,34,160,55,74,75,132,116,29,27,2,2
S01010755,626,35,6,29,104,49,77,92,124,133,8,6,2,4
S01010756,659,64,11,53,167,75,129,72,82,55,15,10,5,0
S01010757,743,80,24,56,127,79,160,97,102,81,14,13,1,3
S01010758,677,58,21,37,139,58,148,70,94,84,9,3,6,17
S01010759,606,49,6,43,117,56,87,64,104,101,11,6,5,17
S01010760,566,95,41,54,127,61,74,63,58,67,14,7,7,7
S01010761,527,77,25,52,113,17,125,59,69,38,29,5,24,0
S01010762,598,58,20,38,148,55,154,60,78,37,8,4,4,0
S01010763,681,60,9,51,141,52,149,51,92,107,23,10,13,6
S01010764,576,41,11,30,129,36,158,72,79,56,1,0,1,4
S01010765,1005,89,26,63,194,66,183,132,178,132,26,21,5,5
S01010766,779,36,12,24,180,77,142,77,122,128,15,2,13,2
S01010767,706,32,5,27,114,62,82,121,125,134,36,12,24,0
S01010768,576,23,2,21,107,68,66,99,94,90,27,17,10,2
S01010769,483,55,13,42,143,28,117,49,45,43,3,0,3,0
S01010770,862,73,23,50,164,84,159,127,99,117,39,24,15,0
S01010771,864,40,7,33,142,72,193,134,137,118,27,12,15,1
S01010772,737,44,12,32,145,47,173,82,100,116,22,13,9,8
S01010773,785,75,19,56,168,57,171,108,78,107,17,8,9,4
S01010774,721,53,17,36,139,52,163,78,108,66,56,27,29,6
S01010775,643,43,17,26,131,59,144,86,63,116,1,0,1,0
S01010776,540,24,6,18,126,51,62,69,81,99,25,12,13,3
S01010777,494,21,9,12,75,49,53,79,85,89,37,19,18,6
S01010778,491,20,3,17,58,29,26,51,116,107,71,50,21,13
S01010779,769,34,9,25,88,64,81,101,156,124,104,78,26,17
S01010780,561,34,2,32,127,50,31,68,123,102,26,11,15,0
S01010781,777,99,19,80,179,73,103,120,73,110,9,4,5,11
S01010782,590,40,2,38,119,36,100,87,90,71,47,19,28,0
S01010783,550,21,5,16,63,36,55,89,121,115,31,20,11,19
S01010784,743,16,3,13,89,73,52,94,175,168,65,24,41,11
S01010785,683,83,15,68,153,89,75,78,69,116,20,9,11,0
S01010786,654,44,6,38,162,84,70,93,83,102,6,4,2,10
S01010787,913,75,7,68,159,91,215,126,93,123,25,17,8,6
S01010788,622,66,9,57,116,47,142,80,82,82,7,3,4,0
S01010789,729,58,19,39,147,23,190,107,106,77,19,4,15,2
S01010790,668,67,11,56,120,36,165,99,71,91,19,15,4,0
S01010791,835,111,10,101,167,58,200,95,96,81,18,12,6,9
S01010792,620,52,3,49,90,50,36,109,139,110,26,14,12,8
S01010793,649,74,18,56,169,45,115,71,79,85,8,5,3,3
S01010794,550,69,12,57,124,54,84,99,51,57,11,2,9,1
S01010795,982,131,31,100,205,107,125,110,109,143,49,12,37,3
S01010796,829,123,20,103,195,58,197,108,63,67,11,10,1,7
S01010797,762,116,13,103,178,74,122,133,62,65,10,7,3,2
S01010798,667,96,16,80,169,42,112,85,68,85,7,5,2,3
S01010799,891,98,10,88,208,87,109,104,130,112,30,19,11,13
S01010800,731,28,9,19,117,73,51,114,173,148,23,13,10,4
S01010801,708,44,2,42,159,51,60,98,134,132,27,13,14,3
S01010802,565,77,17,60,137,52,55,86,72,66,18,3,15,2
S01010803,589,48,6,42,128,48,47,102,118,65,24,11,13,9
S01010804,588,103,12,91,125,69,59,93,43,78,16,10,6,2
S01010805,853,92,25,67,253,79,70,140,95,89,24,5,19,11
S01010806,916,59,12,47,169,83,51,131,159,172,74,54,20,18
S01010807,570,56,12,44,124,49,51,119,75,72,20,6,14,4
S01010808,553,100,17,83,141,53,25,83,86,58,6,1,5,1
S01010809,724,142,33,109,182,78,66,102,71,72,11,2,9,0
S01010810,480,52,12,40,111,27,84,78,52,58,16,11,5,2
S01010811,847,88,23,65,202,70,163,99,105,93,24,8,16,3
S01010812,515,27,15,12,93,37,143,46,102,58,9,5,4,0
S01010813,534,18,7,11,109,28,143,69,73,79,11,2,9,4
S01010814,620,51,12,39,143,47,178,53,69,65,14,5,9,0
S01010815,442,22,6,16,113,34,71,71,54,72,5,4,1,0
S01010816,634,226,78,148,176,44,87,27,35,12,14,9,5,13
S01010817,905,305,41,264,249,108,132,19,48,21,17,9,8,6
S01010818,1014,321,65,256,263,89,101,57,86,52,25,14,11,20
S01010819,805,146,41,105,179,69,92,83,123,87,19,13,6,7
S01010820,526,163,49,114,136,50,74,35,43,22,2,1,1,1
S01010821,597,202,45,157,195,21,85,34,21,33,3,3,0,3
S01010822,663,230,43,187,186,36,100,23,38,22,16,12,4,12
S01010823,435,35,8,27,115,64,61,39,57,52,6,6,0,6
S01010824,758,147,30,117,264,104,68,59,67,40,5,3,2,4
S01010825,355,70,5,65,123,46,32,37,31,13,3,3,0,0
S01010826,755,163,32,131,214,104,94,45,84,39,3,2,1,9
S01010827,598,86,27,59,169,119,50,83,46,42,3,3,0,0
S01010828,1239,234,52,182,433,143,124,118,109,59,8,1,7,11
S01010829,900,184,51,133,248,114,93,63,123,60,10,10,0,5
S01010830,556,50,7,43,157,79,47,71,60,80,12,3,9,0
S01010831,598,118,40,78,197,59,55,65,50,26,17,9,8,11
S01010832,730,35,4,31,202,108,60,76,117,109,17,10,7,6
S01010833,902,246,25,221,274,82,106,95,44,49,2,2,0,4
S01010834,916,187,45,142,350,120,82,57,53,49,11,10,1,7
S01010835,645,141,40,101,231,95,50,51,37,28,7,4,3,5
S01010836,771,141,30,111,245,92,88,53,71,63,9,5,4,9
S01010837,660,41,18,23,157,133,50,71,116,76,5,5,0,11
S01010838,842,71,15,56,191,130,64,100,137,139,6,4,2,4
S01010839,729,96,32,64,204,102,59,74,94,82,6,1,5,12
S01010840,490,54,9,45,141,70,34,35,83,45,21,17,4,7
S01010841,748,86,18,68,245,119,38,73,90,72,21,16,5,4
S01010842,899,51,4,47,141,137,56,92,167,152,57,40,17,46
S01010843,643,37,10,27,137,113,50,64,115,106,15,11,4,6
S01010844,668,118,17,101,211,107,36,68,43,72,4,0,4,9
S01010845,619,50,7,43,172,74,40,91,94,78,10,7,3,10
S01010846,765,37,11,26,148,107,56,72,156,146,35,20,15,8
S01010847,649,81,26,55,196,84,31,112,63,64,10,8,2,8
S01010848,665,20,0,20,82,66,32,74,167,175,36,15,21,13
S01010849,951,27,9,18,112,78,65,106,191,269,73,55,18,30
S01010850,801,11,2,9,82,68,36,93,173,228,80,47,33,30
S01010851,814,20,2,18,105,96,25,66,207,210,67,31,36,18
S01010852,722,43,11,32,80,101,58,79,139,184,29,25,4,9
S01010853,882,55,19,36,122,118,62,112,175,212,18,13,5,8
S01010854,923,32,3,29,136,97,49,79,230,220,74,36,38,6
S01010855,560,7,0,7,45,60,49,55,155,145,27,23,4,17
S01010856,869,28,10,18,110,133,57,119,174,181,48,36,12,19
S01010857,842,70,18,52,187,134,45,104,137,119,31,20,11,15
S01010858,725,25,2,23,108,68,41,64,154,204,44,25,19,17
S01010859,734,26,4,22,74,87,36,61,186,196,60,43,17,8
S01010860,626,23,4,19,104,84,33,67,146,139,29,20,9,1
S01010861,649,27,6,21,109,93,31,46,134,160,40,22,18,9
S01010862,540,17,11,6,52,47,22,48,159,127,56,43,13,12
S01010863,747,128,43,85,235,107,44,49,81,73,13,9,4,17
S01010864,560,102,16,86,198,68,39,56,45,38,4,1,3,10
S01010865,699,152,31,121,235,110,58,33,48,37,7,6,1,19
S01010866,657,129,11,118,207,74,67,49,62,48,6,4,2,15
S01010867,632,118,29,89,180,73,102,30,74,44,4,4,0,7
S01010868,702,148,12,136,203,106,59,41,83,42,8,8,0,12
S01010869,756,138,35,103,254,98,90,59,50,44,20,13,7,3
S01010870,771,99,17,82,251,141,52,46,103,55,14,5,9,10
S01010871,853,129,15,114,233,108,113,74,91,61,22,8,14,22
S01010872,715,49,2,47,137,139,46,81,114,105,16,14,2,28
S01010873,547,14,1,13,85,74,12,60,119,131,42,23,19,10
S01010874,771,105,14,91,234,108,84,64,76,58,16,5,11,26
S01010875,517,59,10,49,139,72,40,31,67,74,20,12,8,15
S01010876,740,36,7,29,159,139,11,88,111,113,41,31,10,42
S01010877,958,100,21,79,221,183,63,89,126,108,45,29,16,23
S01010878,977,40,15,25,177,194,51,112,197,167,28,15,13,11
S01010879,829,50,19,31,174,122,72,95,125,160,22,12,10,9
S01010880,549,15,4,11,91,64,12,85,112,111,44,21,23,15
S01010881,621,27,7,20,162,91,50,69,98,104,10,7,3,10
S01010882,557,26,12,14,139,94,12,86,102,78,17,7,10,3
S01010883,839,86,33,53,215,110,51,115,115,109,31,16,15,7
S01010884,723,22,6,16,72,89,34,76,170,166,78,56,22,16
S01010885,946,39,12,27,147,111,31,84,191,177,124,66,58,42
S01010886,448,22,4,18,74,52,25,44,104,62,44,29,15,21
S01010887,821,10,0,10,108,85,50,82,176,212,79,44,35,19
S01010888,768,48,8,40,121,94,34,73,161,175,43,23,20,19
S01010889,524,25,2,23,60,60,25,42,116,137,51,39,12,8
S01010890,769,12,1,11,84,90,20,81,189,254,33,22,11,6
S01010891,397,7,1,6,25,37,17,39,82,110,55,53,2,25
S01010892,819,34,2,32,126,113,30,78,178,197,53,36,17,10
S01010893,511,20,6,14,51,48,18,49,127,142,37,29,8,19
S01010894,596,40,1,39,125,78,23,60,86,127,36,19,17,21
S01010895,411,7,2,5,59,54,15,26,90,108,48,37,11,4
S01010896,667,17,2,15,91,79,28,69,137,183,50,36,14,13
S01010897,836,28,7,21,92,88,40,89,154,250,91,45,46,4
S01010898,596,4,2,2,61,50,49,76,105,179,65,36,29,7
S01010899,584,37,15,22,109,68,30,71,122,112,24,13,11,11
S01010900,688,30,4,26,87,62,23,71,161,184,61,37,24,9
S01010901,465,4,4,0,42,25,20,55,129,144,39,31,8,7
S01010902,957,62,20,42,109,133,39,123,194,233,54,36,18,10
S01010903,793,7,3,4,77,65,39,76,178,236,92,58,34,23
S01010904,528,26,2,24,55,52,17,60,105,140,59,43,16,14
S01010905,635,51,10,41,122,93,24,59,125,98,50,43,7,13
S01010906,956,51,7,44,130,75,34,81,194,296,74,36,38,21
S01010907,526,66,20,46,149,88,53,51,42,73,3,1,2,1
S01010908,610,56,14,42,121,86,31,57,85,143,26,15,11,5
S01010909,668,74,38,36,178,85,63,60,82,106,8,5,3,12
S01010910,500,9,2,7,71,67,22,35,113,113,59,30,29,11
S01010911,541,12,6,6,67,70,16,48,130,157,29,19,10,12
S01010912,674,23,2,21,68,65,45,68,124,204,42,32,10,35
S01010913,642,41,14,27,158,84,64,63,84,112,18,14,4,18
S01010914,660,23,9,14,130,99,55,75,106,138,12,4,8,22
S01010915,736,65,24,41,143,57,51,103,142,144,15,9,6,16
S01010916,576,11,3,8,44,62,34,61,103,166,56,43,13,39
S01010917,712,34,9,25,122,96,22,104,134,151,42,29,13,7
S01010918,728,20,8,12,110,68,48,79,156,181,55,39,16,11
S01010919,789,28,5,23,95,65,34,104,180,234,49,30,19,0
S01010920,591,29,12,17,46,61,31,54,129,167,52,19,33,22
S01010921,630,10,0,10,61,70,32,73,144,202,32,25,7,6
S01010922,821,31,1,30,128,69,34,106,163,240,39,25,14,11
S01010923,879,22,3,19,123,121,43,81,185,251,51,27,24,2
S01010924,607,6,5,1,78,52,30,88,139,179,34,18,16,1
S01010925,858,12,0,12,105,98,51,76,175,279,48,16,32,14
S01010926,785,4,0,4,75,101,51,100,166,246,29,20,9,13
S01010927,577,13,7,6,97,48,34,50,137,151,41,29,12,6
S01010928,739,11,6,5,83,46,61,74,209,210,42,25,17,3
S01010929,660,6,2,4,44,56,20,90,176,220,36,19,17,12
S01010930,887,212,41,171,257,81,189,38,45,46,16,4,12,3
S01010931,428,78,27,51,88,36,93,35,49,39,6,2,4,4
S01010932,548,30,7,23,111,58,68,53,95,111,12,10,2,10
S01010933,753,195,33,162,230,63,113,37,55,48,10,6,4,2
S01010934,1031,229,47,182,341,117,117,64,99,42,16,8,8,6
S01010935,655,134,14,120,168,98,74,46,70,60,3,3,0,2
S01010936,675,68,6,62,151,132,77,63,90,67,21,12,9,6
S01010937,728,76,27,49,190,134,80,81,78,81,6,0,6,2
S01010938,809,26,8,18,109,95,58,117,170,198,32,4,28,4
S01010939,514,50,4,46,118,75,54,79,67,56,10,6,4,5
S01010940,683,143,43,100,213,104,55,58,73,33,2,2,0,2
S01010941,860,166,38,128,258,136,81,106,61,39,6,1,5,7
S01010942,646,133,29,104,223,97,52,48,63,29,1,1,0,0
S01010943,623,39,6,33,153,73,54,77,92,88,39,14,25,8
S01010944,588,25,2,23,82,89,33,63,133,126,29,5,24,8
S01010945,540,27,4,23,121,66,38,63,86,122,13,4,9,4
S01010946,811,25,3,22,156,94,97,111,125,160,36,26,10,7
S01010947,536,20,4,16,96,80,49,69,127,77,13,4,9,5
S01010948,673,38,5,33,135,101,54,62,108,150,16,8,8,9
S01010949,927,166,32,134,267,164,99,75,91,62,0,0,0,3
S01010950,846,90,10,80,220,119,78,83,117,124,12,4,8,3
S01010951,626,32,6,26,137,102,42,90,92,115,5,2,3,11
S01010952,540,80,14,66,112,90,45,86,69,40,15,15,0,3
S01010953,561,45,16,29,106,96,47,65,111,87,2,1,1,2
S01010954,512,72,19,53,104,96,63,64,43,62,2,1,1,6
S01010955,1023,201,60,141,376,145,91,60,70,47,20,4,16,13
S01010956,691,142,13,129,179,39,135,43,67,63,14,13,1,9
S01010957,581,105,22,83,165,81,75,70,58,22,4,4,0,1
S01010958,482,70,6,64,127,72,43,44,58,61,6,3,3,1
S01010959,579,86,18,68,158,75,52,45,91,51,19,8,11,2
S01010960,1093,110,23,87,222,103,137,100,155,191,50,16,34,25
S01010961,566,47,2,45,112,85,46,60,91,105,18,6,12,2
S01010962,530,36,3,33,110,48,57,55,88,129,6,2,4,1
S01010963,949,144,37,107,200,133,123,88,120,122,17,6,11,2
S01010964,523,60,5,55,96,69,75,48,60,108,7,0,7,0
S01010965,517,20,12,8,74,58,33,58,74,148,38,22,16,14
S01010966,684,36,8,28,129,72,71,108,101,143,19,8,11,5
S01010967,697,31,6,25,96,92,63,95,125,170,21,14,7,4
S01010968,715,47,15,32,167,116,69,76,81,130,23,17,6,6
S01010969,538,70,12,58,131,84,75,48,65,52,6,2,4,7
S01010970,955,114,25,89,213,115,102,121,104,155,20,11,9,11
S01010971,1056,128,36,92,259,164,125,121,125,100,30,13,17,4
S01010972,846,39,13,26,116,109,81,79,190,174,43,16,27,15
S01010973,490,28,6,22,86,81,56,56,74,97,9,1,8,3
S01010974,696,18,3,15,83,89,62,79,147,198,15,8,7,5
S01010975,490,11,2,9,60,55,58,77,89,101,34,19,15,5
S01010976,498,39,14,25,105,70,34,61,74,103,8,5,3,4
S01010977,721,62,11,51,140,92,69,87,126,129,9,6,3,7
S01010978,739,43,17,26,111,100,73,82,162,126,39,24,15,3
S01010979,825,46,6,40,129,91,76,92,165,178,36,15,21,12
S01010980,727,65,7,58,126,113,86,47,151,121,16,14,2,2
S01010981,739,52,13,39,106,109,69,95,113,150,32,26,6,13
S01010982,1048,239,42,197,279,94,164,105,81,69,16,2,14,1
S01010983,780,100,12,88,172,106,95,78,104,106,17,13,4,2
S01010984,663,84,27,57,181,100,70,75,62,79,12,9,3,0
S01010985,638,35,3,32,116,97,53,110,105,109,13,7,6,0
S01010986,537,99,18,81,155,106,77,45,25,27,3,3,0,0
S01010987,658,132,37,95,246,104,91,43,22,18,2,2,0,0
S01010988,627,148,47,101,220,79,70,28,51,26,1,1,0,4
S01010989,917,142,15,127,341,139,107,91,61,29,5,3,2,2
S01010990,798,59,6,53,137,111,91,85,149,157,5,4,1,4
S01010991,523,71,11,60,131,61,66,50,66,64,8,2,6,6
S01010992,583,159,28,131,175,44,82,64,35,22,0,0,0,2
S01010993,632,75,16,59,195,94,67,52,64,71,11,3,8,3
S01010994,992,288,51,237,350,104,75,55,73,39,6,1,5,2
S01010995,719,75,17,58,229,110,84,79,86,50,6,4,2,0
S01010996,553,105,20,85,184,76,82,34,45,23,1,0,1,3
S01010997,637,173,36,137,210,78,94,33,22,23,0,0,0,4
S01010998,578,190,32,158,190,46,96,17,17,9,11,3,8,2
S01010999,886,223,64,159,262,101,87,70,71,58,9,9,0,5
S01011000,842,118,23,95,205,76,171,73,75,97,14,5,9,13
S01011001,643,21,1,20,146,74,72,79,102,132,13,11,2,4
S01011002,707,18,2,16,102,89,49,112,153,174,6,6,0,4
S01011003,688,18,8,10,90,102,69,125,119,139,10,5,5,16
S01011004,624,106,22,84,165,75,67,55,61,73,16,4,12,6
S01011005,660,23,2,21,129,88,48,104,122,124,18,14,4,4
S01011006,1002,94,31,63,229,131,90,121,112,154,53,41,12,18
S01011007,684,16,2,14,69,76,50,125,104,217,19,14,5,8
S01011008,783,45,9,36,128,73,70,136,153,149,20,11,9,9
S01011009,508,17,12,5,86,65,34,85,98,105,16,8,8,2
S01011010,558,42,1,41,96,75,25,43,126,100,41,24,17,10
S01011011,753,28,7,21,101,138,42,77,165,127,64,44,20,11
S01011012,722,34,0,34,73,63,31,101,167,191,55,18,37,7
S01011013,802,35,8,27,101,110,57,118,154,214,11,7,4,2
S01011014,811,74,17,57,168,149,52,95,150,105,12,3,9,6
S01011015,443,17,3,14,97,49,59,37,92,73,19,6,13,0
S01011016,846,114,21,93,259,103,144,83,68,63,7,4,3,5
S01011017,822,177,29,148,192,86,178,73,53,47,7,0,7,9
S01011018,860,54,2,52,196,100,108,101,142,138,15,5,10,6
S01011019,1031,157,37,120,253,90,162,79,125,132,28,9,19,5
S01011020,471,100,8,92,129,36,67,45,36,45,13,2,11,0
S01011021,882,32,8,24,142,86,94,140,155,185,48,32,16,0
S01011022,581,24,2,22,35,57,54,92,112,166,30,16,14,11
S01011023,812,54,12,42,119,105,110,98,134,136,51,38,13,5
S01011024,782,19,5,14,110,90,68,86,149,187,65,35,30,8
S01011025,680,18,2,16,89,91,40,93,132,173,31,11,20,13
S01011026,540,9,0,9,64,75,55,82,127,100,22,5,17,6
S01011027,928,27,7,20,71,115,66,92,218,253,78,39,39,8
S01011028,987,24,6,18,116,96,62,113,219,270,77,38,39,10
S01011029,615,33,7,26,96,83,57,78,102,132,29,21,8,5
S01011030,969,71,19,52,251,165,92,113,121,147,3,1,2,6
S01011031,734,38,5,33,82,70,44,98,173,174,36,20,16,19
S01011032,778,37,8,29,155,102,80,50,157,153,38,22,16,6
S01011033,633,64,9,55,135,90,59,78,81,117,4,3,1,5
S01011034,664,39,13,26,112,95,69,84,120,125,20,17,3,0
S01011035,662,41,21,20,96,66,69,66,132,147,42,22,20,3
S01011036,646,62,5,57,158,84,71,63,91,99,13,2,11,5
S01011037,963,38,12,26,162,96,98,129,184,189,65,46,19,2
S01011038,885,21,4,17,104,73,70,140,178,216,66,28,38,17
S01011039,782,46,3,43,144,118,86,103,102,149,31,22,9,3
S01011040,752,36,12,24,105,86,66,93,143,183,40,18,22,0
S01011041,789,40,1,39,116,74,76,71,173,155,72,30,42,12
S01011042,813,91,24,67,211,102,84,104,103,86,19,6,13,13
S01011043,707,58,12,46,118,82,46,88,92,185,31,15,16,7
S01011044,694,51,14,37,114,93,72,70,142,131,14,9,5,7
S01011045,815,70,16,54,125,87,183,104,142,77,21,8,13,6
S01011046,854,75,42,33,134,70,221,145,104,89,12,7,5,4
S01011047,988,107,51,56,216,44,170,180,148,116,7,5,2,0
S01011048,975,42,23,19,140,65,120,173,180,229,22,6,16,4
S01011049,680,40,11,29,75,35,70,103,206,136,9,5,4,6
S01011050,800,71,18,53,186,40,127,114,164,75,20,15,5,3
S01011051,937,83,21,62,181,67,163,136,149,146,10,7,3,2
S01011052,812,80,37,43,147,71,113,114,169,108,7,1,6,3
S01011053,656,24,4,20,103,67,45,114,144,129,23,5,18,7
S01011054,536,70,26,44,92,40,68,77,123,57,6,6,0,3
S01011055,566,41,11,30,88,43,103,90,113,77,11,6,5,0
S01011056,699,81,20,61,101,18,260,61,80,90,8,4,4,0
S01011057,579,18,11,7,89,41,154,81,66,128,2,2,0,0
S01011058,638,45,16,29,155,36,204,52,73,68,4,2,2,1
S01011059,635,56,22,34,126,46,153,78,85,77,14,1,13,0
S01011060,833,94,15,79,161,76,120,71,135,163,12,11,1,1
S01011061,843,26,5,21,82,62,74,145,201,220,30,16,14,3
S01011062,916,35,18,17,136,70,156,124,164,213,12,8,4,6
S01011063,1036,59,9,50,129,86,89,192,218,220,43,27,16,0
S01011064,1025,86,31,55,112,83,127,184,180,222,27,13,14,4
S01011065,706,77,25,52,130,51,143,86,126,76,15,7,8,2
S01011066,504,52,14,38,110,56,98,65,56,54,10,7,3,3
S01011067,575,49,10,39,72,52,98,98,93,88,24,12,12,1
S01011068,535,28,6,22,88,38,74,71,120,103,9,6,3,4
S01011069,578,35,15,20,141,36,80,82,104,83,13,4,9,4
S01011070,625,37,15,22,131,57,89,113,92,101,5,5,0,0
S01011071,843,57,17,40,207,57,155,117,119,106,14,8,6,11
S01011072,1000,54,24,30,198,69,170,190,128,147,30,6,24,14
S01011073,682,56,16,40,122,56,78,137,115,109,8,5,3,1
S01011074,607,39,21,18,141,40,75,94,126,76,12,11,1,4
S01011075,714,9,8,1,62,43,73,123,170,206,23,7,16,5
S01011076,740,30,15,15,111,18,70,154,165,153,29,16,13,10
S01011077,777,10,2,8,91,43,44,118,202,217,34,18,16,18
S01011078,1104,101,37,64,206,88,162,198,150,172,18,11,7,9
S01011079,1046,45,28,17,188,64,113,248,144,225,15,6,9,4
S01011080,967,44,16,28,157,75,87,216,177,174,27,20,7,10
S01011081,824,43,15,28,107,62,91,161,169,167,20,15,5,4
S01011082,495,15,7,8,82,25,41,102,101,110,19,16,3,0
S01011083,787,50,23,27,144,77,100,131,138,130,14,4,10,3
S01011084,774,61,14,47,237,77,144,81,88,78,7,3,4,1
S01011085,888,98,32,66,288,101,95,90,109,94,9,9,0,4
S01011086,641,75,28,47,149,52,65,113,98,85,3,3,0,1
S01011087,584,21,10,11,118,55,60,99,107,110,11,11,0,3
S01011088,981,73,27,46,259,121,125,96,149,133,18,11,7,7
S01011089,650,31,8,23,120,47,58,91,132,130,35,9,26,6
S01011090,715,79,20,59,152,56,169,99,83,68,7,5,2,2
S01011091,621,86,32,54,124,46,119,89,73,75,9,6,3,0
S01011092,465,21,6,15,86,50,38,45,66,102,37,17,20,20
S01011093,612,73,29,44,158,38,129,93,78,35,3,2,1,5
S01011094,486,67,21,46,156,30,91,55,52,32,0,0,0,3
S01011095,783,112,50,62,222,56,168,89,56,57,13,5,8,10
S01011096,557,57,19,38,179,46,71,62,71,50,17,10,7,4
S01011097,715,103,27,76,167,55,131,91,88,70,9,2,7,1
S01011098,749,41,6,35,214,81,67,92,111,132,3,3,0,8
S01011099,819,21,15,6,141,57,60,113,190,182,41,14,27,14
S01011100,458,30,1,29,86,67,45,62,63,95,3,3,0,7
S01011101,626,16,11,5,80,42,30,101,153,185,15,4,11,4
S01011102,642,13,4,9,93,51,24,74,197,159,29,20,9,2
S01011103,568,31,11,20,92,40,29,85,119,134,30,21,9,8
S01011104,583,58,10,48,164,53,64,81,71,55,25,17,8,12
S01011105,796,40,17,23,144,78,74,107,135,190,20,13,7,8
S01011106,988,30,9,21,399,120,23,80,148,150,30,13,17,8
S01011107,935,44,17,27,304,60,57,135,156,135,23,6,17,21
S01011108,543,38,9,29,136,32,47,89,91,95,7,4,3,8
S01011109,807,47,8,39,130,87,83,143,153,154,10,6,4,0
S01011110,702,17,5,12,124,75,29,101,170,156,25,16,9,5
S01011111,880,11,2,9,143,69,60,114,196,230,47,45,2,10
S01011112,874,56,20,36,240,108,72,187,103,99,5,1,4,4
S01011113,925,44,14,30,173,68,85,161,184,183,20,15,5,7
S01011114,713,35,7,28,148,79,77,158,94,96,18,9,9,8
S01011115,902,22,11,11,117,73,82,188,157,221,31,10,21,11
S01011116,661,32,8,24,162,81,31,115,100,124,1,0,1,15
S01011117,730,117,13,104,219,59,81,82,90,61,6,5,1,15
S01011118,880,180,48,132,256,112,93,89,81,52,10,6,4,7
S01011119,928,170,51,119,300,103,87,69,96,85,9,9,0,9
S01011120,669,150,54,96,237,57,79,55,53,31,7,7,0,0
S01011121,520,42,4,38,87,62,40,77,99,96,10,7,3,7
S01011122,647,31,9,22,163,71,62,99,107,111,1,1,0,2
S01011123,1121,47,22,25,179,104,63,192,217,296,20,7,13,3
S01011124,661,49,23,26,165,56,56,99,96,129,7,5,2,4
S01011125,492,14,4,10,70,35,35,90,116,107,17,11,6,8
S01011126,502,22,6,16,154,69,45,64,63,69,15,1,14,1
S01011127,536,12,4,8,310,140,19,9,22,6,14,14,0,4
S01011128,709,45,9,36,156,93,46,94,125,131,15,7,8,4
S01011129,973,314,252,62,281,58,88,95,78,59,0,0,0,0
S01011130,597,34,9,25,141,71,35,54,111,120,21,12,9,10
S01011131,637,64,37,27,197,81,46,68,99,64,8,2,6,10
S01011132,898,141,54,87,263,109,88,127,100,56,11,9,2,3
S01011133,445,37,16,21,68,48,39,75,89,79,5,5,0,5
S01011134,744,40,16,24,224,91,100,67,117,85,16,11,5,4
S01011135,740,17,2,15,141,80,61,140,103,165,20,8,12,13
S01011136,644,58,28,30,144,83,41,113,100,88,13,8,5,4
S01011137,502,38,24,14,119,58,63,68,71,57,21,5,16,7
S01011138,635,10,7,3,178,68,51,91,95,120,19,10,9,3
S01011139,764,26,14,12,376,160,58,47,48,37,9,4,5,3
S01011140,537,26,2,24,142,43,54,64,80,114,4,2,2,10
S01011141,558,13,7,6,153,37,37,73,109,120,14,5,9,2
S01011142,839,88,27,61,326,68,108,94,80,66,9,3,6,0
S01011143,950,105,54,51,280,57,102,148,145,95,6,3,3,12
S01011144,769,91,35,56,248,75,79,95,78,87,6,6,0,10
S01011145,653,97,43,54,249,35,69,63,61,68,6,4,2,5
S01011146,759,72,29,43,188,91,83,90,125,78,20,1,19,12
S01011147,995,64,14,50,293,120,104,130,164,110,8,3,5,2
S01011148,763,86,35,51,176,51,175,89,82,92,7,2,5,5
S01011149,679,77,24,53,283,132,91,32,23,29,6,0,6,6
S01011150,474,87,68,19,190,42,17,52,38,44,4,2,2,0
S01011151,578,42,26,16,249,113,39,37,41,48,8,1,7,1
S01011152,695,130,42,88,215,72,88,59,72,41,16,12,4,2
S01011153,848,77,14,63,220,76,126,104,114,97,27,14,13,7
S01011154,559,31,16,15,117,60,57,69,96,95,29,14,15,5
S01011155,643,81,15,66,147,51,82,69,97,72,38,14,24,6
S01011156,565,35,3,32,194,69,62,79,57,56,8,7,1,5
S01011157,575,42,14,28,187,84,51,85,79,37,8,4,4,2
S01011158,505,126,35,91,139,55,66,29,54,36,0,0,0,0
S01011159,545,21,5,16,95,70,28,88,109,120,12,2,10,2
S01011160,909,54,17,37,204,116,92,116,170,128,27,20,7,2
S01011161,636,20,7,13,100,46,52,109,131,153,17,2,15,8
S01011162,497,20,4,16,89,67,34,46,116,88,27,8,19,10
S01011163,786,21,17,4,99,74,60,144,196,164,25,4,21,3
S01011164,718,61,16,45,225,90,48,81,100,91,22,0,22,0
S01011165,748,22,5,17,112,65,69,113,162,165,31,18,13,9
S01011166,513,91,14,77,122,72,52,53,63,42,10,7,3,8
S01011167,640,139,42,97,172,41,125,50,55,53,5,3,2,0
S01011168,845,77,36,41,206,68,225,108,78,63,9,5,4,11
S01011169,963,126,51,75,337,115,58,109,102,91,21,4,17,4
S01011170,910,147,53,94,256,74,142,105,102,53,26,10,16,5
S01011171,876,102,25,77,203,47,228,72,118,87,14,5,9,5
S01011172,721,41,9,32,182,47,195,73,98,77,8,3,5,0
S01011173,516,68,6,62,113,28,173,36,64,29,3,2,1,2
S01011174,434,55,13,42,102,28,105,39,41,61,3,1,2,0
S01011175,532,35,4,31,98,45,89,75,96,78,16,12,4,0
S01011176,531,68,15,53,130,46,134,50,28,66,6,5,1,3
S01011177,838,82,27,55,187,61,186,91,126,92,11,8,3,2
S01011178,514,48,16,32,132,56,73,55,65,62,21,6,15,2
S01011179,589,24,8,16,70,46,48,103,104,158,23,19,4,13
S01011180,670,24,2,22,68,38,44,85,130,210,61,31,30,10
S01011181,453,54,12,42,90,39,142,39,43,42,1,1,0,3
S01011182,395,39,10,29,105,32,92,46,38,37,6,4,2,0
S01011183,571,59,18,41,102,41,76,85,102,63,40,19,21,3
S01011184,820,129,35,94,314,63,110,91,67,36,8,5,3,2
S01011185,680,55,11,44,189,74,59,97,96,91,16,11,5,3
S01011186,913,86,17,69,169,96,74,104,153,170,53,28,25,8
S01011187,665,68,24,44,185,63,55,139,71,76,2,0,2,6
S01011188,951,57,14,43,145,111,77,144,190,159,60,19,41,8
S01011189,767,65,24,41,167,121,76,138,94,81,20,7,13,5
S01011190,633,10,3,7,100,59,85,95,131,120,30,18,12,3
S01011191,546,31,14,17,70,43,32,93,103,142,26,4,22,6
S01011192,697,13,5,8,115,66,38,100,168,135,53,19,34,9
S01011193,703,23,7,16,77,81,26,85,170,178,47,26,21,16
S01011194,727,20,6,14,108,66,64,102,136,163,47,11,36,21
S01011195,781,20,4,16,122,86,49,101,166,152,60,17,43,25
S01011196,903,23,8,15,120,89,47,112,217,201,68,40,28,26
S01011197,871,51,11,40,119,94,74,99,143,195,76,40,36,20
S01011198,624,21,2,19,94,54,47,92,117,159,38,15,23,2
S01011199,781,26,4,22,150,102,57,85,194,119,37,11,26,11
S01011200,740,49,14,35,132,68,59,107,143,135,35,14,21,12
S01011201,586,38,8,30,139,80,45,86,88,94,12,10,2,4
S01011202,844,29,8,21,146,111,58,179,141,132,36,15,21,12
S01011203,806,65,11,54,130,93,64,123,180,118,23,12,11,10
S01011204,555,98,14,84,158,66,70,57,68,34,4,3,1,0
S01011205,716,101,23,78,197,98,77,102,77,47,11,0,11,6
S01011206,734,72,27,45,243,72,79,120,84,52,9,1,8,3
S01011207,757,98,26,72,173,83,46,102,134,89,25,19,6,7
S01011208,907,119,49,70,254,104,78,119,89,121,18,6,12,5
S01011209,633,47,7,40,98,91,33,82,111,118,45,21,24,8
S01011210,733,156,51,105,215,54,127,81,64,27,6,2,4,3
S01011211,702,116,29,87,203,86,48,85,79,59,14,6,8,12
S01011212,548,11,3,8,64,23,57,94,121,136,40,28,12,2
S01011213,1048,53,10,43,127,80,76,162,209,235,85,40,45,21
S01011214,852,11,2,9,114,73,52,115,198,212,60,33,27,17
S01011215,596,5,0,5,83,44,38,61,142,136,78,34,44,9
S01011216,482,10,0,10,59,51,39,48,114,122,28,6,22,11
S01011217,799,24,4,20,118,73,62,92,164,142,116,51,65,8
S01011218,696,12,0,12,81,55,30,108,140,144,104,38,66,22
S01011219,782,23,0,23,105,80,60,82,150,198,78,27,51,6
S01011220,889,29,9,20,121,71,70,113,196,185,96,49,47,8
S01011221,947,31,6,25,123,115,53,157,185,224,44,25,19,15
S01011222,662,17,10,7,115,72,46,72,138,172,26,12,14,4
S01011223,796,41,4,37,169,132,57,112,119,132,31,14,17,3
S01011224,681,30,9,21,98,71,78,81,137,139,33,24,9,14
S01011225,697,35,10,25,117,61,50,74,140,146,65,34,31,9
S01011226,971,105,30,75,232,98,108,170,136,90,32,12,20,0
S01011227,709,61,8,53,173,71,61,88,96,102,52,26,26,5
S01011228,768,36,9,27,167,84,57,107,149,118,39,24,15,11
S01011229,510,21,7,14,87,47,49,84,83,86,42,14,28,11
S01011230,886,10,1,9,90,46,44,103,219,246,123,68,55,5
S01011231,604,20,3,17,78,38,31,91,140,157,49,33,16,0
S01011232,874,62,10,52,201,69,100,77,153,147,50,27,23,15
S01011233,365,30,0,30,66,43,21,42,60,57,41,21,20,5
S01011234,1031,35,16,19,117,83,55,129,215,228,131,59,72,38
S01011235,384,18,3,15,45,36,31,46,84,81,30,18,12,13
S01011236,542,20,6,14,82,43,42,73,133,111,33,26,7,5
S01011237,763,25,2,23,134,66,43,130,130,151,66,33,33,18
S01011238,644,12,0,12,76,79,36,49,131,144,105,55,50,12
S01011239,689,18,6,12,108,67,63,78,121,135,81,31,50,18
S01011240,684,31,7,24,117,75,46,77,117,112,103,45,58,6
S01011241,997,86,24,62,223,80,112,140,135,150,62,36,26,9
S01011242,737,54,3,51,152,90,69,91,125,102,44,29,15,10
S01011243,862,27,7,20,128,82,55,88,160,163,143,66,77,16
S01011244,666,26,7,19,94,69,18,68,144,138,93,35,58,16
S01011245,846,34,13,21,99,67,41,145,191,178,83,36,47,8
S01011246,842,73,18,55,223,87,117,89,123,83,44,12,32,3
S01011247,790,122,29,93,228,97,74,101,67,82,11,4,7,8
S01011248,739,73,20,53,181,57,58,97,131,121,12,4,8,9
S01011249,723,79,16,63,159,110,63,141,52,101,11,4,7,7
S01011250,1083,61,17,44,159,130,70,98,266,188,94,37,57,17
S01011251,871,22,7,15,161,54,63,120,195,204,36,20,16,16
S01011252,825,13,4,9,81,76,33,70,241,229,72,32,40,10
S01011253,855,18,2,16,70,75,25,128,252,221,57,39,18,9
S01011254,955,141,40,101,245,127,81,158,96,89,5,0,5,13
S01011255,780,159,33,126,267,78,62,136,53,21,2,2,0,2
S01011256,497,47,25,22,123,50,71,73,65,63,5,3,2,0
S01011257,408,61,12,49,146,40,33,55,37,31,0,0,0,5
S01011258,565,102,24,78,171,40,55,74,44,60,12,4,8,7
S01011259,763,50,11,39,172,82,82,76,129,120,39,26,13,13
S01011260,718,86,14,72,223,69,67,112,78,57,21,9,12,5
S01011261,809,21,10,11,89,65,69,125,187,174,59,32,27,20
S01011262,495,22,4,18,82,56,51,63,120,78,18,11,7,5
S01011263,1063,84,17,67,229,133,56,170,197,143,45,19,26,6
S01011264,688,19,14,5,74,80,39,98,148,171,48,12,36,11
S01011265,1077,28,11,17,94,122,85,92,259,233,125,53,72,39
S01011266,908,33,6,27,131,86,67,191,186,171,38,19,19,5
S01011267,585,60,2,58,154,60,52,90,76,72,18,5,13,3
S01011268,375,39,9,30,77,21,31,48,54,89,16,11,5,0
S01011269,514,30,10,20,95,52,24,70,73,122,38,15,23,10
S01011270,680,24,5,19,80,69,46,93,148,150,46,12,34,24
S01011271,760,37,3,34,117,71,49,115,141,159,56,20,36,15
S01011272,728,34,9,25,108,79,41,111,125,150,73,28,45,7
S01011273,901,12,3,9,104,104,52,126,171,198,114,71,43,20
S01011274,888,30,5,25,105,97,52,155,204,146,81,41,40,18
S01011275,711,14,6,8,91,45,38,88,182,135,93,41,52,25
S01011276,978,54,14,40,109,83,56,172,206,182,111,53,58,5
S01011277,654,55,13,42,177,97,57,90,90,72,6,1,5,10
S01011278,494,51,13,38,106,70,34,86,67,62,16,16,0,2
S01011279,651,59,25,34,181,106,39,77,101,71,14,14,0,3
S01011280,590,79,30,49,184,66,53,95,55,55,3,0,3,0
S01011281,645,65,20,45,247,79,63,91,63,29,0,0,0,8
S01011282,918,98,23,75,283,119,77,121,113,85,5,0,5,17
S01011283,737,102,14,88,210,86,62,126,66,77,4,2,2,4
S01011284,615,97,24,73,245,53,62,76,35,42,0,0,0,5
S01011285,729,18,2,16,91,97,41,96,199,130,55,8,47,2
S01011286,720,10,0,10,107,113,49,99,131,123,50,24,26,38
S01011287,807,33,10,23,129,91,44,91,195,162,41,19,22,21
S01011288,757,14,4,10,117,79,29,119,191,139,63,31,32,6
S01011289,934,26,6,20,139,94,68,140,212,183,57,23,34,15
S01011290,1054,58,15,43,162,109,121,126,190,192,84,43,41,12
S01011291,815,38,8,30,124,95,41,117,148,186,49,9,40,17
S01011292,692,16,7,9,70,43,57,82,191,140,83,20,63,10
S01011293,736,13,2,11,119,51,40,135,130,187,35,20,15,26
S01011294,833,22,2,20,133,76,62,109,135,198,85,38,47,13
S01011295,946,123,15,108,276,121,82,117,79,97,39,15,24,12
S01011296,556,25,4,21,118,60,76,68,71,97,30,11,19,11
S01011297,839,23,3,20,123,91,62,101,193,185,55,22,33,6
S01011298,642,24,9,15,75,73,51,75,129,138,69,32,37,8
S01011299,489,63,17,46,114,23,171,50,30,34,4,4,0,0
S01011300,944,34,4,30,88,94,66,110,197,256,96,30,66,3
S01011301,705,88,28,60,186,101,70,77,77,85,19,6,13,2
S01011302,856,31,9,22,137,94,60,109,144,207,66,29,37,8
S01011303,1004,104,20,84,260,130,100,152,140,98,20,10,10,0
S01011304,708,41,21,20,71,55,46,101,132,191,57,30,27,14
S01011305,829,61,4,57,118,73,92,148,139,136,55,12,43,7
S01011306,590,27,6,21,102,27,27,111,113,119,56,22,34,8
S01011307,470,36,13,23,117,62,139,42,46,26,2,2,0,0
S01011308,432,69,28,41,105,34,126,31,25,33,9,6,3,0
S01011309,712,179,51,128,259,72,90,48,30,29,4,2,2,1
S01011310,706,69,9,60,222,85,85,71,92,45,20,8,12,17
S01011311,666,121,23,98,222,58,113,58,60,21,5,2,3,8
S01011312,1103,274,55,219,364,99,146,110,42,45,14,10,4,9
S01011313,735,103,25,78,194,106,107,77,74,51,18,8,10,5
S01011314,1097,247,53,194,303,110,122,112,84,71,26,12,14,22
S01011315,410,46,10,36,76,24,43,65,52,74,20,4,16,10
S01011316,748,51,8,43,109,78,78,106,104,146,64,37,27,12
S01011317,752,127,29,98,242,105,128,43,50,48,8,3,5,1
S01011318,919,164,22,142,272,108,128,49,121,57,14,10,4,6
S01011319,856,184,41,143,282,95,84,57,101,44,9,8,1,0
S01011320,522,45,3,42,139,56,50,52,93,66,13,8,5,8
S01011321,596,61,6,55,162,86,45,76,93,61,6,3,3,6
S01011322,634,83,14,69,180,96,57,62,74,64,15,4,11,3
S01011323,917,90,11,79,175,99,87,127,186,98,44,9,35,11
S01011324,449,48,6,42,116,66,51,52,60,44,10,9,1,2
S01011325,737,42,6,36,127,88,94,88,120,133,32,14,18,13
S01011326,747,57,15,42,145,91,102,77,149,94,29,20,9,3
S01011327,648,37,11,26,140,82,114,71,98,87,19,7,12,0
S01011328,697,56,4,52,143,71,156,80,83,82,22,12,10,4
S01011329,914,91,9,82,240,113,96,88,132,101,25,12,13,28
S01011330,754,166,47,119,210,118,62,64,53,71,6,3,3,4
S01011331,745,166,53,113,229,86,74,71,66,43,10,7,3,0
S01011332,863,188,24,164,297,91,82,75,79,42,3,2,1,6
S01011333,733,175,32,143,270,70,90,40,47,36,5,2,3,0
S01011334,706,140,32,108,125,58,199,46,59,57,22,7,15,0
S01011335,934,224,57,167,323,94,124,56,53,46,9,3,6,5
S01011336,617,90,28,62,112,74,55,64,118,77,26,15,11,1
S01011337,682,193,41,152,223,57,114,25,34,29,3,0,3,4
S01011338,660,47,7,40,128,56,42,89,105,149,31,9,22,13
S01011339,560,22,2,20,79,50,40,97,141,87,43,36,7,1
S01011340,694,30,19,11,80,79,49,84,153,164,39,13,26,16
S01011341,721,58,17,41,135,78,50,106,122,110,37,25,12,25
S01011342,702,65,32,33,154,90,64,103,107,84,18,8,10,17
S01011343,826,21,2,19,116,83,68,120,175,164,73,44,29,6
S01011344,883,24,2,22,113,74,52,107,186,222,90,39,51,15
S01011345,794,12,4,8,95,48,59,74,220,204,71,20,51,11
S01011346,678,27,10,17,78,97,52,96,112,170,34,24,10,12
S01011347,1043,67,22,45,175,128,106,145,209,159,49,21,28,5
S01011348,921,44,15,29,164,121,39,120,166,164,94,30,64,9
S01011349,923,104,28,76,226,130,117,123,90,118,12,0,12,3
S01011350,658,118,35,83,206,85,92,41,71,39,5,3,2,1
S01011351,696,22,9,13,87,79,45,100,163,151,44,17,27,5
S01011352,635,40,6,34,140,65,55,67,124,105,31,18,13,8
S01011353,610,43,14,29,81,81,50,82,100,137,25,16,9,11
S01011354,730,107,13,94,161,99,88,85,76,94,17,3,14,3
S01011355,927,66,29,37,186,125,101,125,131,164,23,12,11,6
S01011356,962,135,22,113,233,55,291,101,62,57,25,11,14,3
S01011357,852,78,15,63,206,130,89,106,83,139,17,10,7,4
S01011358,547,97,21,76,179,58,34,56,55,55,6,6,0,7
S01011359,737,48,11,37,121,85,43,98,106,177,51,26,25,8
S01011360,756,15,2,13,77,60,36,70,187,213,72,35,37,26
S01011361,537,14,1,13,32,39,26,50,123,163,84,46,38,6
S01011362,555,68,23,45,150,66,113,59,52,47,0,0,0,0
S01011363,870,77,24,53,205,99,103,78,123,118,55,38,17,12
S01011364,659,48,11,37,160,100,45,73,89,118,22,7,15,4
S01011365,648,71,34,37,257,80,48,72,41,77,2,0,2,0
S01011366,433,25,0,25,52,72,19,55,85,109,13,9,4,3
S01011367,840,46,3,43,145,96,52,100,185,190,21,13,8,5
S01011368,843,117,26,91,327,109,87,73,44,61,15,4,11,10
S01011369,811,25,1,24,159,82,56,122,147,162,48,16,32,10
S01011370,811,102,32,70,247,101,42,99,96,112,10,9,1,2
S01011371,925,28,3,25,155,115,44,109,192,185,88,34,54,9
S01011372,667,22,7,15,71,56,18,90,142,150,91,38,53,27
S01011373,674,29,9,20,92,72,59,49,148,132,59,20,39,34
S01011374,694,71,20,51,181,153,40,71,66,81,25,14,11,6
S01011375,645,83,29,54,146,105,43,73,84,79,27,1,26,5
S01011376,475,14,2,12,76,61,24,49,125,93,24,10,14,9
S01011377,594,147,25,122,200,84,66,29,33,24,7,7,0,4
S01011378,793,80,26,54,212,128,49,89,115,107,10,1,9,3
S01011379,902,180,31,149,336,122,68,71,56,64,4,0,4,1
S01011380,665,62,15,47,124,138,46,61,86,114,27,19,8,7
S01011381,617,56,18,38,162,103,58,57,72,81,20,4,16,8
S01011382,531,38,13,25,103,42,38,44,102,128,28,21,7,8
S01011383,686,15,0,15,89,80,20,61,159,182,73,45,28,7
S01011384,734,12,0,12,55,36,35,72,179,208,135,59,76,2
S01011385,957,18,5,13,99,87,54,98,186,299,108,53,55,8
S01011386,588,8,3,5,36,34,36,75,161,112,119,60,59,7
S01011387,810,32,8,24,79,59,34,97,182,231,93,51,42,3
S01011388,1083,123,50,73,321,121,86,141,138,122,23,16,7,8
S01011389,761,34,7,27,130,104,48,80,138,145,54,40,14,28
S01011390,815,35,20,15,110,89,33,117,153,234,36,16,20,8
S01011391,645,22,15,7,75,50,49,70,175,165,31,12,19,8
S01011392,680,17,9,8,74,54,46,108,128,180,65,16,49,8
S01011393,823,41,20,21,154,117,80,92,136,165,32,16,16,6
S01011394,613,153,44,109,181,73,45,69,33,47,9,5,4,3
S01011395,737,27,3,24,145,104,56,75,137,157,30,18,12,6
S01011396,762,48,23,25,160,111,58,59,126,138,54,36,18,8
S01011397,736,26,10,16,152,94,54,77,140,135,43,28,15,15
S01011398,775,18,0,18,112,74,52,98,123,192,102,51,51,4
S01011399,508,16,1,15,60,70,29,59,118,106,41,16,25,9
S01011400,668,70,18,52,172,109,42,55,89,92,39,20,19,0
S01011401,614,60,32,28,170,91,42,51,86,89,20,13,7,5
S01011402,954,83,25,58,164,153,84,143,139,136,43,27,16,9
S01011403,534,45,17,28,125,74,39,46,92,82,22,9,13,9
S01011404,924,54,10,44,186,120,59,84,166,196,46,24,22,13
S01011405,635,66,15,51,176,66,46,72,95,59,55,41,14,0
S01011406,643,18,5,13,148,62,46,74,124,141,19,3,16,11
S01011407,1105,81,15,66,277,154,114,104,139,190,25,11,14,21
S01011408,827,13,5,8,116,96,48,98,200,204,46,28,18,6
S01011409,839,34,2,32,129,94,67,111,156,171,71,33,38,6
S01011410,628,19,2,17,85,106,35,92,131,129,28,19,9,3
S01011411,678,28,7,21,97,73,46,119,143,127,38,18,20,7
S01011412,860,136,58,78,282,113,82,97,70,64,10,7,3,6
S01011413,560,47,13,34,146,118,53,59,48,77,10,8,2,2
S01011414,827,42,12,30,143,113,44,111,112,183,71,50,21,8
S01011415,866,62,23,39,196,105,79,118,130,144,31,17,14,1
S01011416,626,70,22,48,168,98,65,102,48,69,6,2,4,0
S01011417,818,49,6,43,136,104,89,93,129,175,31,24,7,12
S01011418,552,13,3,10,82,46,35,88,123,124,26,19,7,15
S01011419,558,48,5,43,92,74,29,74,82,129,29,12,17,1
S01011420,491,11,3,8,59,44,41,34,92,147,48,26,22,15
S01011421,615,57,19,38,174,89,30,87,61,74,38,15,23,5
S01011422,660,29,6,23,86,70,51,80,126,185,29,16,13,4
S01011423,570,45,4,41,79,44,19,58,129,134,60,35,25,2
S01011424,560,15,7,8,89,48,33,79,108,167,17,13,4,4
S01011425,901,49,21,28,190,61,109,94,173,146,63,30,33,16
S01011426,993,150,35,115,319,73,147,101,88,102,7,2,5,6
S01011427,679,35,4,31,127,50,77,64,128,169,29,11,18,0
S01011428,506,36,9,27,61,38,42,75,81,139,33,18,15,1
S01011429,626,101,30,71,201,58,109,62,36,53,3,2,1,3
S01011430,880,79,17,62,195,101,94,105,136,150,14,6,8,6
S01011431,1063,48,19,29,173,80,89,151,208,255,42,21,21,17
S01011432,1025,31,18,13,159,120,51,130,206,273,48,19,29,7
S01011433,909,25,8,17,76,91,46,101,196,248,103,50,53,23
S01011434,562,21,8,13,112,69,43,76,116,106,15,11,4,4
S01011435,927,89,34,55,290,102,91,114,87,121,23,8,15,10
S01011436,718,18,2,16,94,73,65,81,143,174,58,20,38,12
S01011437,731,29,16,13,105,66,57,85,139,186,59,41,18,5
S01011438,544,8,5,3,43,52,22,57,149,155,56,36,20,2
S01011439,889,38,11,27,124,85,87,112,180,213,43,24,19,7
S01011440,597,21,7,14,56,72,30,74,147,169,25,12,13,3
S01011441,763,28,14,14,90,81,54,96,162,201,51,19,32,0
S01011442,683,13,4,9,88,75,62,96,134,187,23,13,10,5
S01011443,622,24,10,14,100,68,35,70,108,181,27,9,18,9
S01011444,764,20,4,16,77,62,67,103,155,214,60,33,27,6
S01011445,548,41,6,35,112,49,44,67,65,132,33,14,19,5
S01011446,522,33,6,27,86,63,113,57,62,88,13,7,6,7
S01011447,924,20,11,9,129,150,75,103,166,211,65,26,39,5
S01011448,884,62,14,48,218,94,123,103,143,112,19,5,14,10
S01011449,530,30,7,23,92,49,35,82,74,126,41,19,22,1
S01011450,652,90,23,67,175,62,107,67,54,72,14,12,2,11
S01011451,727,124,43,81,220,46,184,47,42,41,23,6,17,0
S01011452,947,108,35,73,209,110,123,110,123,141,18,3,15,5
S01011453,728,31,17,14,118,91,57,107,129,154,38,14,24,3
S01011454,802,25,9,16,139,90,52,128,148,198,18,6,12,4
S01011455,746,14,3,11,88,71,68,82,188,170,59,34,25,6
S01011456,814,19,7,12,100,111,78,127,134,198,43,28,15,4
S01011457,917,27,0,27,111,87,40,97,205,277,65,42,23,8
S01011458,1114,126,25,101,266,165,107,170,108,148,16,10,6,8
S01011459,1053,91,20,71,282,172,72,113,132,174,15,4,11,2
S01011460,756,56,13,43,166,47,47,108,87,191,46,27,19,8
S01011461,722,17,7,10,79,98,57,91,158,169,44,20,24,9
S01011462,897,127,34,93,185,96,79,119,127,136,21,14,7,7
S01011463,670,41,6,35,145,84,74,74,102,130,12,7,5,8
S01011464,571,100,22,78,186,43,74,69,38,51,7,6,1,3
S01011465,547,13,0,13,46,39,51,57,127,143,67,39,28,4
S01011466,592,35,10,25,71,57,35,36,113,185,48,30,18,12
S01011467,539,50,13,37,122,68,42,49,90,81,37,19,18,0
S01011468,915,134,45,89,324,111,93,90,68,61,19,15,4,15
S01011469,859,33,6,27,136,95,75,84,172,174,68,29,39,22
S01011470,1099,87,27,60,183,127,100,112,205,213,41,21,20,31
S01011471,869,82,36,46,201,108,44,83,158,152,19,10,9,22
S01011472,880,26,6,20,109,132,49,112,171,177,80,35,45,24
S01011473,662,17,2,15,88,125,19,70,167,146,20,12,8,10
S01011474,798,39,13,26,136,97,26,91,158,176,68,42,26,7
S01011475,605,18,1,17,81,97,35,56,128,127,43,20,23,20
S01011476,487,85,16,69,138,92,25,68,44,35,0,0,0,0
S01011477,851,149,41,108,278,177,66,66,47,62,5,5,0,1
S01011478,1060,244,73,171,374,135,120,87,52,31,7,2,5,10
S01011479,783,96,24,72,273,114,84,77,70,59,9,8,1,1
S01011480,1019,283,58,225,323,100,116,54,76,51,12,9,3,4
S01011481,812,101,15,86,229,96,59,110,82,112,22,16,6,1
S01011482,895,57,10,47,190,122,50,104,146,168,38,14,24,20
S01011483,531,60,16,44,196,64,48,46,50,55,7,4,3,5
S01011484,865,40,6,34,105,103,55,86,212,207,41,16,25,16
S01011485,965,37,15,22,143,111,22,98,199,231,108,58,50,16
S01011486,562,6,5,1,71,38,15,65,118,189,54,35,19,6
S01011487,1090,49,11,38,122,135,77,111,263,252,75,53,22,6
S01011488,697,26,7,19,54,66,30,85,174,172,83,34,49,7
S01011489,750,92,43,49,200,101,67,87,82,98,19,8,11,4
S01011490,956,31,11,20,211,122,75,98,165,218,30,16,14,6
S01011491,514,12,0,12,73,52,12,74,89,121,72,51,21,9
S01011492,760,15,0,15,83,54,24,100,139,205,109,66,43,31
S01011493,545,88,33,55,164,64,47,87,36,59,0,0,0,0
S01011494,729,41,10,31,117,96,44,76,120,195,31,20,11,9
S01011495,812,29,8,21,121,96,40,93,181,187,57,27,30,8
S01011496,649,22,10,12,64,53,41,77,166,171,50,29,21,5
S01011497,617,71,20,51,173,68,82,78,57,66,19,8,11,3
S01011498,672,54,11,43,207,123,60,89,75,55,1,0,1,8
S01011499,806,55,19,36,186,154,79,110,93,103,19,8,11,7
S01011500,512,23,11,12,94,51,37,59,88,135,24,2,22,1
S01011501,673,30,5,25,44,44,36,72,140,235,71,36,35,1
S01011502,755,24,9,15,90,111,53,132,137,170,31,18,13,7
S01011503,641,23,10,13,101,57,43,74,118,175,42,17,25,8
S01011504,578,39,4,35,100,55,50,71,98,129,28,14,14,8
S01011505,698,29,1,28,101,68,43,98,128,164,51,16,35,16
S01011506,503,34,9,25,102,49,40,69,86,106,14,8,6,3
S01011507,612,36,16,20,109,60,47,82,94,122,58,42,16,4
S01011508,962,90,28,62,198,104,79,142,123,180,38,20,18,8
S01011509,610,39,14,25,91,68,41,107,125,106,30,19,11,3
S01011510,1122,27,5,22,194,75,101,135,281,193,104,43,61,12
S01011511,524,9,0,9,55,57,20,48,132,152,41,17,24,10
S01011512,951,16,0,16,75,134,40,103,209,226,133,77,56,15
S01011513,774,22,4,18,93,72,31,113,155,200,84,54,30,4
S01011514,954,23,0,23,108,77,72,133,197,281,48,28,20,15
S01011515,522,21,5,16,103,95,56,83,60,87,14,8,6,3
S01011516,887,86,28,58,260,119,90,128,102,76,17,8,9,9
S01011517,565,37,11,26,81,96,32,82,103,107,18,5,13,9
S01011518,661,27,9,18,89,39,57,98,127,179,45,33,12,0
S01011519,781,19,5,14,140,65,39,105,169,211,33,26,7,0
S01011520,596,20,0,20,76,57,27,69,113,145,76,48,28,13
S01011521,967,47,25,22,153,118,55,85,208,185,104,54,50,12
S01011522,891,33,8,25,151,114,55,89,222,170,39,27,12,18
S01011523,741,22,4,18,95,57,61,98,161,217,25,13,12,5
S01011524,890,91,27,64,176,119,71,143,122,147,16,9,7,5
S01011525,873,87,25,62,194,80,58,121,141,169,20,16,4,3
S01011526,1018,52,5,47,168,136,83,163,195,181,38,23,15,2
S01011527,704,80,48,32,164,68,75,98,91,103,25,10,15,0
S01011528,974,35,12,23,156,115,61,137,204,207,51,18,33,8
S01011529,529,19,8,11,70,57,23,36,121,140,49,25,24,14
S01011530,947,42,4,38,121,106,58,124,177,245,61,35,26,13
S01011531,1100,134,24,110,290,148,107,120,109,151,32,14,18,9
S01011532,652,95,30,65,174,46,106,84,49,79,14,7,7,5
S01011533,626,21,13,8,51,68,51,73,133,164,60,38,22,5
S01011534,766,66,8,58,125,118,73,89,126,131,34,16,18,4
S01011535,862,28,4,24,98,91,30,98,188,225,89,53,36,15
S01011536,674,107,28,79,188,112,85,49,54,65,5,0,5,9
S01011537,530,62,14,48,137,120,38,43,44,67,13,12,1,6
S01011538,655,148,40,108,191,59,72,54,54,60,12,6,6,5
S01011539,738,29,8,21,123,64,47,70,168,179,49,20,29,9
S01011540,1052,49,10,39,187,112,102,118,165,262,42,25,17,15
S01011541,937,16,5,11,103,69,77,115,236,253,55,19,36,13
S01011542,929,30,17,13,97,98,63,145,222,225,47,13,34,2
S01011543,810,12,5,7,70,69,71,132,190,195,61,28,33,10
S01011544,673,14,5,9,90,56,46,66,177,187,30,15,15,7
S01011545,572,6,0,6,51,56,38,107,125,165,20,10,10,4
S01011546,747,131,54,77,236,91,121,59,58,41,3,0,3,7
S01011547,609,80,18,62,198,67,83,52,52,61,13,6,7,3
S01011548,746,42,12,30,156,111,57,66,151,141,8,7,1,14
S01011549,801,85,25,60,195,99,83,97,98,126,18,4,14,0
S01011550,714,106,14,92,222,161,67,45,40,55,15,9,6,3
S01011551,548,44,15,29,136,58,51,73,86,72,28,12,16,0
S01011552,703,51,10,41,188,106,83,84,112,69,7,5,2,3
S01011553,857,172,18,154,287,53,185,53,46,43,7,0,7,11
S01011554,855,41,9,32,124,114,82,85,143,234,27,20,7,5
S01011555,552,9,1,8,61,75,29,69,121,155,30,17,13,3
S01011556,507,16,10,6,63,65,53,48,136,77,38,19,19,11
S01011557,750,9,4,5,132,92,55,86,184,161,28,16,12,3
S01011558,577,20,8,12,75,64,53,85,114,126,39,19,20,1
S01011559,620,22,4,18,93,40,58,91,123,140,38,24,14,15
S01011560,757,17,6,11,125,77,25,71,171,234,30,17,13,7
S01011561,834,0,0,0,119,72,51,90,219,235,43,22,21,5
S01011562,647,20,0,20,90,65,36,71,111,152,77,47,30,25
S01011563,762,25,8,17,120,85,51,59,147,202,60,35,25,13
S01011564,966,59,12,47,162,131,88,127,147,200,48,25,23,4
S01011565,952,29,13,16,139,135,77,126,159,235,35,13,22,17
S01011566,917,48,19,29,72,97,62,110,196,223,82,32,50,27
S01011567,965,30,5,25,105,131,85,122,207,238,38,32,6,9
S01011568,847,63,22,41,181,130,65,99,144,139,23,13,10,3
S01011569,958,82,28,54,177,108,43,144,164,197,33,23,10,10
S01011570,690,28,14,14,97,94,50,88,141,151,28,17,11,13
S01011571,649,19,0,19,100,68,28,72,154,160,31,14,17,17
S01011572,588,30,8,22,134,71,39,46,127,118,21,6,15,2
S01011573,1084,102,22,80,256,137,125,119,123,173,37,13,24,12
S01011574,795,62,28,34,139,99,83,117,125,148,9,5,4,13
S01011575,533,24,5,19,103,37,33,66,105,101,50,18,32,14
S01011576,779,5,4,1,63,67,31,66,214,249,74,25,49,10
S01011577,702,51,12,39,134,104,64,61,124,116,34,21,13,14
S01011578,826,45,11,34,170,108,57,70,154,175,41,16,25,6
S01011579,1089,194,49,145,391,131,139,93,78,50,10,6,4,3
S01011580,766,56,9,47,150,85,67,92,119,134,57,35,22,6
S01011581,789,44,6,38,81,88,44,99,163,192,69,49,20,9
S01011582,1072,185,51,134,335,138,117,81,117,93,1,1,0,5
S01011583,672,34,6,28,143,71,36,85,135,124,29,12,17,15
S01011584,708,17,3,14,91,98,32,84,162,189,25,19,6,10
S01011585,719,22,7,15,101,119,57,63,155,155,41,23,18,6
S01011586,556,10,0,10,97,84,14,71,94,138,43,10,33,5
S01011587,575,17,3,14,100,47,34,91,126,128,22,11,11,10
S01011588,792,45,22,23,93,115,67,79,158,153,76,31,45,6
S01011589,868,32,17,15,154,80,65,113,219,181,23,16,7,1
S01011590,689,18,6,12,103,75,67,92,133,154,43,22,21,4
S01011591,597,15,0,15,75,42,42,71,86,197,61,30,31,8
S01011592,705,20,6,14,73,88,44,78,138,190,68,32,36,6
S01011593,717,73,25,48,149,108,54,76,98,133,19,8,11,7
S01011594,438,17,8,9,86,46,52,60,76,87,10,3,7,4
S01011595,596,76,11,65,169,82,67,45,45,92,9,1,8,11
S01011596,980,89,33,56,252,147,55,74,151,139,51,32,19,22
S01011597,525,49,12,37,150,61,36,63,86,65,6,4,2,9
S01011598,785,21,5,16,57,92,37,69,186,171,129,53,76,23
S01011599,823,25,1,24,165,125,47,77,122,210,41,23,18,11
S01011600,737,31,6,25,129,98,45,101,149,166,16,14,2,2
S01011601,848,98,24,74,224,99,78,119,90,123,17,14,3,0
S01011602,614,47,9,38,97,54,56,52,136,115,49,26,23,8
S01011603,791,12,3,9,115,103,35,95,180,188,48,25,23,15
S01011604,690,17,5,12,82,66,44,80,141,195,55,27,28,10
S01011605,844,14,3,11,129,106,83,124,162,185,34,17,17,7
S01011606,1001,129,21,108,327,163,77,100,85,93,11,7,4,16
S01011607,569,69,16,53,158,55,65,74,63,67,15,0,15,3
S01011608,945,102,40,62,249,126,134,117,95,110,12,9,3,0
S01011609,970,21,1,20,88,71,71,124,195,246,122,70,52,32
S01011610,833,28,5,23,97,75,28,65,202,236,93,52,41,9
S01011611,626,44,20,24,180,78,57,99,67,75,18,10,8,8
S01011612,628,107,16,91,249,77,77,44,24,41,9,5,4,0
S01011613,940,132,33,99,288,114,133,99,59,105,10,0,10,0
S01011614,447,52,13,39,122,75,49,26,32,66,14,2,12,11
S01011615,728,46,17,29,103,77,63,83,148,146,46,20,26,16
S01011616,423,19,2,17,40,49,35,40,87,101,42,28,14,10
S01011617,840,35,16,19,92,91,77,98,163,226,47,31,16,11
S01011618,654,33,6,27,94,59,40,61,150,171,44,32,12,2
S01011619,1050,123,34,89,340,153,69,104,124,116,18,8,10,3
S01011620,1097,144,24,120,303,174,106,145,81,130,2,1,1,12
S01011621,781,72,23,49,191,85,64,95,105,142,23,6,17,4
S01011622,649,115,25,90,200,72,101,56,42,56,2,2,0,5
S01011623,703,33,8,25,109,84,71,62,132,159,41,27,14,12
S01011624,722,63,23,40,190,79,67,93,82,119,27,6,21,2
S01011625,548,16,5,11,98,81,41,61,105,115,23,9,14,8
S01011626,811,115,41,74,211,138,94,79,58,82,18,1,17,16
S01011627,733,92,21,71,256,66,69,101,52,83,6,3,3,8
S01011628,1063,133,39,94,282,159,142,116,88,126,10,6,4,7
S01011629,629,6,2,4,86,66,51,94,107,153,40,14,26,26
S01011630,639,33,13,20,60,91,60,63,93,175,61,15,46,3
S01011631,628,12,9,3,26,68,36,90,115,181,79,44,35,21
S01011632,754,13,0,13,80,63,60,64,167,254,43,26,17,10
S01011633,736,40,6,34,82,82,51,93,111,214,59,31,28,4
S01011634,565,24,2,22,68,67,10,77,129,131,46,30,16,13
S01011635,683,25,5,20,87,67,57,82,155,144,56,43,13,10
S01011636,720,22,7,15,65,98,52,109,155,161,47,28,19,11
S01011637,686,22,0,22,140,47,53,77,134,154,51,31,20,8
S01011638,483,16,4,12,94,63,44,49,90,107,16,8,8,4
S01011639,590,26,10,16,84,68,22,72,116,132,66,36,30,4
S01011640,674,25,8,17,93,59,51,124,106,176,34,11,23,6
S01011641,476,51,8,43,142,77,63,49,52,40,1,1,0,1
S01011642,790,97,18,79,197,105,61,84,101,103,38,11,27,4
S01011643,586,95,14,81,153,45,79,52,85,67,8,4,4,2
S01011644,717,67,9,58,173,91,73,90,114,96,12,7,5,1
S01011645,537,24,5,19,113,90,64,59,90,87,8,6,2,2
S01011646,696,110,30,80,208,117,65,70,63,61,2,2,0,0
S01011647,878,119,42,77,293,125,66,97,92,71,14,4,10,1
S01011648,694,78,11,67,169,89,58,90,83,83,43,23,20,1
S01011649,502,19,11,8,81,101,35,63,84,85,21,9,12,13
S01011650,721,98,25,73,169,107,82,58,102,85,19,15,4,1
S01011651,926,79,13,66,209,117,54,98,157,142,37,14,23,33
S01011652,747,84,23,61,193,107,46,67,114,93,30,10,20,13
S01011653,899,24,6,18,124,100,81,133,126,216,82,35,47,13
S01011654,983,92,18,74,151,119,95,83,169,167,85,46,39,22
S01011655,846,22,6,16,104,92,49,101,164,199,107,55,52,8
S01011656,608,17,3,14,64,53,32,75,100,177,78,34,44,12
S01011657,514,35,9,26,82,31,32,55,92,116,56,30,26,15
S01011658,655,21,3,18,59,40,66,77,140,171,62,27,35,19
S01011659,787,25,7,18,106,94,59,99,146,209,31,13,18,18
S01011660,906,95,29,66,212,134,82,102,116,137,15,9,6,13
S01011661,516,23,7,16,77,70,61,65,88,113,18,12,6,1
S01011662,642,67,9,58,203,67,105,57,72,64,2,1,1,5
S01011663,961,21,0,21,123,126,67,136,130,236,107,39,68,15
S01011664,1044,20,11,9,99,78,75,131,237,328,75,60,15,1
S01011665,850,33,5,28,144,121,44,74,155,190,65,32,33,24
S01011666,853,38,11,27,126,113,39,80,153,188,100,36,64,16
S01011667,723,56,8,48,99,95,76,86,98,164,46,28,18,3
S01011668,1042,11,4,7,95,82,41,151,245,317,82,48,34,18
S01011669,628,98,24,74,148,77,93,47,47,92,19,12,7,7
S01011670,536,14,1,13,77,68,42,50,130,122,30,16,14,3
S01011671,659,81,14,67,146,101,70,45,88,111,12,7,5,5
S01011672,591,64,14,50,100,47,59,53,104,110,46,28,18,8
S01011673,661,27,4,23,83,87,42,90,99,175,52,29,23,6
S01011674,1002,59,10,49,199,167,56,110,151,211,48,22,26,1
S01011675,896,54,12,42,132,78,57,85,190,217,69,31,38,14
S01011676,699,19,0,19,65,66,29,122,109,239,49,22,27,1
S01011677,622,65,24,41,143,99,51,46,64,102,39,16,23,13
S01011678,464,14,2,12,50,36,40,66,68,132,53,41,12,5
S01011679,563,35,14,21,144,89,50,106,63,60,9,2,7,7
S01011680,1100,44,11,33,111,151,80,103,210,295,91,52,39,15
S01011681,847,51,9,42,135,94,76,87,156,195,45,12,33,8
S01011682,435,42,10,32,88,28,126,37,32,66,14,3,11,2
S01011683,745,19,2,17,95,75,102,114,100,207,25,8,17,8
S01011684,543,34,11,23,100,50,69,72,72,121,23,19,4,2
S01011685,802,92,28,64,256,68,111,80,73,104,18,11,7,0
S01011686,828,108,22,86,243,90,95,90,79,112,6,6,0,5
S01011687,864,56,9,47,118,98,59,121,183,174,53,27,26,2
S01011688,820,125,32,93,178,101,132,79,77,92,29,19,10,7
S01011689,667,113,32,81,165,78,120,69,43,61,9,2,7,9
S01011690,983,117,32,85,231,113,156,100,109,111,43,28,15,3
S01011691,624,83,34,49,169,78,57,51,88,82,11,11,0,5
S01011692,1074,30,9,21,138,129,64,122,213,302,61,32,29,15
S01011693,807,90,15,75,232,112,68,88,91,92,17,10,7,17
S01011694,535,80,15,65,157,60,52,42,56,59,26,15,11,3
S01011695,931,151,46,105,284,105,121,86,76,93,14,10,4,1
S01011696,1068,287,46,241,366,83,146,59,61,54,7,1,6,5
S01011697,1029,159,28,131,293,111,106,88,124,111,28,10,18,9
S01011698,643,10,0,10,114,74,91,93,97,136,22,5,17,6
S01011699,911,122,47,75,246,129,126,101,89,78,11,6,5,9
S01011700,759,68,23,45,186,102,109,87,85,102,13,6,7,7
S01011701,1016,198,43,155,290,153,114,88,90,61,19,13,6,3
S01011702,733,119,21,98,191,87,71,68,83,88,19,8,11,7
S01011703,631,126,23,103,173,61,140,59,23,36,13,5,8,0
S01011704,747,134,25,109,230,97,79,78,78,33,13,6,7,5
S01011705,759,55,16,39,131,87,83,80,114,148,47,21,26,14
S01011706,987,83,24,59,199,117,100,119,159,172,27,12,15,11
S01011707,713,87,20,67,246,90,68,73,89,43,8,0,8,9
S01011708,919,49,9,40,196,133,78,96,155,171,34,20,14,7
S01011709,954,94,26,68,251,96,91,103,139,142,27,7,20,11
S01011710,647,10,4,6,75,79,35,67,166,140,71,19,52,4
S01011711,683,12,2,10,91,92,45,84,123,185,43,16,27,8
S01011712,530,35,8,27,92,88,39,62,102,85,25,7,18,2
S01011713,851,67,13,54,186,130,86,94,144,130,14,8,6,0
S01011714,566,91,7,84,131,66,67,78,52,74,4,4,0,3
S01011715,633,24,0,24,99,73,37,81,127,131,46,26,20,15
S01011716,917,76,11,65,258,153,120,90,108,100,9,5,4,3
S01011717,710,58,15,43,180,81,106,69,96,110,7,3,4,3
S01011718,800,110,15,95,269,88,112,82,67,64,6,5,1,2
S01011719,634,101,37,64,206,80,103,57,35,41,0,0,0,11
S01011720,529,92,27,65,192,64,67,34,28,50,2,2,0,0
S01011721,716,35,4,31,124,147,42,93,116,137,16,6,10,6
S01011722,721,42,1,41,127,108,57,91,129,118,35,14,21,14
S01011723,941,73,11,62,192,149,96,117,135,163,13,4,9,3
S01011724,733,87,11,76,207,101,63,58,79,98,28,14,14,12
S01011725,634,125,36,89,207,63,73,40,52,65,4,1,3,5
S01011726,552,84,22,62,170,89,52,54,38,63,1,1,0,1
S01011727,774,154,47,107,300,91,113,44,34,28,3,0,3,7
S01011728,929,45,12,33,196,121,98,122,152,162,22,13,9,11
S01011729,710,37,5,32,115,97,37,109,106,154,41,9,32,14
S01011730,844,75,9,66,203,121,71,117,130,120,2,1,1,5
S01011731,824,38,13,25,153,118,102,84,146,162,21,13,8,0
S01011732,785,113,36,77,238,120,101,81,54,66,12,3,9,0
S01011733,851,40,15,25,167,157,68,90,140,165,20,7,13,4
S01011734,751,73,14,59,172,113,68,91,121,94,11,7,4,8
S01011735,736,98,32,66,206,104,98,68,80,66,12,2,10,4
S01011736,770,39,6,33,145,158,56,83,109,135,22,8,14,23
S01011737,727,39,12,27,149,121,72,56,76,114,77,45,32,23
S01011738,1016,77,22,55,200,122,109,95,166,173,58,36,22,16
S01011739,502,18,5,13,59,76,27,69,130,96,16,6,10,11
S01011740,783,25,10,15,153,78,33,103,143,146,62,34,28,40
S01011741,657,28,11,17,72,105,35,92,101,170,39,18,21,15
S01011742,758,62,7,55,141,117,52,90,154,110,26,11,15,6
S01011743,797,43,3,40,144,167,57,117,111,129,15,10,5,14
S01011744,849,50,17,33,182,129,73,80,146,142,41,20,21,6
S01011745,711,24,8,16,105,107,41,98,126,182,19,13,6,9
S01011746,539,7,4,3,82,47,40,53,152,130,19,10,9,9
S01011747,992,20,5,15,103,139,56,118,222,231,88,20,68,15
S01011748,878,10,0,10,97,118,57,131,197,178,57,33,24,33
S01011749,769,17,3,14,78,68,32,70,167,187,122,76,46,28
S01011750,876,48,14,34,143,156,59,109,146,176,31,10,21,8
S01011751,972,38,11,27,107,112,56,105,215,208,94,35,59,37
S01011752,921,27,8,19,192,140,63,138,159,179,17,9,8,6
S01011753,777,90,26,64,208,112,58,80,109,93,26,10,16,1
S01011754,764,44,15,29,130,125,60,119,122,122,31,14,17,11
S01011755,939,46,14,32,192,135,62,98,186,172,37,16,21,11
S01011756,990,38,8,30,182,171,70,112,180,196,31,7,24,10
S01011757,730,16,0,16,134,128,51,92,120,129,44,19,25,16
S01011758,624,37,21,16,112,93,54,87,96,128,14,2,12,3
S01011759,836,63,11,52,101,140,60,109,150,171,26,12,14,16
S01011760,884,48,13,35,132,157,65,83,170,187,32,10,22,10
S01011761,720,43,8,35,126,85,63,68,124,187,17,4,13,7
S01011762,656,42,5,37,103,100,37,61,154,104,40,30,10,15
S01011763,773,33,12,21,146,99,86,110,111,153,25,11,14,10
S01011764,403,23,8,15,96,62,24,66,66,54,7,0,7,5
S01011765,974,121,28,93,290,149,127,82,84,105,10,8,2,6
S01011766,513,95,28,67,144,68,76,16,28,72,7,5,2,7
S01011767,848,28,7,21,156,91,75,93,167,170,54,23,31,14
S01011768,694,19,2,17,130,98,41,59,111,170,47,15,32,19
S01011769,607,36,3,33,91,109,57,65,121,92,25,14,11,11
S01011770,808,41,10,31,133,135,49,106,146,149,37,18,19,12
S01011771,667,136,25,111,199,86,76,68,48,41,10,7,3,3
S01011772,1102,257,74,183,401,100,177,58,50,39,18,3,15,2
S01011773,596,106,29,77,188,72,66,80,60,19,3,3,0,2
S01011774,941,129,31,98,261,143,118,96,86,80,12,2,10,16
S01011775,667,179,66,113,217,81,67,52,45,23,3,3,0,0
S01011776,1097,277,67,210,382,94,135,66,75,61,7,1,6,0
S01011777,645,128,24,104,215,128,33,48,41,42,9,3,6,1
S01011778,634,148,44,104,227,67,68,38,46,21,17,1,16,2
S01011779,793,153,25,128,239,112,81,82,72,44,8,3,5,2
S01011780,939,244,80,164,260,72,162,76,62,49,14,5,9,0
S01011781,584,119,38,81,162,55,60,67,53,60,1,0,1,7
S01011782,683,119,38,81,213,97,78,70,48,50,7,1,6,1
S01011783,575,97,24,73,164,83,74,47,65,36,9,2,7,0
S01011784,793,24,3,21,148,116,76,87,145,158,19,8,11,20
S01011785,873,79,13,66,171,176,61,82,162,114,23,20,3,5
S01011786,431,92,29,63,159,45,50,34,19,13,8,0,8,11
S01011787,1026,49,14,35,134,76,95,137,221,239,62,33,29,13
S01011788,697,232,85,147,180,46,188,10,23,13,1,0,1,4
S01011789,660,71,20,51,140,47,122,102,57,104,14,12,2,3
S01011790,998,75,11,64,207,96,132,79,166,165,51,35,16,27
S01011791,735,25,6,19,142,96,68,90,122,139,38,27,11,15
S01011792,888,50,14,36,191,91,109,83,125,193,39,26,13,7
S01011793,660,67,20,47,175,74,82,78,86,80,9,7,2,9
S01011794,884,30,15,15,143,130,103,78,155,201,39,23,16,5
S01011795,627,20,9,11,110,66,49,89,112,126,54,20,34,1
S01011796,774,13,0,13,137,75,63,97,140,170,61,35,26,18
S01011797,1012,168,63,105,283,100,158,104,80,110,7,2,5,2
S01011798,550,23,4,19,88,45,61,81,98,117,27,13,14,10
S01011799,918,85,34,51,214,93,125,140,111,124,26,13,13,0
S01011800,519,24,6,18,63,46,44,123,82,127,8,2,6,2
S01011801,608,36,15,21,102,66,44,71,131,98,42,20,22,18
S01011802,731,41,19,22,102,68,66,112,141,148,42,13,29,11
S01011803,593,25,5,20,72,52,97,93,125,94,33,14,19,2
S01011804,724,35,12,23,175,49,105,90,115,132,15,11,4,8
S01011805,534,48,4,44,121,20,93,65,81,86,7,5,2,13
S01011806,768,67,21,46,167,46,155,102,117,100,11,4,7,3
S01011807,1063,99,22,77,222,44,337,104,140,93,13,13,0,11
S01011808,623,37,8,29,153,40,103,80,108,84,14,9,5,4
S01011809,715,94,27,67,164,45,166,71,73,94,8,5,3,0
S01011810,940,76,14,62,173,71,233,124,94,156,13,11,2,0
S01011811,1052,82,25,57,215,40,319,131,112,139,12,11,1,2
S01011812,669,99,13,86,183,34,172,55,67,53,6,3,3,0
S01011813,748,55,12,43,161,40,191,100,82,109,6,2,4,4
S01011814,721,61,16,45,180,34,204,51,89,99,3,2,1,0
S01011815,814,59,15,44,199,56,138,91,121,128,15,8,7,7
S01011816,628,77,39,38,224,51,117,67,43,45,3,3,0,1
S01011817,724,61,24,37,186,36,182,100,73,73,7,6,1,6
S01011818,1091,86,30,56,265,85,143,129,193,172,12,9,3,6
S01011819,835,47,10,37,138,76,94,129,151,184,12,9,3,4
S01011820,720,59,10,49,193,63,80,101,91,116,14,9,5,3
S01011821,430,8,4,4,90,40,40,45,82,94,25,12,13,6
S01011822,712,50,9,41,118,59,85,116,151,105,25,19,6,3
S01011823,608,33,6,27,130,56,67,79,111,125,7,6,1,0
S01011824,703,18,4,14,143,55,63,107,124,174,19,13,6,0
S01011825,535,41,4,37,152,40,46,67,98,79,5,3,2,7
S01011826,652,52,22,30,116,63,88,79,126,124,4,3,1,0
S01011827,527,18,7,11,101,36,143,73,85,58,13,7,6,0
S01011828,904,73,20,53,167,47,276,88,149,79,16,15,1,9
S01011829,409,51,19,32,78,34,89,59,48,47,3,3,0,0
S01011830,572,26,6,20,88,52,207,66,64,53,15,6,9,1
S01011831,896,51,13,38,137,50,368,53,148,60,22,9,13,7
S01011832,834,40,9,31,163,49,303,78,118,66,17,12,5,0
S01011833,959,257,74,183,296,78,157,69,50,36,14,14,0,2
S01011834,496,164,45,119,144,41,67,30,22,23,5,2,3,0
S01011835,685,168,30,138,205,51,118,58,35,33,9,6,3,8
S01011836,756,196,46,150,222,76,116,44,70,27,5,2,3,0
S01011837,620,148,29,119,173,44,148,36,28,32,8,3,5,3
S01011838,805,216,47,169,241,102,95,52,51,41,1,1,0,6
S01011839,962,169,50,119,295,117,125,77,95,71,11,11,0,2
S01011840,1001,173,53,120,289,94,96,108,132,96,13,6,7,0
S01011841,950,121,44,77,281,100,120,90,102,117,14,11,3,5
S01011842,965,96,21,75,215,76,89,132,168,162,19,7,12,8
S01011843,980,213,55,158,276,71,238,66,54,50,9,8,1,3
S01011844,753,285,48,237,214,45,105,26,36,36,3,2,1,3
S01011845,857,115,48,67,212,90,118,87,106,107,7,6,1,15
S01011846,869,208,48,160,245,79,130,51,65,73,13,13,0,5
S01011847,429,98,28,70,162,25,89,21,16,16,0,0,0,2
S01011848,727,134,19,115,201,51,152,34,82,63,4,3,1,6
S01011849,813,121,35,86,160,79,119,117,132,69,14,4,10,2
S01011850,672,104,37,67,193,72,178,41,46,28,9,5,4,1
S01011851,870,110,22,88,170,52,171,101,130,113,16,1,15,7
S01011852,976,101,16,85,192,100,148,102,153,136,33,23,10,11
S01011853,708,108,25,83,178,63,103,82,82,81,8,4,4,3
S01011854,745,103,20,83,203,55,115,93,81,82,4,3,1,9
S01011855,848,74,15,59,117,53,114,142,131,196,15,5,10,6
S01011856,691,162,43,119,259,74,112,31,33,13,3,0,3,4
S01011857,689,100,30,70,177,39,168,53,80,55,13,10,3,4
S01011858,859,169,44,125,277,63,142,70,67,58,6,4,2,7
S01011859,839,99,22,77,196,76,152,87,122,86,17,15,2,4
S01011860,506,68,18,50,137,44,106,60,35,36,16,10,6,4
S01011861,732,104,27,77,197,60,174,44,67,70,10,2,8,6
S01011862,947,190,54,136,309,73,130,76,105,43,12,3,9,9
S01011863,734,204,62,142,192,54,81,66,76,49,11,6,5,1
S01011864,716,120,35,85,239,76,96,57,74,50,1,1,0,3
S01011865,601,57,16,41,153,89,72,79,43,86,17,4,13,5
S01011866,817,89,11,78,183,73,120,88,117,136,9,2,7,2
S01011867,961,72,18,54,195,72,99,117,188,184,23,16,7,11
S01011868,869,116,25,91,206,80,131,96,137,76,26,15,11,1
S01011869,758,103,14,89,169,67,119,84,99,86,22,14,8,9
S01011870,692,59,13,46,149,54,91,78,113,134,12,10,2,2
S01011871,1087,165,53,112,303,50,244,123,99,69,29,20,9,5
S01011872,914,193,33,160,234,73,246,53,60,39,11,3,8,5
S01011873,812,154,32,122,229,102,117,79,67,47,3,1,2,14
S01011874,657,63,17,46,175,91,101,83,81,52,6,2,4,5
S01011875,672,64,16,48,134,89,62,73,106,139,5,5,0,0
S01011876,939,168,46,122,307,62,166,70,93,64,9,7,2,0
S01011877,546,64,10,54,154,50,90,48,49,83,6,3,3,2
S01011878,947,191,56,135,278,80,156,77,96,59,8,1,7,2
S01011879,547,118,44,74,147,48,103,53,33,24,8,6,2,13
S01011880,593,141,42,99,143,34,118,46,63,46,2,1,1,0
S01011881,817,98,14,84,211,94,108,75,95,107,19,7,12,10
S01011882,941,87,23,64,190,142,119,96,124,157,22,15,7,4
S01011883,1026,192,43,149,310,115,132,92,85,73,17,6,11,10
S01011884,412,80,12,68,110,44,87,26,27,34,4,0,4,0
S01011885,689,163,16,147,241,46,107,42,52,28,5,1,4,5
S01011886,875,172,29,143,214,80,105,105,94,82,10,6,4,13
S01011887,594,63,7,56,125,89,82,67,96,63,7,7,0,2
S01011888,871,34,6,28,180,134,65,115,147,151,37,16,21,8
S01011889,892,155,39,116,245,132,104,78,97,63,12,10,2,6
S01011890,708,132,33,99,162,96,53,84,63,105,8,5,3,5
S01011891,741,35,6,29,121,111,48,135,91,148,39,23,16,13
S01011892,981,135,27,108,290,137,102,84,108,98,7,3,4,20
S01011893,929,108,19,89,217,169,66,97,136,107,18,8,10,11
S01011894,635,51,11,40,133,108,62,48,123,90,5,1,4,15
S01011895,632,184,12,172,164,61,102,42,40,27,0,0,0,12
S01011896,866,157,19,138,244,162,68,67,79,78,4,2,2,7
S01011897,1027,236,51,185,307,113,94,88,83,79,23,23,0,4
S01011898,675,213,35,178,230,90,74,20,34,14,0,0,0,0
S01011899,779,121,36,85,229,137,49,88,67,81,7,7,0,0
S01011900,735,197,23,174,220,111,70,44,58,29,5,5,0,1
S01011901,899,191,56,135,262,120,117,58,92,39,2,1,1,18
S01011902,1056,230,34,196,369,138,106,63,87,51,2,2,0,10
S01011903,798,125,33,92,294,115,74,74,58,47,1,1,0,10
S01011904,744,125,31,94,270,111,67,54,71,41,3,1,2,2
S01011905,775,200,52,148,230,88,103,52,64,26,3,1,2,9
S01011906,425,44,10,34,161,52,37,47,38,38,4,2,2,4
S01011907,745,77,5,72,201,106,63,122,103,69,4,1,3,0
S01011908,376,56,16,40,116,53,34,48,46,18,3,2,1,2
S01011909,1036,125,27,98,303,149,94,146,128,74,7,4,3,10
S01011910,910,39,12,27,106,83,67,117,197,233,56,25,31,12
S01011911,641,31,13,18,118,90,55,91,94,142,16,12,4,4
S01011912,727,24,2,22,133,81,42,83,161,171,20,8,12,12
S01011913,739,26,4,22,104,85,47,90,154,194,37,16,21,2
S01011914,865,21,4,17,99,93,71,115,232,189,33,7,26,12
S01011915,811,36,8,28,112,83,60,110,155,220,17,11,6,18
S01011916,592,20,7,13,71,58,31,89,135,146,38,22,16,4
S01011917,510,8,2,6,82,49,32,68,126,129,7,2,5,9
S01011918,786,27,6,21,96,61,54,73,161,210,83,44,39,21
S01011919,809,57,12,45,140,105,54,88,151,146,33,21,12,35
S01011920,622,20,2,18,75,90,51,74,111,173,15,10,5,13
S01011921,594,19,1,18,66,68,37,59,130,165,29,10,19,21
S01011922,768,24,5,19,104,81,38,92,180,206,37,16,21,6
S01011923,880,22,5,17,141,101,52,123,181,201,46,28,18,13
S01011924,454,16,6,10,60,58,36,53,98,101,13,2,11,19
S01011925,758,133,45,88,225,76,96,92,51,64,16,10,6,5
S01011926,656,37,10,27,98,78,61,82,156,127,13,8,5,4
S01011927,613,14,5,9,102,105,50,62,135,118,19,10,9,8
S01011928,702,51,13,38,117,79,82,114,95,137,20,13,7,7
S01011929,692,16,3,13,126,115,30,99,137,147,20,18,2,2
S01011930,638,23,11,12,109,92,48,68,94,180,15,10,5,9
S01011931,625,15,2,13,95,47,34,77,119,170,57,43,14,11
S01011932,621,46,3,43,129,89,38,60,88,116,30,18,12,25
S01011933,631,30,4,26,104,79,51,81,97,140,21,12,9,28
S01011934,1091,94,29,65,227,108,105,111,165,176,35,17,18,70
S01011935,793,48,12,36,120,79,68,93,127,178,26,10,16,54
S01011936,679,110,5,105,171,79,55,55,92,72,18,8,10,27
S01011937,667,87,12,75,124,85,47,69,107,97,22,16,6,29
S01011938,670,89,23,66,174,76,90,49,77,89,16,6,10,10
S01011939,710,52,9,43,147,72,49,88,123,99,37,15,22,43
S01011940,441,29,7,22,77,53,27,52,87,71,26,15,11,19
S01011941,682,64,7,57,121,84,41,67,159,100,15,7,8,31
S01011942,849,46,9,37,175,103,44,82,158,146,31,19,12,64
S01011943,1112,67,8,59,167,132,72,115,242,203,60,31,29,54
S01011944,444,116,20,96,136,24,80,26,47,10,5,3,2,0
S01011945,767,271,73,198,256,66,89,35,30,8,4,3,1,8
S01011946,789,142,25,117,175,68,64,108,123,86,16,8,8,7
S01011947,490,57,5,52,139,75,38,75,56,48,2,2,0,0
S01011948,1042,224,32,192,299,110,90,87,105,96,30,12,18,1
S01011949,825,166,47,119,306,93,87,61,61,40,11,8,3,0
S01011950,738,119,28,91,181,97,61,76,124,75,2,2,0,3
S01011951,678,85,19,66,200,92,86,57,64,78,7,4,3,9
S01011952,498,110,31,79,166,63,60,46,34,17,2,2,0,0
S01011953,754,180,35,145,218,102,98,56,40,45,12,2,10,3
S01011954,492,38,15,23,120,88,33,70,64,72,7,3,4,0
S01011955,959,86,11,75,207,132,138,111,123,140,19,10,9,3
S01011956,1033,214,45,169,326,108,117,89,82,77,10,10,0,10
S01011957,742,140,33,107,169,78,133,79,73,54,12,6,6,4
S01011958,1060,142,26,116,290,63,249,79,105,119,10,6,4,3
S01011959,854,115,37,78,236,71,188,70,80,78,9,4,5,7
S01011960,798,211,36,175,249,71,90,83,44,41,5,4,1,4
S01011961,734,117,25,92,195,79,72,95,70,96,2,0,2,8
S01011962,688,192,47,145,169,68,127,62,32,36,2,2,0,0
S01011963,522,86,20,66,133,70,33,58,66,65,10,3,7,1
S01011964,980,184,27,157,235,109,110,138,82,103,15,6,9,4
S01011965,797,159,39,120,198,118,70,91,82,64,10,4,6,5
S01011966,840,216,46,170,209,124,98,53,70,54,11,9,2,5
S01011967,997,230,40,190,260,85,224,60,68,58,12,11,1,0
S01011968,996,171,28,143,253,154,99,109,102,91,8,0,8,9
S01011969,1045,81,18,63,227,96,101,137,175,206,20,6,14,2
S01011970,990,35,12,23,72,76,118,133,222,268,46,33,13,20
S01011971,576,108,37,71,127,46,87,62,65,72,9,1,8,0
S01011972,1115,127,41,86,272,87,253,101,149,104,18,15,3,4
S01011973,621,96,31,65,152,34,114,52,91,69,10,8,2,3
S01011974,738,109,30,79,210,49,145,79,61,70,15,13,2,0
S01011975,452,66,8,58,104,32,87,55,52,40,12,7,5,4
S01011976,779,80,32,48,179,87,136,113,78,81,15,12,3,10
S01011977,1111,126,25,101,245,74,183,131,145,170,25,14,11,12
S01011978,693,34,8,26,153,56,89,64,117,163,13,8,5,4
S01011979,947,134,31,103,272,93,200,58,87,89,2,2,0,12
S01011980,401,57,23,34,89,27,109,38,37,38,6,4,2,0
S01011981,890,132,33,99,161,60,210,150,108,51,13,8,5,5
S01011982,940,138,47,91,243,38,232,101,103,66,14,14,0,5
S01011983,695,83,7,76,122,65,159,124,76,51,9,7,2,6
S01011984,676,21,0,21,136,50,72,60,121,170,38,25,13,8
S01011985,662,57,14,43,180,47,145,61,74,83,13,8,5,2
S01011986,664,22,4,18,101,49,78,77,154,141,34,17,17,8
S01011987,948,62,21,41,206,116,132,86,197,124,22,17,5,3
S01011988,620,78,21,57,211,50,96,65,58,51,5,5,0,6
S01011989,866,76,22,54,215,120,121,105,86,135,8,5,3,0
S01011990,750,81,17,64,190,105,102,85,71,100,13,7,6,3
S01011991,703,37,14,23,148,60,103,87,127,109,32,11,21,0
S01011992,962,172,26,146,249,94,150,63,120,95,15,9,6,4
S01011993,838,33,12,21,125,87,66,125,156,188,42,19,23,16
S01011994,676,192,51,141,186,59,126,50,34,24,5,5,0,0
S01011995,806,129,29,100,224,47,196,71,60,75,4,4,0,0
S01011996,555,39,17,22,140,47,50,87,72,91,23,23,0,6
S01011997,886,106,25,81,209,63,130,114,113,116,17,9,8,18
S01011998,545,104,34,70,180,61,85,50,32,32,1,0,1,0
S01011999,621,66,13,53,131,64,140,74,68,63,8,0,8,7
S01012000,454,34,6,28,145,69,60,63,30,49,0,0,0,4
S01012001,635,63,27,36,123,58,106,92,63,121,4,1,3,5
S01012002,539,49,11,38,98,81,84,89,66,61,7,7,0,4
S01012003,533,28,7,21,143,62,69,59,49,108,15,4,11,0
S01012004,846,126,33,93,214,98,103,100,76,105,14,8,6,10
S01012005,877,154,39,115,266,111,102,78,82,72,8,5,3,4
S01012006,624,96,20,76,208,40,140,50,26,45,7,2,5,12
S01012007,790,102,21,81,218,75,122,90,117,54,7,6,1,5
S01012008,901,136,28,108,255,60,139,103,118,70,9,8,1,11
S01012009,642,91,17,74,131,30,121,77,83,85,19,13,6,5
S01012010,1079,181,34,147,297,78,172,150,93,95,10,8,2,3
S01012011,1068,91,13,78,230,71,156,136,234,112,21,8,13,17
S01012012,626,90,26,64,163,41,150,41,74,55,12,7,5,0
S01012013,738,104,33,71,130,46,205,85,94,66,8,4,4,0
S01012014,813,74,29,45,156,37,120,123,161,118,13,8,5,11
S01012015,980,101,40,61,212,89,169,142,133,95,22,11,11,17
S01012016,780,101,20,81,197,65,178,69,92,68,7,1,6,3
S01012017,495,87,13,74,121,15,152,40,40,29,11,9,2,0
S01012018,843,110,22,88,194,42,168,121,128,62,15,5,10,3
S01012019,846,138,14,124,303,105,84,63,68,59,20,7,13,6
S01012020,698,133,15,118,152,83,60,65,77,104,14,8,6,10
S01012021,565,138,29,109,133,52,65,44,69,49,15,9,6,0
S01012022,660,71,27,44,126,87,87,67,105,97,11,6,5,9
S01012023,531,133,38,95,140,39,132,43,14,16,7,2,5,7
S01012024,868,152,21,131,242,102,83,70,95,104,10,1,9,10
S01012025,687,66,9,57,156,95,76,101,100,87,2,0,2,4
S01012026,648,181,58,123,196,76,78,38,57,14,7,7,0,1
S01012027,823,161,39,122,220,104,129,68,66,57,9,3,6,9
S01012028,932,244,56,188,363,92,106,41,28,35,9,3,6,14
S01012029,967,153,54,99,240,85,172,110,99,88,12,12,0,8
S01012030,641,109,24,85,173,49,176,31,36,58,5,4,1,4
S01012031,553,156,30,126,200,50,75,24,25,17,6,4,2,0
S01012032,347,61,12,49,97,28,110,30,7,8,6,6,0,0
S01012033,800,95,18,77,241,116,54,77,75,107,32,13,19,3
S01012034,825,117,26,91,207,93,97,58,106,106,31,11,20,10
S01012035,919,165,35,130,277,92,94,84,105,72,16,9,7,14
S01012036,846,142,26,116,279,109,68,91,56,88,10,8,2,3
S01012037,989,38,12,26,143,152,43,115,185,221,68,21,47,24
S01012038,932,15,1,14,92,84,40,96,235,246,102,47,55,22
S01012039,956,24,11,13,121,111,79,163,174,221,51,32,19,12
S01012040,691,93,34,59,206,99,57,89,67,54,14,6,8,12
S01012041,914,59,18,41,200,104,61,107,167,148,39,6,33,29
S01012042,917,34,6,28,150,101,89,126,183,183,39,24,15,12
S01012043,926,47,14,33,133,103,50,98,191,216,76,51,25,12
S01012044,892,39,22,17,142,94,40,86,200,227,49,22,27,15
S01012045,1060,80,29,51,182,132,67,125,172,184,92,39,53,26
S01012046,686,21,1,20,88,80,30,96,157,133,66,42,24,15
S01012047,932,33,9,24,149,99,76,119,168,207,67,42,25,14
S01012048,740,42,6,36,96,112,33,103,158,133,51,37,14,12
S01012049,660,55,16,39,128,103,68,77,90,103,21,14,7,15
S01012050,1019,91,38,53,224,148,91,123,128,159,39,13,26,16
S01012051,497,61,4,57,139,90,42,32,45,58,20,10,10,10
S01012052,866,66,14,52,190,98,65,113,149,151,29,17,12,5
S01012053,903,36,4,32,149,108,39,171,180,166,41,21,20,13
S01012054,829,44,4,40,94,79,44,84,186,170,100,39,61,28
S01012055,877,33,6,27,148,108,62,108,168,206,32,10,22,12
S01012056,776,82,13,69,154,144,79,101,97,88,15,10,5,16
S01012057,743,127,33,94,236,126,66,73,46,52,14,4,10,3
S01012058,728,112,32,80,225,124,80,43,75,52,13,7,6,4
S01012059,870,43,10,33,113,121,70,99,186,183,43,18,25,12
S01012060,857,67,20,47,192,89,65,97,132,163,46,32,14,6
S01012061,963,182,61,121,301,100,76,96,87,79,29,11,18,13
S01012062,846,96,32,64,254,119,106,100,85,80,4,4,0,2
S01012063,547,42,5,37,128,69,45,76,112,57,9,7,2,9
S01012064,653,28,5,23,48,43,18,66,100,183,136,84,52,31
S01012065,624,11,4,7,30,33,10,49,140,191,137,105,32,23
S01012066,852,28,9,19,110,70,63,70,194,202,86,50,36,29
S01012067,534,7,0,7,57,30,16,47,144,124,97,56,41,12
S01012068,538,2,0,2,19,55,21,50,113,164,108,83,25,6
S01012069,479,17,8,9,66,53,24,31,122,102,52,27,25,12
S01012070,710,20,11,9,65,61,31,67,155,189,94,52,42,28
S01012071,1057,55,2,53,142,109,54,121,185,258,93,57,36,40
S01012072,1107,61,12,49,160,110,65,78,212,234,138,97,41,49
S01012073,695,78,12,66,215,70,47,68,103,58,35,16,19,21
S01012074,715,86,26,60,216,121,86,79,54,47,11,7,4,15
S01012075,724,140,44,96,215,89,86,90,44,54,1,1,0,5
S01012076,722,69,18,51,192,94,54,60,134,84,32,22,10,3
S01012077,751,41,4,37,129,76,23,63,185,166,43,20,23,25
S01012078,871,84,37,47,216,119,69,77,100,148,43,24,19,15
S01012079,917,47,18,29,115,129,76,104,186,214,41,20,21,5
S01012080,809,37,3,34,103,83,42,67,178,181,99,61,38,19
S01012081,737,18,1,17,106,77,38,78,156,164,83,44,39,17
S01012082,620,21,0,21,85,69,38,62,146,150,48,24,24,1
S01012083,690,21,7,14,106,103,29,77,145,166,40,8,32,3
S01012084,577,34,8,26,153,77,48,85,76,88,4,4,0,12
S01012085,677,94,25,69,146,89,48,77,105,103,9,5,4,6
S01012086,918,25,4,21,152,116,46,105,195,201,60,34,26,18
S01012087,720,39,16,23,149,112,35,73,118,156,29,12,17,9
S01012088,740,111,36,75,230,71,61,100,81,64,17,12,5,5
S01012089,842,117,27,90,305,139,69,82,62,52,15,13,2,1
S01012090,884,183,33,150,311,117,89,78,45,41,20,13,7,0
S01012091,537,57,21,36,145,80,41,55,85,63,8,6,2,3
S01012092,506,91,39,52,148,72,57,46,44,42,3,3,0,3
S01012093,535,79,19,60,143,90,50,59,52,52,7,5,2,3
S01012094,751,143,35,108,294,85,101,44,43,21,12,4,8,8
S01012095,1061,94,32,62,259,124,89,139,123,162,44,24,20,27
S01012096,871,27,8,19,168,78,62,103,190,186,37,21,16,20
S01012097,695,20,4,16,95,84,36,81,155,170,54,24,30,0
S01012098,628,22,12,10,111,70,31,64,119,157,42,21,21,12
S01012099,787,25,17,8,107,81,33,94,185,215,31,9,22,16
S01012100,1089,38,14,24,217,134,82,109,254,173,73,63,10,9
S01012101,785,149,20,129,236,83,53,99,104,48,7,6,1,6
S01012102,670,33,10,23,124,69,22,59,177,125,40,25,15,21
S01012103,925,65,15,50,213,156,73,105,155,130,22,1,21,6
S01012104,924,286,138,148,283,45,70,84,86,55,8,8,0,7
S01012105,1115,201,56,145,346,137,102,92,120,88,16,9,7,13
S01012106,1101,192,31,161,400,152,129,79,60,72,9,0,9,8
S01012107,646,144,29,115,241,63,94,33,32,17,17,6,11,5
S01012108,908,43,7,36,142,134,51,107,183,195,37,14,23,16
S01012109,922,47,6,41,175,116,50,106,164,129,94,48,46,41
S01012110,700,61,13,48,136,108,42,79,134,99,27,12,15,14
S01012111,558,29,12,17,74,77,35,51,106,107,57,28,29,22
S01012112,731,88,18,70,115,123,61,84,122,113,23,14,9,2
S01012113,990,99,28,71,200,178,93,98,137,151,18,3,15,16
S01012114,820,169,27,142,300,81,89,50,86,29,9,7,2,7
S01012115,517,23,10,13,86,81,21,72,108,101,15,12,3,10
S01012116,591,20,7,13,122,87,37,66,122,117,10,5,5,10
S01012117,807,121,49,72,284,113,70,102,57,51,0,0,0,9
S01012118,661,100,21,79,201,91,70,69,65,44,9,2,7,12
S01012119,900,111,21,90,279,106,100,93,92,98,9,4,5,12
S01012120,583,40,9,31,81,67,17,78,103,133,49,32,17,15
S01012121,903,35,6,29,163,113,47,127,186,148,69,42,27,15
S01012122,764,26,1,25,86,108,49,91,151,246,7,4,3,0
S01012123,510,54,11,43,103,69,50,61,77,76,15,5,10,5
S01012124,503,38,2,36,119,79,32,44,88,85,5,1,4,13
S01012125,782,21,7,14,140,78,33,79,164,148,77,28,49,42
S01012126,753,117,15,102,212,103,68,99,49,60,21,9,12,24
S01012127,849,58,14,44,121,116,56,68,143,112,94,56,38,81
S01012128,510,53,8,45,88,68,23,60,97,56,40,23,17,25
S01012129,669,45,10,35,137,98,32,74,110,97,62,41,21,14
S01012130,1002,70,18,52,190,136,55,84,158,218,65,43,22,26
S01012131,962,39,2,37,137,136,43,104,166,186,89,53,36,62
S01012132,684,39,6,33,104,70,45,42,130,112,57,38,19,85
S01012133,750,89,17,72,185,66,53,70,128,86,42,24,18,31
S01012134,1090,137,30,107,355,176,81,74,104,89,42,25,17,32
S01012135,878,31,10,21,85,120,33,84,227,175,79,51,28,44
S01012136,835,28,2,26,123,114,48,71,154,154,55,26,29,88
S01012137,671,16,4,12,167,103,25,70,112,86,48,25,23,44
S01012138,904,149,26,123,245,150,60,80,91,94,12,5,7,23
S01012139,940,119,29,90,178,150,70,95,150,144,26,16,10,8
S01012140,519,92,8,84,209,50,49,36,34,40,7,2,5,2
S01012141,1014,156,43,113,312,220,83,109,79,50,5,4,1,0
S01012142,952,162,58,104,314,142,119,88,70,47,3,2,1,7
S01012143,869,221,32,189,280,101,116,55,60,24,6,3,3,6
S01012144,1046,212,55,157,249,164,119,94,122,61,17,17,0,8
S01012145,1019,273,46,227,344,149,74,67,73,31,8,3,5,0
S01012146,979,31,1,30,138,103,42,91,242,235,48,29,19,49
S01012147,753,20,9,11,92,107,26,92,177,154,66,36,30,19
S01012148,756,28,14,14,92,94,16,87,168,152,107,73,34,12
S01012149,800,83,13,70,174,83,98,90,126,96,36,31,5,14
S01012150,778,18,3,15,104,103,36,104,184,152,61,31,30,16
S01012151,760,34,18,16,133,78,35,76,162,195,39,22,17,8
S01012152,744,29,5,24,83,96,40,88,159,149,95,49,46,5
S01012153,538,23,1,22,90,66,37,75,92,91,44,30,14,20
S01012154,777,37,3,34,91,95,28,115,146,164,66,43,23,35
S01012155,546,14,3,11,106,51,36,59,95,111,40,17,23,34
S01012156,605,11,5,6,96,53,28,62,120,160,62,41,21,13
S01012157,989,53,13,40,236,116,58,108,163,202,28,14,14,25
S01012158,1068,91,9,82,313,157,118,112,121,106,30,24,6,20
S01012159,503,54,13,41,110,79,41,93,61,62,3,1,2,0
S01012160,662,81,21,60,164,107,62,91,72,79,1,1,0,5
S01012161,457,15,4,11,92,27,16,36,121,119,28,19,9,3
S01012162,870,52,8,44,171,101,45,143,162,136,42,20,22,18
S01012163,761,70,5,65,139,107,43,78,126,120,59,31,28,19
S01012164,1098,130,38,92,360,151,94,144,101,102,16,15,1,0
S01012165,921,38,9,29,107,99,50,139,196,205,74,36,38,13
S01012166,604,8,3,5,101,75,44,102,120,121,22,11,11,11
S01012167,781,36,11,25,143,112,44,137,141,128,24,9,15,16
S01012168,848,74,26,48,242,160,62,110,98,89,8,8,0,5
S01012169,851,47,29,18,155,166,50,92,172,133,30,23,7,6
S01012170,975,53,11,42,156,163,62,149,193,169,26,19,7,4
S01012171,1000,52,11,41,167,146,29,117,244,211,21,18,3,13
S01012172,744,25,5,20,103,118,44,79,152,172,42,32,10,9
S01012173,647,88,24,64,193,99,59,64,67,71,6,6,0,0
S01012174,894,145,33,112,291,111,99,69,78,90,5,0,5,6
S01012175,818,119,18,101,230,130,47,89,111,75,10,9,1,7
S01012176,841,64,25,39,204,140,81,123,108,101,6,1,5,14
S01012177,617,103,19,84,137,90,72,87,60,63,4,1,3,1
S01012178,519,64,12,52,112,99,48,72,43,77,4,1,3,0
S01012179,604,48,11,37,138,85,46,78,77,76,41,33,8,15
S01012180,573,51,10,41,130,82,52,69,84,90,11,9,2,4
S01012181,757,69,22,47,196,101,72,70,117,102,29,16,13,1
S01012182,1049,171,40,131,317,132,94,157,103,48,11,6,5,16
S01012183,720,49,13,36,152,87,63,87,121,107,42,30,12,12
S01012184,502,102,14,88,133,72,42,31,47,50,6,0,6,19
S01012185,704,33,3,30,121,94,46,76,88,141,87,57,30,18
S01012186,694,58,34,24,136,89,37,77,113,133,43,21,22,8
S01012187,669,9,3,6,93,84,33,94,151,139,39,23,16,27
S01012188,523,52,22,30,133,105,28,49,74,73,4,2,2,5
S01012189,581,71,17,54,150,95,33,83,88,45,13,8,5,3
S01012190,556,107,22,85,164,81,38,49,62,46,1,1,0,8
S01012191,872,158,51,107,266,135,74,103,92,34,8,2,6,2
S01012192,505,85,27,58,170,54,69,48,36,31,8,4,4,4
S01012193,562,131,42,89,182,63,74,68,28,16,0,0,0,0
S01012194,561,125,18,107,199,98,29,48,28,25,7,1,6,2
S01012195,1118,143,30,113,347,196,75,133,102,95,24,18,6,3
S01012196,573,110,34,76,190,74,44,23,63,59,7,7,0,3
S01012197,726,52,9,43,153,124,56,81,131,109,14,8,6,6
S01012198,859,83,26,57,234,136,45,81,108,127,21,17,4,24
S01012199,730,57,19,38,121,116,45,107,139,120,11,6,5,14
S01012200,647,53,14,39,135,95,48,71,121,108,12,4,8,4
S01012201,770,48,11,37,190,103,37,120,135,107,18,4,14,12
S01012202,598,64,17,47,156,81,37,102,86,67,0,0,0,5
S01012203,772,109,45,64,247,117,94,71,72,46,8,6,2,8
S01012204,789,101,26,75,271,143,62,108,57,38,4,2,2,5
S01012205,675,116,31,85,198,90,89,65,63,41,7,6,1,6
S01012206,846,93,21,72,258,109,70,100,119,86,9,2,7,2
S01012207,926,46,19,27,187,134,62,120,199,137,21,17,4,20
S01012208,1057,46,5,41,242,157,84,143,177,163,28,10,18,17
S01012209,737,53,11,42,165,120,47,96,137,92,16,8,8,11
S01012210,790,40,12,28,154,150,50,130,120,118,15,14,1,13
S01012211,905,105,35,70,251,134,77,89,119,94,17,10,7,19
S01012212,762,151,42,109,290,119,31,74,64,30,3,0,3,0
S01012213,808,130,33,97,254,147,69,65,90,49,4,0,4,0
S01012214,681,130,35,95,264,112,55,40,53,22,3,1,2,2
S01012215,843,169,34,135,332,103,46,96,54,35,6,3,3,2
S01012216,709,191,46,145,199,96,90,46,43,32,9,6,3,3
S01012217,560,16,5,11,63,73,20,69,102,137,48,30,18,32
S01012218,487,10,0,10,77,24,18,63,114,111,51,25,26,19
S01012219,846,38,18,20,105,108,46,92,177,207,56,39,17,17
S01012220,629,7,0,7,68,70,38,82,134,163,64,33,31,3
S01012221,628,18,5,13,80,82,46,92,95,166,45,22,23,4
S01012222,789,16,9,7,115,107,34,117,148,197,33,23,10,22
S01012223,722,30,15,15,94,85,37,88,154,175,44,24,20,15
S01012224,767,49,12,37,120,105,44,110,135,148,35,28,7,21
S01012225,1070,42,9,33,166,116,59,139,222,266,52,38,14,8
S01012226,731,41,17,24,148,126,46,108,129,122,8,4,4,3
S01012227,669,34,10,24,131,111,31,89,117,127,23,8,15,6
S01012228,693,72,14,58,118,112,53,93,88,125,15,7,8,17
S01012229,684,119,28,91,202,110,61,77,34,60,10,3,7,11
S01012230,911,202,48,154,265,180,73,76,64,35,8,3,5,8
S01012231,831,225,59,166,285,80,97,51,45,38,6,2,4,4
S01012232,868,220,34,186,299,108,62,67,58,51,3,0,3,0
S01012233,953,249,68,181,349,113,66,59,59,46,8,5,3,4
S01012234,1082,294,82,212,375,96,117,64,60,70,3,2,1,3
S01012235,457,126,41,85,163,59,39,22,20,24,3,3,0,1
S01012236,610,95,28,67,151,101,37,75,62,74,9,6,3,6
S01012237,801,258,69,189,301,80,85,24,15,21,3,1,2,14
S01012238,604,89,26,63,154,62,52,70,63,90,18,10,8,6
S01012239,586,39,14,25,84,67,62,62,123,116,26,15,11,7
S01012240,842,117,18,99,199,75,67,109,115,121,31,13,18,8
S01012241,569,232,35,197,158,45,57,30,19,21,4,1,3,3
S01012242,800,240,37,203,282,80,82,51,23,26,3,2,1,13
S01012243,644,177,53,124,182,81,54,41,43,53,7,7,0,6
S01012244,911,327,61,266,280,44,160,29,40,23,6,1,5,2
S01012245,734,215,36,179,199,67,100,42,53,43,11,6,5,4
S01012246,813,260,54,206,275,54,99,35,54,31,5,0,5,0
S01012247,713,170,40,130,201,59,83,85,64,40,10,8,2,1
S01012248,818,188,43,145,183,57,197,60,64,38,22,15,7,9
S01012249,863,202,43,159,190,42,194,67,108,41,15,7,8,4
S01012250,671,118,39,79,187,59,159,35,59,43,5,1,4,6
S01012251,957,78,7,71,190,92,91,134,177,160,29,12,17,6
S01012252,713,69,17,52,151,72,100,70,113,107,26,6,20,5
S01012253,871,115,10,105,205,81,102,80,113,142,26,16,10,7
S01012254,858,108,19,89,259,68,100,95,114,90,19,13,6,5
S01012255,859,171,31,140,234,91,113,75,85,64,12,7,5,14
S01012256,867,180,50,130,276,109,85,50,73,70,17,2,15,7
S01012257,926,118,27,91,224,79,74,85,127,200,18,8,10,1
S01012258,759,253,34,219,300,65,61,26,23,21,9,6,3,1
S01012259,606,185,33,152,204,45,87,18,28,30,9,5,4,0
S01012260,857,164,43,121,199,64,130,75,104,104,17,7,10,0
S01012261,883,221,55,166,315,92,90,47,63,37,13,4,9,5
S01012262,792,171,43,128,189,67,192,53,72,33,14,3,11,1
S01012263,699,32,10,22,133,56,142,63,126,125,17,3,14,5
S01012264,472,102,19,83,129,40,57,25,62,54,3,0,3,0
S01012265,788,40,9,31,98,59,91,127,153,206,11,4,7,3
S01012266,1058,121,25,96,258,133,139,120,122,134,26,12,14,5
S01012267,682,151,33,118,197,55,109,55,60,52,3,1,2,0
S01012268,627,107,23,84,156,25,187,29,65,42,12,5,7,4
S01012269,999,125,27,98,236,111,149,104,120,135,19,12,7,0
S01012270,775,59,26,33,160,82,100,77,136,135,19,14,5,7
S01012271,1023,148,31,117,271,67,299,78,93,40,21,12,9,6
S01012272,718,156,35,121,228,88,77,44,79,33,10,2,8,3
S01012273,697,122,37,85,199,92,121,53,70,26,7,4,3,7
S01012274,916,97,19,78,229,106,110,91,124,120,25,16,9,14
S01012275,800,52,12,40,151,73,63,84,117,122,34,16,18,104
S01012276,915,105,30,75,248,84,92,99,133,111,26,16,10,17
S01012277,1045,65,20,45,230,127,127,112,144,173,41,13,28,26
S01012278,687,56,19,37,139,80,85,56,96,100,19,10,9,56
S01012279,774,42,12,30,174,90,43,117,127,115,33,24,9,33
S01012280,933,45,7,38,160,129,70,100,172,186,53,11,42,18
S01012281,704,28,18,10,150,80,66,88,152,110,15,13,2,15
S01012282,936,139,40,99,243,119,131,74,110,85,18,7,11,17
S01012283,848,139,58,81,221,88,115,58,75,111,25,2,23,16
S01012284,774,64,16,48,111,89,73,64,128,148,63,28,35,34
S01012285,537,64,16,48,173,64,58,47,63,57,9,8,1,2
S01012286,1049,64,16,48,160,77,85,121,179,236,46,16,30,81
S01012287,980,20,7,13,145,74,70,65,247,275,70,30,40,14
S01012288,769,27,9,18,78,73,65,69,158,210,63,24,39,26
S01012289,837,232,35,197,241,80,128,40,49,28,24,19,5,15
S01012290,585,71,15,56,137,62,78,39,81,96,16,12,4,5
S01012291,961,182,44,138,301,102,124,65,73,95,19,12,7,0
S01012292,717,196,42,154,217,57,124,30,57,22,12,12,0,2
S01012293,477,60,17,43,128,58,60,56,50,57,6,2,4,2
S01012294,870,58,22,36,214,142,80,81,131,135,23,14,9,6
S01012295,731,70,15,55,226,103,105,65,71,64,26,12,14,1
S01012296,888,172,41,131,303,68,127,96,72,40,2,2,0,8
S01012297,589,118,33,85,134,37,215,16,35,19,14,9,5,1
S01012298,810,137,23,114,223,71,160,57,78,71,13,8,5,0
S01012299,620,110,15,95,154,35,141,64,71,42,3,3,0,0
S01012300,648,41,17,24,130,40,117,73,121,98,18,11,7,10
S01012301,949,118,26,92,231,60,208,97,122,87,26,9,17,0
S01012302,556,77,17,60,131,21,123,62,82,49,11,2,9,0
S01012303,896,143,29,114,220,67,214,73,121,47,11,8,3,0
S01012304,983,118,23,95,227,70,217,68,130,131,15,5,10,7
S01012305,697,60,21,39,187,65,142,53,97,62,30,28,2,1
S01012306,594,39,26,13,106,26,78,72,138,108,25,14,11,2
S01012307,612,74,20,54,121,46,57,61,98,137,16,10,6,2
S01012308,842,56,21,35,164,79,118,103,147,171,2,2,0,2
S01012309,535,75,33,42,125,47,87,44,60,85,12,6,6,0
S01012310,879,103,18,85,213,54,256,48,108,82,11,5,6,4
S01012311,561,69,16,53,157,55,76,67,84,49,4,2,2,0
S01012312,997,89,12,77,222,85,270,82,138,85,16,12,4,10
S01012313,758,103,35,68,143,47,155,95,114,85,10,6,4,6
S01012314,851,43,15,28,110,51,117,102,192,205,31,16,15,0
S01012315,699,26,6,20,115,54,121,99,120,122,25,18,7,17
S01012316,612,22,13,9,89,37,75,93,129,144,20,7,13,3
S01012317,558,23,12,11,151,55,94,55,93,63,11,1,10,13
S01012318,792,20,11,9,134,34,97,120,161,197,27,23,4,2
S01012319,767,111,26,85,124,49,196,58,128,83,11,5,6,7
S01012320,687,29,17,12,112,33,104,78,170,126,35,23,12,0
S01012321,772,94,30,64,148,59,108,97,149,88,15,6,9,14
S01012322,985,132,40,92,253,91,248,67,87,85,22,13,9,0
S01012323,866,141,45,96,176,65,232,74,92,65,21,12,9,0
S01012324,789,105,44,61,160,48,201,78,101,85,11,7,4,0
S01012325,590,67,22,45,97,70,74,52,97,115,17,6,11,1
S01012326,540,23,6,17,85,55,82,81,107,71,35,10,25,1
S01012327,802,49,10,39,145,65,122,98,141,165,14,11,3,3
S01012328,544,78,23,55,133,57,79,41,71,74,11,3,8,0
S01012329,831,95,31,64,146,46,257,96,121,53,14,11,3,3
S01012330,582,79,34,45,141,54,93,59,73,73,1,1,0,9
S01012331,638,90,35,55,179,64,87,60,71,77,9,6,3,1
S01012332,988,122,23,99,229,63,260,126,116,58,13,4,9,1
S01012333,993,92,28,64,234,84,231,82,136,104,28,16,12,2
S01012334,816,38,14,24,142,70,108,118,160,155,25,11,14,0
S01012335,989,68,43,25,196,114,93,138,184,160,33,10,23,3
S01012336,603,12,4,8,92,51,79,91,108,152,14,11,3,4
S01012337,844,47,17,30,130,55,84,156,185,132,45,27,18,10
S01012338,695,69,13,56,183,43,111,68,120,76,19,9,10,6
S01012339,581,53,12,41,101,67,70,75,105,77,22,11,11,11
S01012340,1032,109,39,70,243,99,139,140,144,129,29,22,7,0
S01012341,941,132,38,94,191,61,321,51,101,73,11,4,7,0
S01012342,884,90,32,58,195,81,196,78,119,110,11,10,1,4
S01012343,977,104,33,71,252,54,262,76,125,74,27,11,16,3
S01012344,579,19,4,15,100,70,67,57,110,127,21,14,7,8
S01012345,700,61,17,44,155,47,124,111,65,112,6,5,1,19
S01012346,777,111,16,95,154,44,218,53,95,78,9,6,3,15
S01012347,774,113,43,70,167,97,112,67,87,111,20,6,14,0
S01012348,719,133,40,93,210,93,94,52,48,73,10,7,3,6
S01012349,899,36,13,23,119,56,90,131,178,260,25,12,13,4
S01012350,773,78,35,43,129,51,125,78,141,149,16,3,13,6
S01012351,850,45,15,30,119,64,105,129,177,180,20,10,10,11
S01012352,734,60,24,36,142,39,131,80,132,127,17,11,6,6
S01012353,744,58,14,44,124,88,112,85,109,126,29,18,11,13
S01012354,763,33,3,30,157,51,149,92,107,155,13,6,7,6
S01012355,849,117,42,75,166,39,286,56,107,76,1,1,0,1
S01012356,653,61,18,43,147,71,121,71,82,92,8,6,2,0
S01012357,812,112,28,84,204,46,295,43,71,34,6,2,4,1
S01012358,764,86,16,70,128,36,289,46,67,96,16,10,6,0
S01012359,785,21,13,8,75,55,71,97,144,250,61,38,23,11
S01012360,808,22,3,19,72,72,56,66,237,207,68,43,25,8
S01012361,641,13,6,7,71,27,70,86,141,174,52,9,43,7
S01012362,834,17,8,9,97,47,72,89,174,251,75,42,33,12
S01012363,962,36,12,24,137,95,119,117,149,206,61,37,24,42
S01012364,666,31,15,16,127,73,77,86,108,138,17,9,8,9
S01012365,923,74,34,40,190,108,130,121,106,179,13,9,4,2
S01012366,862,46,16,30,157,81,83,97,138,226,30,19,11,4
S01012367,916,80,29,51,185,84,101,109,117,217,16,6,10,7
S01012368,574,88,30,58,150,57,86,44,58,81,6,3,3,4
S01012369,872,100,51,49,202,66,152,96,104,133,17,8,9,2
S01012370,944,73,19,54,136,78,116,85,143,282,13,5,8,18
S01012371,881,41,17,24,138,81,68,104,149,262,33,21,12,5
S01012372,738,21,3,18,100,64,82,68,132,221,40,24,16,10
S01012373,981,83,28,55,199,94,115,98,116,234,36,20,16,6
S01012374,920,41,22,19,144,90,150,103,176,199,10,8,2,7
S01012375,928,36,12,24,129,82,74,110,140,318,37,11,26,2
S01012376,960,179,47,132,249,78,218,69,75,76,10,0,10,6
S01012377,690,146,41,105,166,49,154,38,63,53,9,7,2,12
S01012378,567,70,11,59,132,25,162,55,67,48,7,5,2,1
S01012379,520,57,24,33,146,41,102,57,63,40,5,1,4,9
S01012380,892,34,13,21,198,112,123,111,117,172,21,9,12,4
S01012381,844,52,20,32,144,84,105,76,168,189,19,10,9,7
S01012382,969,85,32,53,253,146,185,96,87,97,13,13,0,7
S01012383,825,70,16,54,172,70,95,107,112,173,18,13,5,8
S01012384,515,52,15,37,128,46,51,53,77,89,16,10,6,3
S01012385,689,73,13,60,203,84,107,64,88,50,11,6,5,9
S01012386,977,64,11,53,108,110,88,94,210,242,53,24,29,8
S01012387,930,53,21,32,230,96,139,171,131,94,11,2,9,5
S01012388,691,95,32,63,198,39,90,84,90,87,2,2,0,6
S01012389,882,93,43,50,248,74,109,103,124,119,10,5,5,2
S01012390,769,99,24,75,183,54,77,100,126,130,0,0,0,0
S01012391,1114,129,51,78,324,129,120,162,119,114,10,7,3,7
S01012392,791,81,29,52,216,84,61,108,123,106,10,7,3,2
S01012393,899,82,21,61,242,58,112,118,116,157,12,9,3,2
S01012394,638,36,5,31,127,60,41,85,124,133,22,8,14,10
S01012395,607,37,7,30,149,61,71,63,112,109,5,1,4,0
S01012396,638,27,10,17,142,58,66,109,105,114,16,14,2,1
S01012397,833,91,20,71,226,65,75,112,130,119,9,7,2,6
S01012398,849,91,18,73,195,96,60,99,126,165,14,11,3,3
S01012399,621,35,8,27,106,65,31,89,128,158,4,3,1,5
S01012400,587,15,9,6,92,40,77,104,101,142,11,4,7,5
S01012401,770,35,9,26,140,58,69,123,141,179,17,7,10,8
S01012402,460,31,7,24,107,32,90,65,62,63,5,0,5,5
S01012403,1025,93,29,64,233,103,179,132,130,144,7,7,0,4
S01012404,968,47,12,35,260,72,109,126,161,174,11,4,7,8
S01012405,726,100,39,61,201,60,101,110,65,81,5,5,0,3
S01012406,624,73,11,62,141,33,110,94,56,100,13,3,10,4
S01012407,813,95,8,87,162,62,151,105,93,120,22,15,7,3
S01012408,652,53,21,32,133,40,145,101,90,81,2,2,0,7
S01012409,688,57,22,35,151,27,125,65,106,142,13,11,2,2
S01012410,1037,101,27,74,280,72,98,185,169,121,8,1,7,3
S01012411,957,59,17,42,157,93,102,178,170,171,18,14,4,9
S01012412,643,44,4,40,114,48,106,114,119,91,7,1,6,0
S01012413,960,54,9,45,249,40,122,141,161,180,7,7,0,6
S01012414,684,40,10,30,133,38,126,101,117,107,15,13,2,7
S01012415,566,6,0,6,80,18,226,60,71,95,5,5,0,5
S01012416,559,18,4,14,113,12,168,62,87,93,6,4,2,0
S01012417,631,26,6,20,120,40,133,80,123,94,12,8,4,3
S01012418,768,45,18,27,132,59,246,86,107,68,17,10,7,8
S01012419,769,62,17,45,114,42,280,97,87,62,25,6,19,0
S01012420,850,42,20,22,111,57,86,121,204,193,31,18,13,5
S01012421,712,37,9,28,147,50,157,97,93,109,20,15,5,2
S01012422,863,100,34,66,169,54,178,92,128,103,28,9,19,11
S01012423,814,72,17,55,181,60,183,84,103,109,17,5,12,5
S01012424,950,45,10,35,86,88,72,181,216,203,48,24,24,11
S01012425,626,5,1,4,59,40,41,67,156,194,50,38,12,14
S01012426,493,1,1,0,39,50,48,97,110,106,33,15,18,9
S01012427,674,13,0,13,76,32,38,88,189,180,44,24,20,14
S01012428,662,31,10,21,85,77,73,80,144,153,15,12,3,4
S01012429,558,23,4,19,102,59,46,85,127,91,20,14,6,5
S01012430,551,36,14,22,111,53,66,81,103,77,23,22,1,1
S01012431,899,86,18,68,196,54,167,97,141,108,43,30,13,7
S01012432,712,40,9,31,162,71,78,60,122,141,22,14,8,16
S01012433,501,15,2,13,81,47,58,83,90,101,24,17,7,2
S01012434,709,27,5,22,115,74,50,100,147,144,43,16,27,9
S01012435,637,25,4,21,89,81,60,83,138,135,22,4,18,4
S01012436,748,32,14,18,94,73,67,113,169,133,56,22,34,11
S01012437,733,36,16,20,116,83,76,118,122,146,31,24,7,5
S01012438,693,32,8,24,159,62,93,112,96,112,25,7,18,2
S01012439,765,41,7,34,160,77,77,111,113,120,45,22,23,21
S01012440,524,52,12,40,146,50,85,82,45,58,3,1,2,3
S01012441,890,98,16,82,196,48,234,99,113,85,17,10,7,0
S01012442,964,137,40,97,284,76,190,53,126,63,25,17,8,10
S01012443,746,84,30,54,178,75,170,85,70,52,28,13,15,4
S01012444,686,111,24,87,257,66,108,56,51,28,8,6,2,1
S01012445,548,173,24,149,170,26,64,32,34,35,9,6,3,5
S01012446,491,27,12,15,89,63,42,55,89,108,16,10,6,2
S01012447,860,106,20,86,271,111,99,117,82,66,6,3,3,2
S01012448,925,113,26,87,299,134,121,105,71,40,29,12,17,13
S01012449,571,62,12,50,114,79,57,69,70,111,9,4,5,0
S01012450,830,106,15,91,237,56,168,65,81,79,32,27,5,6
S01012451,868,212,36,176,324,95,102,41,59,20,15,10,5,0
S01012452,589,74,17,57,214,92,53,49,71,26,4,4,0,6
S01012453,821,237,69,168,346,33,115,22,46,22,0,0,0,0
S01012454,662,124,29,95,251,100,68,32,57,21,9,7,2,0
S01012455,612,195,27,168,200,54,87,28,18,18,7,0,7,5
S01012456,751,242,81,161,288,48,84,56,17,5,11,8,3,0
S01012457,840,244,68,176,305,80,97,37,43,20,9,4,5,5
S01012458,813,236,56,180,296,66,119,29,37,13,11,4,7,6
S01012459,735,121,26,95,238,99,106,55,54,54,8,5,3,0
S01012460,546,81,13,68,216,81,56,46,31,29,2,2,0,4
S01012461,545,41,3,38,143,52,55,58,76,101,13,11,2,6
S01012462,757,15,1,14,158,63,51,101,157,158,41,25,16,13
S01012463,578,27,5,22,103,53,54,68,116,115,42,13,29,0
S01012464,625,24,5,19,110,58,44,74,116,124,52,22,30,23
S01012465,701,20,5,15,128,60,63,102,150,141,24,7,17,13
S01012466,782,56,15,41,255,88,113,60,73,78,40,33,7,19
S01012467,699,28,4,24,176,99,74,83,116,98,4,1,3,21
S01012468,757,48,11,37,191,91,69,130,115,87,23,1,22,3
S01012469,769,216,49,167,280,77,87,33,50,20,5,5,0,1
S01012470,962,86,23,63,241,96,76,113,163,133,48,34,14,6
S01012471,805,224,50,174,286,60,126,41,38,22,4,4,0,4
S01012472,719,118,23,95,286,102,75,48,57,27,6,6,0,0
S01012473,554,120,27,93,169,57,45,64,47,37,10,7,3,5
S01012474,714,85,14,71,215,80,66,82,85,78,18,13,5,5
S01012475,630,92,21,71,189,85,50,96,60,48,9,6,3,1
S01012476,941,29,5,24,198,142,86,153,163,128,29,19,10,13
S01012477,674,97,25,72,211,98,57,72,65,62,7,5,2,5
S01012478,840,35,11,24,177,136,66,97,177,136,12,9,3,4
S01012479,688,108,22,86,190,84,74,107,69,54,2,2,0,0
S01012480,515,61,19,42,139,57,45,53,51,72,14,7,7,23
S01012481,775,72,12,60,189,98,68,89,116,76,30,19,11,37
S01012482,762,115,25,90,195,124,109,47,79,45,39,22,17,9
S01012483,881,66,15,51,190,52,73,114,170,132,54,35,19,30
S01012484,780,235,70,165,269,43,90,50,45,22,19,13,6,7
S01012485,790,217,36,181,264,92,107,35,39,17,14,11,3,5
S01012486,532,123,34,89,207,46,64,18,44,15,8,8,0,7
S01012487,612,45,6,39,147,62,66,73,78,119,21,7,14,1
S01012488,903,62,15,47,191,120,74,97,170,123,54,36,18,12
S01012489,1023,32,5,27,130,72,62,135,203,248,111,70,41,30
S01012490,978,48,11,37,169,94,63,113,186,203,76,45,31,26
S01012491,440,4,1,3,25,35,27,38,108,136,57,27,30,10
S01012492,772,15,6,9,113,82,42,97,157,152,84,44,40,30
S01012493,651,62,9,53,153,63,46,58,107,138,18,13,5,6
S01012494,861,23,7,16,180,71,75,127,195,161,23,16,7,6
S01012495,1024,33,15,18,145,130,64,124,216,233,52,25,27,27
S01012496,765,37,14,23,78,74,47,112,187,162,48,29,19,20
S01012497,487,7,5,2,40,37,30,103,102,134,29,24,5,5
S01012498,857,14,7,7,83,38,29,124,204,249,98,59,39,18
S01012499,700,30,12,18,67,85,54,74,133,186,45,29,16,26
S01012500,468,4,0,4,54,57,39,59,97,111,39,28,11,8
S01012501,619,9,2,7,59,23,7,80,181,162,85,54,31,13
S01012502,832,8,0,8,85,50,69,76,190,211,115,75,40,28
S01012503,637,18,1,17,69,40,43,106,164,136,54,25,29,7
S01012504,636,19,7,12,93,38,37,91,156,136,58,11,47,8
S01012505,1014,41,26,15,152,127,101,129,187,197,73,39,34,7
S01012506,478,46,14,32,122,47,51,61,83,47,14,7,7,7
S01012507,946,52,10,42,189,138,96,97,181,145,42,23,19,6
S01012508,762,66,18,48,154,76,52,106,163,89,47,27,20,9
S01012509,541,48,4,44,145,68,91,65,60,51,13,10,3,0
S01012510,877,51,8,43,221,127,59,133,114,131,30,8,22,11
S01012511,628,47,7,40,163,96,40,75,126,68,7,6,1,6
S01012512,677,79,31,48,150,48,55,83,120,79,57,26,31,6
S01012513,550,84,27,57,164,81,46,52,83,32,7,5,2,1
S01012514,986,134,37,97,306,166,62,124,103,69,4,1,3,18
S01012515,612,30,12,18,97,67,65,67,140,118,20,10,10,8
S01012516,668,74,20,54,173,69,63,90,91,72,36,18,18,0
S01012517,860,77,19,58,209,90,77,107,155,100,29,19,10,16
S01012518,559,99,22,77,159,74,64,64,38,37,17,7,10,7
S01012519,516,41,12,29,101,78,85,74,57,61,14,6,8,5
S01012520,783,187,42,145,275,87,60,63,57,37,17,7,10,0
S01012521,515,68,10,58,157,75,59,42,53,41,17,12,5,3
S01012522,860,165,29,136,280,94,146,87,45,29,12,3,9,2
S01012523,864,133,18,115,261,143,75,93,59,83,13,5,8,4
S01012524,864,86,23,63,275,161,82,104,91,57,6,5,1,2
S01012525,714,89,23,66,238,100,61,89,70,54,8,2,6,5
S01012526,775,144,22,122,329,77,85,64,49,22,5,1,4,0
S01012527,625,76,14,62,182,72,81,67,80,55,11,8,3,1
S01012528,823,65,18,47,134,80,60,126,160,155,30,23,7,13
S01012529,712,75,21,54,182,76,60,98,95,100,16,11,5,10
S01012530,874,105,28,77,262,127,64,138,70,88,17,10,7,3
S01012531,754,136,35,101,166,97,81,86,65,95,16,13,3,12
S01012532,788,75,30,45,195,79,114,78,124,95,22,8,14,6
S01012533,532,55,20,35,155,63,49,68,72,43,16,9,7,11
S01012534,569,27,13,14,126,105,29,69,98,84,28,18,10,3
S01012535,818,33,10,23,146,77,83,132,157,174,7,4,3,9
S01012536,750,28,3,25,122,68,72,86,120,205,25,16,9,24
S01012537,727,25,8,17,93,40,66,111,148,181,32,13,19,31
S01012538,1081,68,35,33,181,130,103,158,207,181,40,18,22,13
S01012539,701,48,19,29,128,51,134,99,119,106,9,3,6,7
S01012540,717,31,6,25,76,57,68,110,156,172,41,14,27,6
S01012541,1066,100,18,82,198,83,251,113,169,122,19,7,12,11
S01012542,870,137,32,105,246,60,116,109,92,92,14,8,6,4
S01012543,686,127,14,113,182,66,146,51,57,48,7,1,6,2
S01012544,810,106,23,83,229,75,117,82,93,72,25,13,12,11
S01012545,473,28,14,14,95,39,52,61,79,96,20,3,17,3
S01012546,807,76,9,67,165,96,95,111,128,108,20,7,13,8
S01012547,746,139,30,109,197,87,88,66,78,44,38,26,12,9
S01012548,830,161,47,114,236,88,87,96,92,53,12,8,4,5
S01012549,545,30,4,26,110,65,30,58,106,116,30,15,15,0
S01012550,824,66,19,47,226,95,66,113,95,115,42,10,32,6
S01012551,815,107,22,85,297,123,81,91,59,43,13,5,8,1
S01012552,905,186,39,147,309,119,89,94,55,47,0,0,0,6
S01012553,839,155,18,137,274,134,69,77,83,40,7,4,3,0
S01012554,458,66,19,47,139,56,47,66,58,15,8,3,5,3
S01012555,541,84,20,64,197,73,44,66,45,21,4,2,2,7
S01012556,545,115,29,86,186,57,56,53,37,35,6,3,3,0
S01012557,636,141,31,110,208,67,51,55,48,49,14,14,0,3
S01012558,577,34,4,30,123,75,41,84,96,95,29,12,17,0
S01012559,767,40,18,22,154,96,54,128,138,120,29,12,17,8
S01012560,562,62,12,50,129,82,36,70,78,91,14,9,5,0
S01012561,757,75,17,58,220,84,65,99,104,79,24,14,10,7
S01012562,747,48,10,38,175,88,50,133,107,97,27,15,12,22
S01012563,630,183,54,129,232,59,77,24,34,8,6,6,0,7
S01012564,824,165,48,117,293,76,115,74,68,24,2,2,0,7
S01012565,779,181,33,148,237,91,85,52,71,56,4,4,0,2
S01012566,716,92,24,68,205,60,90,56,91,77,33,18,15,12
S01012567,1010,106,32,74,233,119,112,127,152,99,52,23,29,10
S01012568,617,153,39,114,225,47,94,30,33,18,15,9,6,2
S01012569,738,250,46,204,200,58,154,23,29,16,6,1,5,2
S01012570,454,59,6,53,83,24,91,77,54,49,15,7,8,2
S01012571,807,56,6,50,156,49,179,101,126,119,14,5,9,7
S01012572,514,54,12,42,97,27,115,38,83,73,16,4,12,11
S01012573,821,170,31,139,195,39,229,71,63,43,11,9,2,0
S01012574,886,145,47,98,275,75,160,84,57,77,3,0,3,10
S01012575,655,114,19,95,159,64,107,55,102,46,5,2,3,3
S01012576,751,141,28,113,222,57,124,67,58,68,7,3,4,7
S01012577,768,92,18,74,164,59,145,81,99,111,12,4,8,5
S01012578,936,130,34,96,268,53,162,88,96,114,22,14,8,3
S01012579,718,119,25,94,127,44,133,71,100,83,33,5,28,8
S01012580,753,147,40,107,187,43,164,61,59,71,21,9,12,0
S01012581,747,28,2,26,112,99,65,95,126,136,76,31,45,10
S01012582,919,128,36,92,260,83,184,69,101,70,14,10,4,10
S01012583,689,56,18,38,121,55,83,100,115,130,27,17,10,2
S01012584,737,76,10,66,196,74,118,72,69,96,23,20,3,13
S01012585,833,44,15,29,171,51,86,117,125,186,46,15,31,7
S01012586,808,103,24,79,237,45,147,100,62,93,13,8,5,8
S01012587,862,109,25,84,260,62,204,85,53,81,3,3,0,5
S01012588,637,103,31,72,131,69,122,54,62,85,7,2,5,4
S01012589,688,33,8,25,112,68,52,110,101,183,26,20,6,3
S01012590,777,58,11,47,121,66,47,95,143,193,52,34,18,2
S01012591,792,23,8,15,111,70,40,98,167,215,66,39,27,2
S01012592,568,112,27,85,192,77,88,33,28,24,14,4,10,0
S01012593,823,129,21,108,267,94,70,85,64,106,8,2,6,0
S01012594,470,36,12,24,121,56,35,56,60,91,12,7,5,3
S01012595,616,42,8,34,139,60,83,88,80,105,16,6,10,3
S01012596,788,46,18,28,147,91,55,77,111,209,43,21,22,9
S01012597,472,54,0,54,134,50,44,75,41,54,20,13,7,0
S01012598,661,117,27,90,200,87,63,73,64,45,11,6,5,1
S01012599,660,120,26,94,176,86,71,54,55,66,25,14,11,7
S01012600,692,90,33,57,227,132,50,55,73,55,9,8,1,1
S01012601,889,133,19,114,282,126,78,95,78,84,13,7,6,0
S01012602,558,48,7,41,114,62,34,70,65,126,35,25,10,4
S01012603,650,26,6,20,131,79,56,64,101,153,34,16,18,6
S01012604,664,54,18,36,146,50,37,67,104,166,38,19,19,2
S01012605,515,43,12,31,117,60,36,68,87,86,13,6,7,5
S01012606,782,180,32,148,324,85,50,58,49,30,6,2,4,0
S01012607,737,69,11,58,199,77,83,70,104,89,43,16,27,3
S01012608,801,40,7,33,157,75,57,103,124,217,23,12,11,5
S01012609,834,23,4,19,117,95,53,101,170,230,41,18,23,4
S01012610,920,63,21,42,150,92,73,119,154,183,81,57,24,5
S01012611,804,109,16,93,214,80,75,79,115,117,12,9,3,3
S01012612,756,47,15,32,151,97,70,89,96,147,51,28,23,8
S01012613,668,45,5,40,142,71,54,71,101,146,26,11,15,12
S01012614,1001,103,30,73,266,134,63,98,161,124,34,16,18,18
S01012615,674,157,39,118,189,57,90,42,56,66,14,7,7,3
S01012616,928,167,47,120,206,82,177,84,95,98,19,14,5,0
S01012617,384,51,18,33,112,36,82,45,17,32,5,5,0,4
S01012618,529,60,10,50,137,45,68,55,62,81,18,12,6,3
S01012619,513,45,8,37,93,67,61,46,71,81,42,30,12,7
S01012620,746,160,29,131,256,87,101,51,47,34,10,6,4,0
S01012621,563,96,26,70,169,70,69,34,57,55,13,4,9,0
S01012622,732,72,11,61,163,80,78,86,135,100,17,4,13,1
S01012623,649,47,10,37,112,61,55,78,145,124,27,18,9,0
S01012624,715,46,13,33,120,106,73,83,122,126,27,16,11,12
S01012625,524,21,3,18,118,59,54,77,75,95,25,23,2,0
S01012626,478,59,12,47,131,63,46,51,63,49,12,11,1,4
S01012627,524,78,20,58,100,69,50,49,65,75,36,16,20,2
S01012628,925,227,47,180,305,81,101,70,77,56,8,3,5,0
S01012629,470,108,40,68,159,66,59,38,21,16,3,2,1,0
S01012630,823,105,18,87,187,93,101,77,109,105,36,22,14,10
S01012631,931,58,13,45,234,76,54,102,150,191,59,36,23,7
S01012632,726,73,8,65,171,79,205,70,42,77,7,5,2,2
S01012633,679,114,28,86,168,26,170,69,83,29,20,12,8,0
S01012634,685,52,15,37,122,71,83,57,120,138,33,21,12,9
S01012635,1077,153,30,123,319,91,146,112,131,102,21,3,18,2
S01012636,613,61,13,48,172,33,140,42,89,66,8,5,3,2
S01012637,848,33,5,28,74,97,75,103,171,246,47,21,26,2
S01012638,865,61,25,36,137,66,78,106,168,201,40,22,18,8
S01012639,844,52,12,40,131,75,84,91,168,208,35,21,14,0
S01012640,942,21,4,17,121,69,116,98,155,241,106,49,57,15
S01012641,987,62,25,37,206,106,109,124,174,164,35,12,23,7
S01012642,804,16,4,12,58,45,50,118,180,247,85,47,38,5
S01012643,470,4,0,4,86,43,20,61,92,134,26,12,14,4
S01012644,708,38,5,33,130,65,52,86,153,132,52,40,12,0
S01012645,781,88,22,66,163,89,120,82,82,128,28,13,15,1
S01012646,972,114,26,88,258,95,151,122,101,103,21,15,6,7
S01012647,733,112,24,88,207,83,72,68,70,101,14,4,10,6
S01012648,554,17,4,13,78,29,37,44,151,161,29,16,13,8
S01012649,641,77,20,57,124,53,73,72,116,97,21,14,7,8
S01012650,587,75,21,54,130,71,103,51,63,87,7,5,2,0
S01012651,649,16,4,12,71,54,49,79,132,183,51,31,20,14
S01012652,1045,199,63,136,287,139,71,116,86,127,11,1,10,9
S01012653,885,48,9,39,170,67,120,80,148,182,65,36,29,5
S01012654,767,109,47,62,178,118,119,56,74,90,18,4,14,5
S01012655,1032,63,31,32,174,123,153,85,171,200,60,49,11,3
S01012656,821,30,0,30,139,78,75,119,111,206,56,37,19,7
S01012657,542,24,2,22,98,86,39,56,84,125,24,15,9,6
S01012658,938,112,26,86,266,133,99,121,111,82,8,6,2,6
S01012659,1066,173,35,138,413,111,97,110,65,72,13,0,13,12
S01012660,715,81,10,71,127,73,52,83,127,145,25,9,16,2
S01012661,739,93,26,67,151,100,99,100,76,92,23,13,10,5
S01012662,732,36,15,21,117,74,76,80,140,178,24,20,4,7
S01012663,691,78,17,61,184,97,80,67,69,99,16,5,11,1
S01012664,900,76,18,58,156,95,118,126,141,166,19,5,14,3
S01012665,717,10,4,6,90,65,73,92,153,164,59,37,22,11
S01012666,650,13,10,3,82,56,48,75,133,197,38,12,26,8
S01012667,580,24,4,20,73,57,74,68,116,109,52,18,34,7
S01012668,761,22,9,13,116,86,92,85,118,178,60,29,31,4
S01012669,722,82,26,56,219,122,47,78,75,99,0,0,0,0
S01012670,696,104,21,83,175,109,58,93,73,72,10,5,5,2
S01012671,898,23,2,21,125,85,78,151,179,221,35,11,24,1
S01012672,722,15,8,7,66,72,43,106,146,225,43,18,25,6
S01012673,582,11,0,11,53,58,37,69,158,156,33,8,25,7
S01012674,582,8,2,6,71,66,24,88,92,149,78,38,40,6
S01012675,766,18,2,16,96,79,47,77,175,213,47,24,23,14
S01012676,835,37,10,27,144,133,81,110,128,170,23,3,20,9
S01012677,583,22,9,13,95,70,53,81,91,142,29,21,8,0
S01012678,711,66,19,47,220,106,76,71,53,113,6,2,4,0
S01012679,791,66,13,53,162,76,92,101,127,147,17,9,8,3
S01012680,557,115,11,104,145,60,54,49,37,73,11,3,8,13
S01012681,705,44,9,35,168,66,148,68,65,116,30,9,21,0
S01012682,691,118,38,80,181,94,95,41,53,90,15,9,6,4
S01012683,749,70,14,56,128,85,67,104,144,114,30,15,15,7
S01012684,528,88,21,67,139,75,67,40,51,53,6,4,2,9
S01012685,779,54,14,40,158,77,69,99,133,144,33,12,21,12
S01012686,941,208,28,180,296,87,125,89,63,43,29,18,11,1
S01012687,538,176,32,144,190,55,59,26,20,7,2,2,0,3
S01012688,791,149,36,113,214,102,74,56,73,85,29,11,18,9
S01012689,481,136,40,96,147,23,68,46,27,34,0,0,0,0
S01012690,532,89,15,74,145,78,34,58,53,69,6,3,3,0
S01012691,766,238,55,183,277,45,97,43,39,15,9,7,2,3
S01012692,736,104,19,85,201,78,75,76,103,77,16,13,3,6
S01012693,905,304,62,242,302,80,96,46,50,24,3,1,2,0
S01012694,476,64,12,52,137,53,45,72,50,45,10,7,3,0
S01012695,830,116,18,98,193,80,197,53,67,101,19,13,6,4
S01012696,689,146,29,117,133,46,251,38,40,33,2,2,0,0
S01012697,509,117,26,91,136,35,113,24,25,48,7,4,3,4
S01012698,748,127,24,103,207,84,157,54,63,41,11,10,1,4
S01012699,1045,186,38,148,220,97,246,79,96,87,23,22,1,11
S01012700,818,127,40,87,213,74,145,89,71,84,9,6,3,6
S01012701,551,99,18,81,157,81,72,67,34,36,0,0,0,5
S01012702,588,127,27,100,154,50,70,64,39,72,11,3,8,1
S01012703,606,100,25,75,173,66,72,63,61,51,16,7,9,4
S01012704,772,28,13,15,94,90,72,108,147,167,58,31,27,8
S01012705,780,176,39,137,252,82,97,82,44,43,4,2,2,0
S01012706,687,31,10,21,90,56,54,83,151,183,32,16,16,7
S01012707,898,188,36,152,341,102,100,71,50,26,13,4,9,7
S01012708,723,32,3,29,126,96,56,72,122,171,48,12,36,0
S01012709,506,50,12,38,104,81,36,58,90,66,19,9,10,2
S01012710,697,56,23,33,145,70,68,68,119,137,34,23,11,0
S01012711,768,40,16,24,107,97,57,77,139,186,57,29,28,8
S01012712,857,173,30,143,306,109,93,68,65,21,17,7,10,5
S01012713,727,114,34,80,251,91,78,57,69,63,4,3,1,0
S01012714,598,134,32,102,206,82,44,49,45,27,8,8,0,3
S01012715,696,78,25,53,157,99,68,74,73,108,28,10,18,11
S01012716,802,240,51,189,228,69,122,46,43,25,14,7,7,15
S01012717,945,127,19,108,223,152,84,72,123,115,45,21,24,4
S01012718,942,158,42,116,280,104,98,86,91,101,19,10,9,5
S01012719,771,106,17,89,183,83,74,55,128,91,22,9,13,29
S01012720,506,87,11,76,130,49,49,43,60,50,21,7,14,17
S01012721,644,56,13,43,161,79,46,73,102,114,10,5,5,3
S01012722,742,29,6,23,95,99,33,88,160,180,48,27,21,10
S01012723,688,24,9,15,88,82,63,79,137,148,52,40,12,15
S01012724,728,61,11,50,169,97,87,74,124,96,14,8,6,6
S01012725,881,116,28,88,215,127,88,73,96,124,29,15,14,13
S01012726,641,44,7,37,109,81,78,72,122,103,27,6,21,5
S01012727,708,11,0,11,120,55,36,95,146,177,61,34,27,7
S01012728,814,19,6,13,95,73,44,77,200,199,92,47,45,15
S01012729,837,106,16,90,183,109,76,140,113,86,18,10,8,6
S01012730,556,18,8,10,75,59,27,55,131,167,21,10,11,3
S01012731,797,31,4,27,136,97,58,86,142,212,33,22,11,2
S01012732,678,51,16,35,92,93,45,84,138,138,34,19,15,3
S01012733,1087,218,59,159,369,155,137,85,56,46,7,3,4,14
S01012734,640,184,36,148,239,41,64,57,42,12,1,1,0,0
S01012735,476,21,5,16,73,60,22,78,84,113,22,3,19,3
S01012736,959,95,15,80,231,113,86,116,167,127,22,18,4,2
S01012737,800,86,12,74,185,120,87,91,87,113,17,11,6,14
S01012738,612,11,1,10,101,59,54,89,133,139,23,11,12,3
S01012739,841,204,38,166,283,105,118,57,22,39,7,6,1,6
S01012740,890,153,44,109,290,88,136,70,67,59,15,0,15,12
S01012741,555,95,22,73,177,84,55,41,56,43,1,1,0,3
S01012742,689,114,30,84,217,103,83,59,55,46,8,8,0,4
S01012743,581,85,19,66,188,89,53,76,40,50,0,0,0,0
S01012744,675,142,31,111,182,97,74,67,56,51,6,0,6,0
S01012745,704,120,36,84,198,104,81,65,65,55,12,12,0,4
S01012746,772,100,22,78,204,96,93,86,85,84,15,14,1,9
S01012747,831,68,7,61,156,103,65,93,166,119,49,26,23,12
S01012748,829,14,3,11,87,63,51,96,170,226,103,62,41,19
S01012749,876,9,6,3,117,91,67,106,184,188,103,60,43,11
S01012750,788,24,6,18,72,66,38,81,210,205,74,27,47,18
S01012751,817,42,13,29,126,83,62,137,155,160,41,21,20,11
S01012752,832,61,21,40,147,86,81,91,145,165,35,13,22,21
S01012753,496,24,14,10,69,42,37,54,90,139,38,18,20,3
S01012754,538,31,4,27,92,55,61,56,74,125,31,16,15,13
S01012755,499,20,6,14,77,55,18,45,139,96,44,31,13,5
S01012756,496,22,14,8,84,60,37,68,103,100,22,22,0,0
S01012757,461,14,8,6,56,39,47,56,94,132,18,8,10,5
S01012758,608,46,9,37,135,75,96,53,105,71,24,8,16,3
S01012759,722,22,0,22,90,77,49,88,155,177,51,31,20,13
S01012760,959,41,24,17,153,98,60,97,189,232,76,26,50,13
S01012761,754,47,16,31,112,86,76,92,129,168,41,16,25,3
S01012762,708,43,11,32,113,112,71,115,110,122,13,3,10,9
S01012763,402,21,11,10,71,37,27,33,105,93,13,10,3,2
S01012764,764,45,16,29,109,106,49,98,126,194,31,20,11,6
S01012765,717,44,9,35,157,69,71,88,126,136,22,16,6,4
S01012766,904,64,26,38,128,90,66,150,175,186,38,7,31,7
S01012767,568,49,13,36,140,95,65,71,72,70,6,0,6,0
S01012768,726,67,6,61,175,139,53,113,93,78,8,3,5,0
S01012769,442,93,16,77,157,39,70,34,20,25,4,1,3,0
S01012770,839,42,8,34,183,124,76,110,135,133,26,15,11,10
S01012771,705,84,18,66,151,61,56,62,120,121,43,20,23,7
S01012772,685,5,1,4,75,64,66,88,180,151,52,20,32,4
S01012773,853,68,13,55,139,115,79,96,132,177,39,26,13,8
S01012774,825,53,17,36,177,99,79,79,129,160,41,20,21,8
S01012775,409,28,3,25,78,54,58,49,71,46,24,16,8,1
S01012776,738,25,0,25,102,67,42,88,157,195,54,22,32,8
S01012777,969,82,20,62,273,131,99,161,107,79,26,20,6,11
S01012778,732,42,12,30,152,103,44,77,118,120,54,29,25,22
S01012779,458,21,6,15,85,49,35,55,76,95,34,20,14,8
S01012780,731,32,8,24,89,78,39,73,179,145,82,49,33,14
S01012781,648,47,9,38,177,69,82,75,100,74,14,5,9,10
S01012782,614,11,0,11,47,79,29,71,154,167,49,32,17,7
S01012783,698,10,3,7,98,68,38,88,150,176,62,30,32,8
S01012784,745,31,7,24,112,113,44,81,155,163,32,15,17,14
S01012785,711,7,3,4,73,62,42,93,192,165,73,37,36,4
S01012786,692,13,2,11,76,79,37,80,154,131,92,44,48,30
S01012787,550,55,21,34,163,73,31,37,74,79,15,6,9,23
S01012788,615,28,7,21,82,66,38,97,78,164,55,37,18,7
S01012789,740,96,12,84,128,107,90,96,90,105,22,10,12,6
S01012790,587,138,18,120,160,78,54,47,30,53,11,9,2,16
S01012791,720,144,28,116,243,122,54,45,65,37,5,3,2,5
S01012792,842,70,16,54,197,127,69,67,123,141,28,14,14,20
S01012793,635,24,9,15,117,77,41,55,136,129,38,24,14,18
S01012794,590,103,11,92,182,68,52,46,56,59,18,7,11,6
S01012795,1029,37,17,20,121,119,93,84,234,268,53,31,22,20
S01012796,787,50,6,44,165,113,68,73,141,126,40,19,21,11
S01012797,690,35,13,22,135,46,41,71,138,152,59,32,27,13
S01012798,720,236,68,168,187,54,113,30,42,40,9,5,4,9
S01012799,778,224,61,163,240,68,124,44,35,34,8,4,4,1
S01012800,894,260,38,222,299,74,119,33,54,30,15,8,7,10
S01012801,426,112,14,98,130,61,41,19,23,21,11,8,3,8
S01012802,612,242,61,181,162,53,94,39,10,10,1,1,0,1
S01012803,675,151,32,119,246,106,51,51,32,37,1,0,1,0
S01012804,764,73,2,71,171,102,66,83,145,88,26,16,10,10
S01012805,912,52,20,32,164,135,73,74,195,164,38,21,17,17
S01012806,715,85,21,64,211,100,55,56,88,98,19,5,14,3
S01012807,587,176,41,135,188,54,119,32,8,1,5,0,5,4
S01012808,1059,225,55,170,273,123,135,69,120,79,27,17,10,8
S01012809,612,115,23,92,173,64,65,47,55,57,22,10,12,14
S01012810,836,75,21,54,147,135,78,63,148,152,22,13,9,16
S01012811,770,99,13,86,191,110,55,95,104,83,22,14,8,11
S01012812,666,100,24,76,153,77,67,73,88,93,12,8,4,3
S01012813,884,268,54,214,291,106,84,69,36,25,1,1,0,4
S01012814,836,91,6,85,255,115,89,86,101,85,12,0,12,2
S01012815,875,141,30,111,234,120,102,95,103,63,10,0,10,7
S01012816,583,54,17,37,161,81,74,53,69,64,27,14,13,0
S01012817,563,131,22,109,138,122,64,31,26,40,11,3,8,0
S01012818,840,118,14,104,268,104,107,97,69,53,17,9,8,7
S01012819,735,37,6,31,85,82,37,91,180,161,59,47,12,3
S01012820,1027,139,31,108,270,157,157,108,109,71,10,2,8,6
S01012821,772,116,21,95,211,98,109,86,62,54,36,28,8,0
S01012822,474,18,2,16,52,54,20,55,119,109,36,12,24,11
S01012823,847,92,24,68,183,81,90,166,118,82,35,15,20,0
S01012824,664,45,9,36,171,79,66,61,110,105,16,10,6,11
S01012825,475,37,5,32,71,56,33,39,89,103,32,9,23,15
S01012826,599,18,3,15,85,65,43,45,138,146,40,24,16,19
S01012827,702,88,29,59,208,87,80,81,40,100,18,11,7,0
S01012828,583,70,17,53,214,74,55,50,68,38,7,5,2,7
S01012829,865,43,0,43,91,97,64,77,197,225,69,48,21,2
S01012830,690,38,14,24,120,76,80,103,104,126,42,24,18,1
S01012831,630,20,13,7,103,71,49,69,122,156,24,19,5,16
S01012832,544,46,14,32,90,68,68,59,95,85,31,19,12,2
S01012833,714,32,0,32,71,77,31,69,188,163,74,41,33,9
S01012834,616,50,5,45,102,70,60,56,119,98,51,26,25,10
S01012835,804,82,16,66,211,102,53,78,122,130,24,13,11,2
S01012836,673,110,8,102,182,80,127,76,55,39,1,1,0,3
S01012837,735,10,5,5,53,90,52,71,196,158,96,42,54,9
S01012838,917,34,5,29,97,82,58,93,236,188,117,42,75,12
S01012839,666,65,19,46,168,88,79,96,82,84,4,4,0,0
S01012840,786,143,41,102,247,111,114,52,70,40,7,5,2,2
S01012841,589,76,20,56,154,78,72,87,71,46,0,0,0,5
S01012842,475,64,8,56,139,56,39,56,61,52,4,2,2,4
S01012843,979,253,37,216,337,99,117,38,66,46,17,10,7,6
S01012844,697,228,49,179,231,56,90,24,36,23,7,7,0,2
S01012845,685,169,37,132,216,43,78,50,48,43,38,21,17,0
S01012846,926,41,4,37,127,132,53,89,182,220,63,44,19,19
S01012847,547,49,8,41,118,66,76,76,69,78,11,8,3,4
S01012848,773,129,22,107,231,78,103,72,68,71,17,6,11,4
S01012849,683,65,16,49,149,74,40,81,120,118,26,13,13,10
S01012850,710,17,0,17,116,93,48,74,141,195,21,11,10,5
S01012851,803,83,15,68,177,117,82,77,114,122,23,20,3,8
S01012852,696,128,28,100,219,120,71,57,48,29,2,1,1,22
S01012853,772,80,28,52,229,84,112,90,86,74,9,3,6,8
S01012854,797,139,18,121,260,125,70,60,83,49,6,4,2,5
S01012855,642,101,19,82,201,80,65,57,83,37,16,10,6,2
S01012856,667,21,6,15,124,123,40,47,117,143,37,28,9,15
S01012857,807,29,10,19,135,140,40,99,174,135,52,41,11,3
S01012858,689,36,10,26,100,120,35,70,144,130,40,28,12,14
S01012859,1014,47,7,40,184,137,89,99,171,199,40,25,15,48
S01012860,808,109,31,78,203,139,92,57,92,86,25,13,12,5
S01012861,687,85,19,66,169,96,118,47,88,66,12,5,7,6
S01012862,588,7,2,5,80,77,37,67,131,122,53,25,28,14
S01012863,621,25,3,22,106,84,18,60,101,133,81,34,47,13
S01012864,775,14,2,12,123,106,62,64,135,147,102,63,39,22
S01012865,779,68,9,59,140,130,76,72,133,114,38,28,10,8
S01012866,749,50,21,29,158,87,51,75,117,159,36,16,20,16
S01012867,720,5,3,2,75,80,39,102,150,224,39,29,10,6
S01012868,554,13,2,11,89,81,38,61,120,132,19,14,5,1
S01012869,546,11,2,9,30,47,24,74,128,147,72,33,39,13
S01012870,915,70,18,52,186,130,123,96,152,140,12,10,2,6
S01012871,815,53,14,39,211,148,96,75,119,80,29,17,12,4
S01012872,726,52,6,46,141,162,63,62,122,100,21,0,21,3
S01012873,801,57,14,43,166,194,55,79,100,115,24,17,7,11
S01012874,777,44,8,36,132,103,60,70,170,137,57,24,33,4
S01012875,573,25,1,24,110,81,50,62,72,110,40,15,25,23
S01012876,801,28,14,14,122,101,64,82,202,169,29,16,13,4
S01012877,726,10,3,7,98,141,55,101,133,164,24,7,17,0
S01012878,925,194,46,148,270,128,101,86,74,55,5,0,5,12
S01012879,729,141,15,126,194,112,79,51,71,55,19,8,11,7
S01012880,892,256,38,218,284,91,88,53,68,39,9,9,0,4
S01012881,832,165,36,129,244,115,94,58,82,53,19,11,8,2
S01012882,603,26,11,15,81,71,48,72,130,129,32,23,9,14
S01012883,634,27,6,21,79,70,39,49,142,164,61,26,35,3
S01012884,531,81,25,56,112,48,64,39,75,74,32,17,15,6
S01012885,446,2,1,1,39,61,31,35,112,112,47,27,20,7
S01012886,766,117,9,108,248,108,83,83,64,50,5,4,1,8
S01012887,734,161,39,122,206,133,56,51,64,47,15,10,5,1
S01012888,808,245,39,206,239,86,99,55,35,43,4,4,0,2
S01012889,875,116,29,87,254,85,112,96,107,89,12,12,0,4
S01012890,717,42,15,27,92,62,61,73,162,146,47,30,17,32
S01012891,548,26,4,22,70,57,66,58,124,121,17,10,7,9
S01012892,1107,52,11,41,120,146,72,120,238,264,90,35,55,5
S01012893,746,18,2,16,67,85,37,105,198,154,72,41,31,10
S01012894,814,135,26,109,260,81,89,58,80,80,21,17,4,10
S01012895,522,94,18,76,136,42,116,31,45,48,9,4,5,1
S01012896,840,53,12,41,182,137,64,93,160,111,33,19,14,7
S01012897,607,103,17,86,170,79,60,63,74,49,2,2,0,7
S01012898,567,135,27,108,185,66,76,53,32,17,3,1,2,0
S01012899,529,29,5,24,86,84,43,55,97,103,27,8,19,5
S01012900,573,103,11,92,155,66,87,55,41,54,8,5,3,4
S01012901,689,55,17,38,141,140,45,68,101,119,14,2,12,6
S01012902,748,67,20,47,190,111,40,92,112,108,19,4,15,9
S01012903,811,46,9,37,176,122,66,99,126,142,20,5,15,14
S01012904,816,37,3,34,153,165,65,91,149,109,31,18,13,16
S01012905,622,24,2,22,116,113,41,50,137,102,25,8,17,14
S01012906,900,79,14,65,266,134,62,108,122,98,16,7,9,15
S01012907,858,35,7,28,181,148,66,106,126,161,15,7,8,20
S01012908,699,36,13,23,120,126,48,88,121,118,32,12,20,10
S01012909,610,35,7,28,141,107,36,75,100,95,21,13,8,0
S01012910,834,40,11,29,164,138,77,94,140,136,30,10,20,15
S01012911,728,72,17,55,178,99,59,99,128,72,6,4,2,15
S01012912,673,43,21,22,133,125,68,64,95,121,21,14,7,3
S01012913,882,87,16,71,179,128,65,122,140,125,28,12,16,8
S01012914,848,109,13,96,203,105,56,118,125,86,30,15,15,16
S01012915,1055,147,47,100,286,129,100,137,110,100,35,10,25,11
S01012916,651,87,23,64,174,84,34,80,80,90,9,6,3,13
S01012917,717,134,14,120,238,85,81,63,72,31,3,3,0,10
S01012918,490,50,18,32,109,80,32,62,53,83,16,2,14,5
S01012919,455,31,12,19,110,83,30,69,82,38,9,1,8,3
S01012920,571,107,23,84,199,79,73,36,29,40,6,2,4,2
S01012921,705,52,22,30,155,120,29,79,121,116,24,4,20,9
S01012922,1011,104,23,81,271,155,81,82,153,143,16,5,11,6
S01012923,706,91,24,67,160,103,67,54,108,103,5,4,1,15
S01012924,500,79,27,52,98,90,61,50,57,46,16,7,9,3
S01012925,482,76,21,55,189,48,45,31,43,35,5,0,5,10
S01012926,697,75,22,53,160,104,73,77,95,80,26,6,20,7
S01012927,772,69,8,61,198,96,71,101,95,114,14,9,5,14
S01012928,810,104,23,81,232,114,101,79,68,87,16,7,9,9
S01012929,749,107,28,79,171,134,67,77,89,94,7,3,4,3
S01012930,823,108,13,95,214,133,60,65,108,108,20,7,13,7
S01012931,883,86,22,64,209,153,60,93,115,130,28,17,11,9
S01012932,512,101,31,70,132,52,96,44,36,38,4,4,0,9
S01012933,803,75,25,50,157,123,70,102,130,107,35,22,13,4
S01012934,708,51,5,46,164,110,58,101,103,91,28,13,15,2
S01012935,887,105,28,77,217,171,59,78,115,112,29,6,23,1
S01012936,726,77,20,57,165,78,84,106,101,77,32,23,9,6
S01012937,692,121,27,94,166,96,33,73,93,64,37,22,15,9
S01012938,691,193,34,159,217,80,62,50,35,47,3,1,2,4
S01012939,651,156,23,133,214,86,57,57,53,10,4,0,4,14
S01012940,698,132,19,113,219,122,95,51,45,23,4,4,0,7
S01012941,789,229,58,171,269,89,89,52,25,25,8,1,7,3
S01012942,788,47,5,42,110,121,33,109,186,136,31,10,21,15
S01012943,751,130,38,92,236,119,73,71,67,44,9,1,8,2
S01012944,525,113,20,93,220,80,34,33,22,19,1,0,1,3
S01012945,724,175,64,111,262,69,100,57,30,24,3,0,3,4
S01012946,861,139,26,113,307,135,92,79,47,50,2,2,0,10
S01012947,453,129,16,113,161,38,75,22,6,16,3,0,3,3
S01012948,681,117,39,78,202,90,117,41,42,63,5,5,0,4
S01012949,667,105,22,83,219,87,90,47,62,47,6,6,0,4
S01012950,865,244,72,172,310,85,88,45,45,40,7,1,6,1
S01012951,914,270,60,210,359,77,117,42,34,15,0,0,0,0
S01012952,640,205,49,156,184,18,165,24,16,21,4,4,0,3
S01012953,685,105,26,79,178,160,75,23,62,72,10,9,1,0
S01012954,485,45,2,43,135,103,54,46,47,51,4,0,4,0
S01012955,899,226,55,171,312,124,71,67,44,39,8,2,6,8
S01012956,926,95,10,85,172,158,65,110,132,148,28,18,10,18
S01012957,633,58,17,41,120,98,70,75,89,95,20,5,15,8
S01012958,502,43,10,33,124,72,66,41,91,57,3,3,0,5
S01012959,572,78,24,54,139,114,56,37,78,54,9,7,2,7
S01012960,602,75,7,68,167,94,56,45,77,75,13,7,6,0
S01012961,521,91,23,68,159,56,82,27,48,54,4,2,2,0
S01012962,649,119,12,107,192,99,81,61,57,36,2,2,0,2
S01012963,812,198,45,153,257,86,96,70,60,43,2,2,0,0
S01012964,644,131,37,94,191,82,111,77,12,38,0,0,0,2
S01012965,645,138,16,122,160,73,56,60,66,58,15,2,13,19
S01012966,690,63,15,48,212,79,70,70,95,88,5,5,0,8
S01012967,493,28,4,24,94,65,39,56,94,105,2,2,0,10
S01012968,660,32,3,29,149,88,60,50,120,137,13,7,6,11
S01012969,688,40,7,33,137,97,43,70,116,158,18,6,12,9
S01012970,579,33,8,25,130,82,49,76,97,95,17,9,8,0
S01012971,833,53,13,40,133,88,71,89,159,171,56,23,33,13
S01012972,797,40,12,28,123,102,71,114,126,190,27,16,11,4
S01012973,790,74,29,45,171,84,65,107,155,115,17,6,11,2
S01012974,919,68,11,57,188,100,75,92,195,164,29,9,20,8
S01012975,618,28,16,12,69,80,42,77,146,150,26,15,11,0
S01012976,522,37,9,28,99,89,37,36,113,88,14,9,5,9
S01012977,719,25,3,22,116,58,55,90,177,159,30,7,23,9
S01012978,808,43,11,32,120,127,74,113,127,162,21,15,6,21
S01012979,640,48,8,40,146,72,75,79,101,103,9,5,4,7
S01012980,668,49,10,39,114,101,37,86,110,110,43,13,30,18
S01012981,748,47,18,29,148,99,59,84,127,143,18,5,13,23
S01012982,820,33,8,25,176,136,46,117,123,155,13,5,8,21
S01012983,745,106,16,90,215,132,57,57,83,79,6,0,6,10
S01012984,628,47,11,36,184,102,42,91,76,63,18,8,10,5
S01012985,783,45,10,35,197,101,68,139,97,121,14,12,2,1
S01012986,746,39,10,29,168,115,40,74,116,150,28,12,16,16
S01012987,733,48,4,44,145,100,73,79,107,153,22,16,6,6
S01012988,883,60,18,42,189,98,69,112,155,152,29,16,13,19
S01012989,920,63,9,54,224,159,63,126,124,137,12,5,7,12
S01012990,602,46,15,31,110,119,41,49,90,127,13,7,6,7
S01012991,811,58,7,51,147,147,58,108,106,158,20,3,17,9
S01012992,786,58,12,46,180,120,42,85,148,122,22,13,9,9
S01012993,689,27,3,24,149,119,49,93,113,99,30,18,12,10
S01012994,871,61,11,50,156,144,72,110,163,126,27,11,16,12
S01012995,795,88,25,63,191,143,61,104,88,109,4,1,3,7
S01012996,651,23,0,23,185,92,58,99,103,62,19,3,16,10
S01012997,487,44,6,38,125,73,15,62,92,56,19,7,12,1
S01012998,1054,133,30,103,270,147,104,93,124,149,19,7,12,15
S01012999,479,37,12,25,86,61,38,79,67,98,9,1,8,4
S01013000,642,43,4,39,99,96,53,98,117,120,12,5,7,4
S01013001,381,116,39,77,84,14,97,29,22,12,2,1,1,5
S01013002,492,145,22,123,114,21,110,24,35,25,4,4,0,14
S01013003,641,283,47,236,196,34,66,25,21,12,3,3,0,1
S01013004,671,164,23,141,257,43,97,43,29,25,11,7,4,2
S01013005,711,185,36,149,238,46,120,44,42,21,8,5,3,7
S01013006,611,258,45,213,154,27,87,26,26,22,5,0,5,6
S01013007,910,264,58,206,312,63,116,66,55,21,11,4,7,2
S01013008,777,223,56,167,194,72,109,48,56,52,17,3,14,6
S01013009,634,82,11,71,213,77,106,40,67,44,2,1,1,3
S01013010,592,169,36,133,144,33,145,21,43,16,11,6,5,10
S01013011,705,156,27,129,218,54,132,40,63,35,6,1,5,1
S01013012,654,105,15,90,169,65,73,65,75,78,20,13,7,4
S01013013,731,158,47,111,208,72,118,31,79,54,8,5,3,3
S01013014,732,84,16,68,202,60,166,58,75,71,13,6,7,3
S01013015,760,154,36,118,204,60,178,60,44,46,8,3,5,6
S01013016,604,193,33,160,148,21,163,16,26,30,7,3,4,0
S01013017,846,190,54,136,206,73,104,79,98,71,24,10,14,1
S01013018,953,277,56,221,263,75,167,69,30,53,14,7,7,5
S01013019,898,268,56,212,294,99,131,35,38,18,4,2,2,11
S01013020,466,49,6,43,109,36,39,52,59,105,14,10,4,3
S01013021,464,36,1,35,104,56,50,50,81,79,4,4,0,4
S01013022,430,51,14,37,108,62,15,36,83,52,19,8,11,4
S01013023,854,229,60,169,359,60,73,37,55,31,8,5,3,2
S01013024,527,110,28,82,177,60,53,60,23,32,2,2,0,10
S01013025,498,84,28,56,128,23,161,31,30,36,5,2,3,0
S01013026,956,90,13,77,195,120,62,121,147,164,50,27,23,7
S01013027,1026,43,17,26,102,61,71,101,201,334,99,48,51,14
S01013028,457,53,19,34,76,21,79,63,64,83,8,6,2,10
S01013029,577,28,8,20,74,40,21,71,131,187,18,11,7,7
S01013030,627,16,0,16,74,53,55,99,109,164,46,26,20,11
S01013031,635,6,2,4,50,61,52,102,129,206,19,4,15,10
S01013032,810,78,17,61,198,86,95,98,107,125,7,6,1,16
S01013033,669,30,5,25,133,75,69,96,88,147,18,7,11,13
S01013034,717,25,8,17,77,50,38,134,169,186,34,24,10,4
S01013035,676,6,2,4,80,34,37,121,132,230,32,20,12,4
S01013036,770,7,0,7,79,66,57,98,183,242,31,15,16,7
S01013037,714,81,28,53,215,93,68,91,79,64,17,10,7,6
S01013038,970,56,12,44,164,115,79,156,170,187,34,28,6,9
S01013039,527,115,27,88,161,64,41,55,45,33,4,4,0,9
S01013040,628,51,1,50,125,95,54,89,122,72,19,10,9,1
S01013041,587,55,16,39,145,90,58,69,58,92,14,9,5,6
S01013042,795,66,21,45,181,78,114,89,87,151,20,15,5,9
S01013043,704,21,9,12,99,73,56,84,132,177,59,30,29,3
S01013044,827,24,6,18,131,87,48,100,183,202,35,14,21,17
S01013045,713,62,7,55,137,87,71,104,112,107,17,10,7,16
S01013046,499,16,9,7,71,67,37,55,126,109,16,15,1,2
S01013047,931,152,44,108,306,108,78,94,100,86,3,3,0,4
S01013048,791,80,24,56,240,134,38,88,95,85,10,3,7,21
S01013049,803,135,14,121,265,106,57,81,100,41,13,7,6,5
S01013050,709,51,7,44,134,122,62,80,109,109,40,21,19,2
S01013051,931,53,10,43,140,133,88,99,147,209,54,29,25,8
S01013052,738,56,10,46,104,87,59,91,153,141,39,30,9,8
S01013053,615,32,8,24,64,81,50,77,122,142,41,29,12,6
S01013054,658,68,16,52,170,62,63,75,97,92,28,21,7,3
S01013055,688,34,8,26,125,63,70,80,129,148,29,16,13,10
S01013056,904,42,6,36,135,105,91,115,130,232,43,39,4,11
S01013057,870,37,8,29,102,85,65,108,175,196,88,41,47,14
S01013058,625,117,38,79,188,81,53,38,67,47,20,10,10,14
S01013059,779,184,42,142,216,102,72,40,51,67,31,17,14,16
S01013060,491,156,36,120,156,63,29,33,14,14,20,11,9,6
S01013061,794,203,47,156,304,93,56,42,49,23,1,1,0,23
S01013062,824,248,43,205,265,69,109,44,25,16,12,10,2,36
S01013063,805,333,47,286,233,55,75,14,23,20,13,7,6,39
S01013064,866,52,12,40,160,100,81,101,147,190,21,14,7,14
S01013065,864,51,21,30,152,117,65,95,137,162,44,29,15,41
S01013066,690,73,20,53,176,72,81,60,82,88,30,11,19,28
S01013067,808,62,4,58,137,32,27,59,64,52,30,15,15,345
S01013068,776,58,6,52,99,65,54,61,112,116,67,34,33,144
S01013069,733,57,19,38,91,47,30,48,73,68,39,21,18,280
S01013070,560,27,5,22,61,49,43,44,77,63,40,29,11,156
S01013071,750,33,8,25,105,41,25,50,60,78,24,17,7,334
S01013072,517,15,7,8,50,28,29,70,116,160,41,21,20,8
S01013073,747,23,5,18,154,59,25,54,154,143,66,38,28,69
S01013074,711,20,0,20,50,28,74,93,152,179,91,53,38,24
S01013075,866,37,6,31,101,44,55,69,166,257,93,58,35,44
S01013076,467,84,17,67,128,44,66,33,23,27,10,8,2,52
S01013077,717,35,10,25,88,77,29,80,139,171,74,34,40,24
S01013078,572,14,1,13,75,49,25,84,119,142,52,28,24,12
S01013079,1052,245,19,226,324,96,88,63,105,67,21,2,19,43
S01013080,856,199,55,144,229,66,86,68,52,49,9,8,1,98
S01013081,643,172,18,154,172,73,66,37,65,37,7,7,0,14
S01013082,830,109,23,86,262,127,80,71,93,68,6,4,2,14
S01013083,469,121,24,97,172,52,48,24,20,23,0,0,0,9
S01013084,759,204,49,155,250,95,67,45,46,40,4,4,0,8
S01013085,527,76,29,47,102,62,58,46,71,78,29,24,5,5
S01013086,854,231,22,209,189,69,74,52,69,46,33,18,15,91
S01013087,771,297,80,217,227,45,94,15,18,11,22,6,16,42
S01013088,927,327,66,261,332,65,117,30,26,11,3,0,3,16
S01013089,749,102,18,84,182,79,70,60,85,108,22,13,9,41
S01013090,789,141,19,122,192,56,74,57,65,28,17,13,4,159
S01013091,461,58,7,51,113,42,18,26,26,42,11,10,1,125
S01013092,893,153,22,131,230,99,56,71,81,101,37,25,12,65
S01013093,470,124,45,79,141,32,90,37,18,21,1,1,0,6
S01013094,602,199,32,167,265,49,35,24,21,9,0,0,0,0
S01013095,889,439,136,303,279,46,71,23,19,7,0,0,0,5
S01013096,469,57,21,36,136,43,41,37,84,61,8,3,5,2
S01013097,620,179,35,144,219,17,92,39,22,39,6,3,3,7
S01013098,708,335,99,236,256,19,58,11,17,12,0,0,0,0
S01013099,854,216,32,184,291,54,93,59,63,53,12,7,5,13
S01013100,620,219,67,152,270,33,44,21,13,6,5,5,0,9
S01013101,993,126,28,98,208,111,83,116,160,125,49,28,21,15
S01013102,603,152,36,116,248,62,21,34,55,18,8,6,2,5
S01013103,863,228,63,165,372,76,74,64,34,9,6,2,4,0
S01013104,984,270,61,209,365,102,110,50,50,29,8,2,6,0
S01013105,889,276,64,212,336,73,83,29,45,36,5,4,1,6
S01013106,811,101,16,85,198,73,142,89,82,100,18,10,8,8
S01013107,661,167,39,128,217,61,109,27,33,38,3,3,0,6
S01013108,596,90,20,70,152,42,85,48,84,87,2,0,2,6
S01013109,1037,220,47,173,218,79,273,73,99,54,13,5,8,8
S01013110,597,96,15,81,173,30,168,30,49,40,10,6,4,1
S01013111,447,71,10,61,163,38,96,24,37,12,1,1,0,5
S01013112,648,97,24,73,150,69,85,72,80,74,14,5,9,7
S01013113,812,49,24,25,159,58,123,104,162,135,16,9,7,6
S01013114,776,134,29,105,199,76,167,50,81,51,13,7,6,5
S01013115,563,58,9,49,121,60,109,50,101,47,14,7,7,3
S01013116,717,146,39,107,279,62,116,27,58,23,3,3,0,3
S01013117,602,48,7,41,159,54,74,105,87,59,3,3,0,13
S01013118,444,100,24,76,144,27,80,31,26,34,2,2,0,0
S01013119,744,125,33,92,200,33,198,44,67,66,9,4,5,2
S01013120,909,104,23,81,178,49,221,105,133,93,16,6,10,10
S01013121,340,20,5,15,49,19,99,42,55,38,18,10,8,0
S01013122,598,7,3,4,72,77,17,43,154,135,81,47,34,12
S01013123,767,33,10,23,154,121,24,78,158,114,66,29,37,19
S01013124,719,28,17,11,142,121,32,77,166,128,23,14,9,2
S01013125,762,64,32,32,154,114,80,54,132,115,44,34,10,5
S01013126,743,25,3,22,81,99,35,67,196,139,78,40,38,23
S01013127,853,15,3,12,101,107,34,73,203,205,98,56,42,17
S01013128,624,24,10,14,114,105,11,68,116,122,49,21,28,15
S01013129,1100,57,22,35,253,188,48,133,177,160,72,47,25,12
S01013130,710,29,6,23,128,91,46,54,152,111,94,47,47,5
S01013131,653,45,13,32,100,80,30,72,137,142,29,7,22,18
S01013132,587,17,0,17,99,81,38,55,146,103,36,14,22,12
S01013133,756,40,7,33,145,107,33,75,154,121,67,29,38,14
S01013134,840,95,31,64,196,100,82,77,115,128,39,26,13,8
S01013135,771,21,2,19,95,105,55,65,172,180,62,41,21,16
S01013136,928,24,12,12,176,122,50,105,170,213,53,40,13,15
S01013137,745,9,4,5,99,103,70,89,153,204,18,9,9,0
S01013138,704,13,3,10,104,83,31,76,181,127,67,32,35,22
S01013139,878,28,19,9,117,128,51,89,203,189,61,40,21,12
S01013140,816,34,9,25,121,113,54,97,161,166,55,49,6,15
S01013141,647,16,12,4,97,99,44,55,125,150,54,41,13,7
S01013142,863,16,8,8,118,137,40,108,184,183,56,36,20,21
S01013143,853,38,6,32,170,125,46,87,172,169,34,20,14,12
S01013144,894,39,15,24,172,113,60,114,188,165,30,20,10,13
S01013145,704,51,14,37,137,91,51,111,125,113,21,16,5,4
S01013146,455,22,5,17,62,66,55,47,92,104,7,7,0,0
S01013147,726,60,13,47,123,113,86,81,129,109,14,12,2,11
S01013148,757,55,20,35,172,136,72,82,107,94,35,22,13,4
S01013149,824,64,18,46,191,143,46,83,117,129,33,26,7,18
S01013150,846,42,10,32,136,167,46,98,148,161,21,15,6,27
S01013151,566,70,19,51,150,90,64,59,50,65,13,7,6,5
S01013152,910,97,20,77,179,127,83,93,136,159,36,24,12,0
S01013153,890,35,15,20,120,121,53,89,214,174,69,53,16,15
S01013154,979,33,12,21,149,156,58,128,183,193,56,22,34,23
S01013155,908,28,7,21,88,101,54,63,289,159,103,49,54,23
S01013156,865,17,4,13,104,95,29,118,207,191,98,48,50,6
S01013157,983,32,4,28,104,113,34,146,218,182,126,60,66,28
S01013158,555,64,14,50,177,85,72,55,57,34,11,3,8,0
S01013159,701,64,25,39,192,104,92,52,102,87,1,1,0,7
S01013160,728,122,32,90,210,114,104,52,66,45,10,3,7,5
S01013161,1021,54,2,52,203,174,87,121,159,178,39,24,15,6
S01013162,815,41,11,30,132,111,54,92,167,167,44,22,22,7
S01013163,702,66,18,48,155,115,66,130,71,89,7,2,5,3
S01013164,1064,125,21,104,242,142,106,110,108,176,40,24,16,15
S01013165,883,97,16,81,203,137,84,108,104,125,21,14,7,4
S01013166,642,18,8,10,65,97,37,64,135,137,66,31,35,23
S01013167,655,13,4,9,67,82,39,54,138,141,105,34,71,16
S01013168,891,14,0,14,109,141,54,147,179,167,66,28,38,14
S01013169,853,20,4,16,154,120,56,117,171,169,44,36,8,2
S01013170,528,6,0,6,74,85,27,65,86,107,74,44,30,4
S01013171,679,98,20,78,181,101,62,60,57,91,29,13,16,0
S01013172,749,62,23,39,142,129,50,83,149,106,23,8,15,5
S01013173,799,78,30,48,185,120,66,71,131,121,22,10,12,5
S01013174,793,144,39,105,254,87,63,117,71,51,0,0,0,6
S01013175,867,132,15,117,252,124,63,104,89,81,13,7,6,9
S01013176,745,89,18,71,177,151,53,84,81,90,16,10,6,4
S01013177,617,57,17,40,179,100,39,62,66,98,6,5,1,10
S01013178,719,83,24,59,164,126,64,75,84,102,9,6,3,12
S01013179,781,56,19,37,203,114,85,78,135,86,16,12,4,8
S01013180,434,39,6,33,158,61,36,62,32,40,4,2,2,2
S01013181,718,43,13,30,169,104,39,145,95,109,11,9,2,3
S01013182,743,46,10,36,129,110,46,58,166,158,30,14,16,0
S01013183,834,111,21,90,264,120,56,107,95,73,6,0,6,2
S01013184,572,9,0,9,57,70,18,53,169,104,78,46,32,14
S01013185,810,28,9,19,176,109,40,103,164,147,39,9,30,4
S01013186,673,9,9,0,85,75,32,93,195,122,60,15,45,2
S01013187,825,44,6,38,148,105,48,91,174,137,65,28,37,13
S01013188,885,85,22,63,199,132,53,93,151,151,17,7,10,4
S01013189,618,68,14,54,181,61,65,67,81,82,13,4,9,0
S01013190,805,67,10,57,206,98,58,77,128,141,25,16,9,5
S01013191,1055,177,37,140,362,139,70,119,100,79,9,5,4,0
S01013192,895,98,12,86,231,170,57,89,156,75,11,6,5,8
S01013193,649,55,19,36,150,121,44,67,100,93,11,8,3,8
S01013194,568,60,12,48,126,80,38,66,105,70,14,5,9,9
S01013195,977,69,3,66,231,164,49,92,173,153,23,14,9,23
S01013196,626,50,21,29,188,94,54,73,75,69,9,6,3,14
S01013197,555,73,24,49,157,79,33,59,74,54,18,11,7,8
S01013198,768,61,19,42,151,91,86,74,128,133,44,29,15,0
S01013199,897,117,22,95,226,114,103,71,148,93,21,12,9,4
S01013200,695,49,12,37,182,73,47,52,131,96,62,53,9,3
S01013201,741,37,6,31,68,73,38,51,201,173,92,53,39,8
S01013202,552,23,8,15,84,66,24,46,109,117,73,32,41,10
S01013203,717,39,5,34,121,61,39,105,155,134,57,34,23,6
S01013204,793,73,13,60,226,118,18,118,122,95,16,8,8,7
S01013205,629,13,4,9,49,51,50,76,143,146,97,72,25,4
S01013206,627,21,6,15,93,73,32,50,145,156,52,17,35,5
S01013207,766,43,12,31,136,113,83,68,150,128,32,24,8,13
S01013208,919,45,12,33,173,72,60,103,188,171,89,66,23,18
S01013209,819,28,3,25,184,108,83,93,130,153,36,22,14,4
S01013210,588,83,24,59,115,107,86,67,59,50,17,11,6,4
S01013211,859,74,24,50,139,141,53,124,153,141,30,18,12,4
S01013212,590,83,23,60,155,104,62,78,69,38,0,0,0,1
S01013213,555,81,18,63,142,83,76,70,66,34,3,0,3,0
S01013214,438,24,3,21,136,70,53,66,44,45,0,0,0,0
S01013215,762,32,9,23,156,117,61,112,132,126,18,2,16,8
S01013216,579,21,7,14,76,77,28,74,128,118,38,20,18,19
S01013217,676,44,5,39,98,101,45,71,152,128,31,12,19,6
S01013218,609,7,5,2,77,49,22,62,149,162,68,41,27,13
S01013219,527,19,0,19,83,46,28,59,140,115,22,9,13,15
S01013220,696,18,2,16,81,77,37,73,196,143,62,27,35,9
S01013221,907,61,18,43,122,96,97,126,201,147,44,28,16,13
S01013222,595,24,7,17,66,64,40,62,147,133,45,35,10,14
S01013223,1113,59,11,48,217,156,81,123,182,194,88,52,36,13
S01013224,814,56,19,37,138,110,61,86,176,132,48,23,25,7
S01013225,812,32,6,26,134,77,34,123,182,182,35,23,12,13
S01013226,512,39,14,25,161,55,35,71,97,45,5,4,1,4
S01013227,703,21,3,18,124,72,30,133,144,120,41,27,14,18
S01013228,693,45,18,27,118,79,62,66,160,109,48,14,34,6
S01013229,772,35,5,30,117,129,36,120,135,149,46,22,24,5
S01013230,654,19,4,15,120,92,18,114,112,168,11,10,1,0
S01013231,732,29,6,23,145,98,39,88,171,132,25,17,8,5
S01013232,691,42,22,20,117,101,50,71,140,153,17,13,4,0
S01013233,579,40,12,28,129,90,56,78,107,68,5,0,5,6
S01013234,383,42,11,31,176,51,57,32,13,9,3,1,2,0
S01013235,751,59,10,49,155,90,73,104,151,105,12,11,1,2
S01013236,864,99,24,75,246,93,128,124,74,78,12,11,1,10
S01013237,813,77,30,47,210,129,73,73,122,77,23,17,6,29
S01013238,767,17,1,16,105,81,45,87,190,158,69,43,26,15
S01013239,885,21,0,21,151,61,36,131,200,195,81,51,30,9
S01013240,534,15,13,2,76,42,22,67,112,118,66,36,30,16
S01013241,809,114,35,79,290,139,65,83,57,51,9,8,1,1
S01013242,590,78,12,66,135,43,185,57,45,34,5,5,0,8
S01013243,735,47,10,37,94,78,43,77,159,202,33,22,11,2
S01013244,752,21,0,21,109,91,66,76,137,192,58,24,34,2
S01013245,1009,114,34,80,182,99,154,130,130,176,21,9,12,3
S01013246,467,48,13,35,83,39,59,41,77,105,10,8,2,5
S01013247,741,22,3,19,86,78,60,64,196,192,37,24,13,6
S01013248,629,18,5,13,69,91,41,41,152,179,34,4,30,4
S01013249,460,12,0,12,79,54,34,49,83,117,28,14,14,4
S01013250,864,115,17,98,202,61,188,67,86,107,27,17,10,11
S01013251,780,29,12,17,120,88,29,74,149,207,68,29,39,16
S01013252,680,43,18,25,131,56,66,76,83,180,27,13,14,18
S01013253,708,60,12,48,127,70,58,82,127,155,26,8,18,3
S01013254,633,26,8,18,74,59,47,79,95,214,30,21,9,9
S01013255,840,53,22,31,149,88,91,127,153,154,18,9,9,7
S01013256,710,100,28,72,172,70,91,74,115,76,10,3,7,2
S01013257,803,49,17,32,173,87,98,84,129,151,17,6,11,15
S01013258,759,122,40,82,210,98,80,80,84,67,10,4,6,8
S01013259,841,49,9,40,168,123,60,107,134,177,17,7,10,6
S01013260,887,39,15,24,93,113,43,95,191,230,67,40,27,16
S01013261,812,28,4,24,75,84,56,116,174,218,45,19,26,16
S01013262,642,44,14,30,80,72,71,87,124,141,19,8,11,4
S01013263,557,176,31,145,189,47,55,33,29,15,9,0,9,4
S01013264,524,137,26,111,205,72,36,40,11,20,3,3,0,0
S01013265,675,202,32,170,223,85,87,20,18,36,0,0,0,4
S01013266,566,165,33,132,139,89,45,45,56,25,0,0,0,2
S01013267,544,53,17,36,121,94,38,30,114,52,30,21,9,12
S01013268,839,66,11,55,199,110,71,101,129,137,18,2,16,8
S01013269,949,190,41,149,344,132,78,64,55,75,2,0,2,9
S01013270,829,291,76,215,291,92,88,39,11,17,0,0,0,0
S01013271,597,219,56,163,198,78,31,33,17,17,1,1,0,3
S01013272,777,212,53,159,327,81,62,24,25,35,11,2,9,0
S01013273,939,291,48,243,284,114,107,65,36,42,0,0,0,0
S01013274,793,136,52,84,236,111,64,62,80,75,22,12,10,7
S01013275,671,115,32,83,184,91,112,34,63,54,16,16,0,2
S01013276,611,79,16,63,192,93,49,78,58,52,2,0,2,8
S01013277,889,47,18,29,170,101,61,124,177,173,25,14,11,11
S01013278,781,32,18,14,118,97,66,71,185,143,45,16,29,24
S01013279,740,43,12,31,112,95,37,92,156,148,42,33,9,15
S01013280,585,41,6,35,149,112,47,34,86,101,13,1,12,2
S01013281,963,43,8,35,151,112,83,111,207,213,23,19,4,20
S01013282,827,32,5,27,113,105,35,111,180,182,57,26,31,12
S01013283,642,78,5,73,105,99,39,61,137,96,16,10,6,11
S01013284,651,59,6,53,177,125,51,61,73,93,4,1,3,8
S01013285,656,81,8,73,191,125,28,85,79,62,3,1,2,2
S01013286,667,74,14,60,203,130,60,83,69,40,4,3,1,4
S01013287,784,181,25,156,296,120,63,57,45,14,2,0,2,6
S01013288,660,118,22,96,155,106,45,56,90,73,10,8,2,7
S01013289,760,155,31,124,217,85,134,48,64,52,3,3,0,2
S01013290,911,126,30,96,241,125,80,77,131,111,16,1,15,4
S01013291,724,94,22,72,167,104,77,77,76,117,12,0,12,0
S01013292,723,78,14,64,181,120,64,88,74,116,2,0,2,0
S01013293,714,137,15,122,179,128,81,50,69,61,1,1,0,8
S01013294,729,80,8,72,154,139,67,92,90,93,4,2,2,10
S01013295,746,78,12,66,160,148,77,98,93,79,11,10,1,2
S01013296,712,35,8,27,86,78,58,82,139,184,36,16,20,14
S01013297,688,68,22,46,115,98,70,88,108,125,10,8,2,6
S01013298,668,63,15,48,153,84,77,70,83,123,14,10,4,1
S01013299,1019,73,23,50,230,148,59,125,155,183,36,18,18,10
S01013300,552,46,11,35,100,56,50,65,111,107,14,8,6,3
S01013301,481,32,14,18,63,58,32,89,81,108,15,8,7,3
S01013302,614,63,6,57,145,79,105,87,66,61,8,3,5,0
S01013303,881,109,31,78,194,100,53,115,118,172,10,6,4,10
S01013304,929,26,2,24,110,101,33,115,218,248,60,15,45,18
S01013305,952,41,19,22,138,150,45,88,198,268,19,8,11,5
S01013306,920,19,9,10,80,103,43,82,234,239,104,57,47,16
S01013307,1047,28,10,18,95,78,47,140,240,309,94,38,56,16
S01013308,943,29,3,26,65,135,53,117,225,240,46,18,28,33
S01013309,618,135,26,109,182,94,31,39,62,64,10,8,2,1
S01013310,649,42,8,34,118,89,21,98,115,142,16,9,7,8
S01013311,801,37,9,28,132,117,71,86,173,150,22,13,9,13
S01013312,1042,43,2,41,161,150,60,113,184,268,52,13,39,11
S01013313,692,40,16,24,124,71,37,81,142,158,33,23,10,6
S01013314,670,30,16,14,121,107,38,89,143,118,15,12,3,9
S01013315,567,157,37,120,205,46,66,33,18,38,0,0,0,4
S01013316,663,115,21,94,200,76,56,70,73,62,9,9,0,2
S01013317,521,45,8,37,134,92,42,52,72,77,7,2,5,0
S01013318,612,108,32,76,190,73,27,58,85,64,4,2,2,3
S01013319,570,108,27,81,160,86,45,69,59,30,13,7,6,0
S01013320,1040,203,29,174,337,126,86,104,86,76,12,6,6,10
S01013321,423,16,6,10,104,68,25,49,40,88,24,13,11,9
S01013322,724,68,20,48,153,123,48,85,109,122,7,1,6,9
S01013323,947,73,18,55,177,119,51,98,166,204,38,18,20,21
S01013324,649,31,12,19,116,68,27,72,151,129,46,18,28,9
S01013325,905,64,20,44,156,94,40,85,178,176,80,52,28,32
S01013326,541,29,5,24,48,55,35,48,140,147,23,13,10,16
S01013327,697,21,4,17,74,77,57,102,139,185,35,24,11,7
S01013328,652,27,7,20,76,82,47,93,159,147,14,8,6,7
S01013329,538,23,3,20,100,79,31,51,141,100,10,9,1,3
S01013330,1051,174,31,143,306,178,72,90,103,92,24,12,12,12
S01013331,647,98,15,83,175,95,66,62,70,69,7,3,4,5
S01013332,673,43,7,36,107,108,69,73,100,150,11,6,5,12
S01013333,826,96,13,83,218,113,83,101,80,121,9,5,4,5
S01013334,784,34,5,29,112,111,39,91,151,201,40,13,27,5
S01013335,825,17,6,11,88,90,72,85,195,194,65,29,36,19
S01013336,863,28,10,18,117,68,75,83,183,212,88,44,44,9
S01013337,950,106,40,66,207,99,112,118,107,177,18,10,8,6
S01013338,588,144,27,117,218,55,74,38,24,31,4,0,4,0
S01013339,584,123,24,99,169,69,41,72,58,40,5,0,5,7
S01013340,805,163,37,126,235,116,92,99,57,35,4,3,1,4
S01013341,898,188,52,136,329,84,109,53,64,58,11,2,9,2
S01013342,644,8,2,6,93,81,26,55,151,168,54,30,24,8
S01013343,673,37,7,30,115,119,46,65,108,169,8,4,4,6
S01013344,792,22,6,16,115,75,42,120,169,209,31,20,11,9
S01013345,762,28,2,26,106,71,49,108,125,223,35,10,25,17
S01013346,881,196,68,128,276,113,58,91,67,66,8,6,2,6
S01013347,700,82,13,69,205,126,58,64,68,74,11,3,8,12
S01013348,470,92,22,70,133,72,60,34,36,32,1,1,0,10
S01013349,785,132,23,109,178,100,30,67,93,131,29,23,6,25
S01013350,662,39,11,28,140,87,38,75,117,134,15,5,10,17
S01013351,784,71,15,56,131,125,58,131,123,112,25,16,9,8
S01013352,897,48,14,34,146,156,54,120,162,184,25,9,16,2
S01013353,669,21,1,20,100,92,65,105,104,152,27,13,14,3
S01013354,727,71,38,33,179,88,76,87,95,119,6,4,2,6
S01013355,653,70,10,60,125,56,60,67,126,137,12,6,6,0
S01013356,754,27,4,23,111,69,77,81,136,176,65,24,41,12
S01013357,827,77,32,45,189,99,82,97,101,151,25,10,15,6
S01013358,811,63,18,45,135,83,81,107,139,153,33,21,12,17
S01013359,621,15,5,10,84,46,37,63,121,204,38,31,7,13
S01013360,687,24,12,12,114,72,57,81,159,143,35,18,17,2
S01013361,545,17,13,4,68,81,18,63,137,143,15,7,8,3
S01013362,494,23,9,14,74,31,27,51,113,141,25,12,13,9
S01013363,753,33,12,21,74,98,33,72,182,187,53,26,27,21
S01013364,903,115,25,90,163,74,64,129,115,223,14,13,1,6
S01013365,779,70,11,59,166,136,102,92,69,132,9,4,5,3
S01013366,888,103,26,77,219,130,84,133,79,111,19,12,7,10
S01013367,584,95,35,60,154,63,82,56,55,75,4,4,0,0
S01013368,719,72,21,51,88,59,108,76,127,168,18,9,9,3
S01013369,911,33,7,26,107,128,30,107,218,240,48,33,15,0
S01013370,582,23,4,19,99,71,25,45,114,165,32,18,14,8
S01013371,661,49,18,31,113,71,34,89,129,150,25,14,11,1
S01013372,1094,14,7,7,110,123,64,109,272,292,88,26,62,22
S01013373,925,44,18,26,129,105,45,113,198,216,56,24,32,19
S01013374,959,24,5,19,95,92,76,112,179,283,90,32,58,8
S01013375,574,26,4,22,50,74,38,72,121,166,24,13,11,3
S01013376,594,29,6,23,55,65,59,71,102,174,38,26,12,1
S01013377,772,21,6,15,142,84,44,102,145,201,32,22,10,1
S01013378,973,76,23,53,210,153,68,80,140,167,59,28,31,20
S01013379,826,43,7,36,151,86,62,98,168,187,29,21,8,2
S01013380,108,11,8,3,42,7,22,10,8,6,2,2,0,0
S01013381,489,26,7,19,80,45,42,80,71,124,18,9,9,3
S01013382,553,50,27,23,72,56,47,89,81,135,15,6,9,8
S01013383,679,31,4,27,111,78,37,107,133,140,31,15,16,11
S01013384,745,47,11,36,98,88,74,120,73,215,24,13,11,6
S01013385,480,32,9,23,120,71,39,49,65,92,5,3,2,7
S01013386,855,119,12,107,243,118,83,79,66,127,15,2,13,5
S01013387,612,39,12,27,71,72,48,77,98,166,37,12,25,4
S01013388,737,47,11,36,122,92,60,57,95,221,36,25,11,7
S01013389,757,32,7,25,144,66,51,120,132,163,26,8,18,23
S01013390,459,17,0,17,50,68,44,55,95,123,7,3,4,0
S01013391,435,35,17,18,96,30,67,45,81,63,10,5,5,8
S01013392,761,127,33,94,175,136,83,100,52,72,6,6,0,10
S01013393,713,74,22,52,83,56,58,111,128,158,40,12,28,5
S01013394,680,20,9,11,93,75,32,84,155,159,57,39,18,5
S01013395,728,24,2,22,64,46,27,76,180,195,108,65,43,8
S01013396,689,90,16,74,191,110,102,71,39,74,5,0,5,7
S01013397,858,67,13,54,134,95,98,90,127,196,47,28,19,4
S01013398,612,122,33,89,127,111,58,78,50,61,1,1,0,4
S01013399,1032,104,29,75,310,132,80,118,154,112,10,5,5,12
S01013400,637,36,11,25,106,73,48,98,121,123,30,17,13,2
S01013401,805,126,29,97,293,98,68,55,71,61,25,14,11,8
S01013402,1057,243,41,202,350,133,54,85,76,97,10,4,6,9
S01013403,889,188,39,149,284,127,78,48,90,68,0,0,0,6
S01013404,595,109,17,92,175,57,38,58,69,72,15,11,4,2
S01013405,663,48,13,35,130,95,47,87,94,137,18,3,15,7
S01013406,612,14,8,6,88,73,18,63,133,183,38,14,24,2
S01013407,534,19,10,9,68,55,22,53,143,144,20,10,10,10
S01013408,658,26,4,22,91,94,44,84,103,170,41,21,20,5
S01013409,1052,136,52,84,208,134,92,67,159,206,36,8,28,14
S01013410,687,17,13,4,57,85,42,78,169,168,60,18,42,11
S01013411,723,75,9,66,203,80,53,66,94,121,29,20,9,2
S01013412,797,62,23,39,196,113,53,96,82,148,31,14,17,16
S01013413,776,184,72,112,259,46,50,70,82,77,7,6,1,1
S01013414,825,58,14,44,210,105,60,76,132,139,35,14,21,10
S01013415,649,17,5,12,99,105,52,81,113,144,38,24,14,0
S01013416,576,20,1,19,84,63,28,28,135,165,44,28,16,9
S01013417,812,80,17,63,194,103,43,81,143,138,21,8,13,9
S01013418,642,57,19,38,143,85,57,65,85,131,19,7,12,0
S01013419,468,80,3,77,159,70,40,48,20,37,7,3,4,7
S01013420,565,42,11,31,148,97,21,47,97,93,18,5,13,2
S01013421,804,151,32,119,246,98,70,99,67,65,4,3,1,4
S01013422,724,22,0,22,150,99,46,97,141,133,17,9,8,19
S01013423,820,93,18,75,192,101,77,74,95,159,29,11,18,0
S01013424,494,87,24,63,142,60,62,42,54,44,1,1,0,2
S01013425,429,57,11,46,130,62,29,39,40,58,8,1,7,6
S01013426,826,51,27,24,91,117,73,78,143,233,38,24,14,2
S01013427,452,86,34,52,196,44,64,12,17,22,3,2,1,8
S01013428,944,50,11,39,168,104,80,104,136,238,53,25,28,11
S01013429,681,46,5,41,155,79,51,110,112,106,19,17,2,3
S01013430,693,62,12,50,115,86,70,98,102,130,30,19,11,0
S01013431,683,62,26,36,112,65,65,68,129,153,26,8,18,3
S01013432,703,77,19,58,137,78,106,67,73,129,22,1,21,14
S01013433,746,155,49,106,216,75,92,74,50,70,8,1,7,6
S01013434,534,109,15,94,184,28,131,31,21,25,4,3,1,1
S01013435,664,260,67,193,246,50,39,28,17,23,1,1,0,0
S01013436,884,157,30,127,172,100,71,101,115,147,13,8,5,8
S01013437,645,96,10,86,149,77,28,67,99,111,7,6,1,11
S01013438,575,55,16,39,133,77,67,65,74,80,17,9,8,7
S01013439,899,274,32,242,344,84,65,58,40,29,5,2,3,0
S01013440,1012,385,53,332,342,105,64,47,39,24,0,0,0,6
S01013441,745,253,48,205,242,87,71,48,23,15,3,3,0,3
S01013442,785,157,18,139,236,86,63,76,75,80,12,8,4,0
S01013443,635,134,24,110,239,49,47,39,57,54,12,5,7,4
S01013444,928,167,24,143,213,102,83,92,122,101,36,17,19,12
S01013445,624,254,55,199,184,62,37,34,32,17,2,2,0,2
S01013446,713,90,20,70,172,94,41,72,121,107,10,7,3,6
S01013447,645,227,56,171,256,61,50,20,16,7,5,0,5,3
S01013448,798,238,64,174,281,89,64,60,37,13,10,9,1,6
S01013449,640,165,40,125,208,110,58,42,25,27,2,1,1,3
S01013450,588,137,17,120,185,100,30,49,39,43,5,2,3,0
S01013451,871,286,60,226,333,71,68,35,52,16,10,1,9,0
S01013452,779,216,54,162,292,54,55,71,37,37,5,5,0,12
S01013453,772,50,13,37,108,69,39,80,171,216,26,3,23,13
S01013454,753,157,26,131,223,61,80,73,70,76,9,6,3,4
S01013455,560,105,28,77,137,61,68,44,59,64,17,4,13,5
S01013456,772,75,16,59,157,74,82,96,109,155,16,11,5,8
S01013457,909,12,2,10,118,89,68,116,172,276,43,16,27,15
S01013458,711,68,17,51,157,81,72,68,111,124,22,6,16,8
S01013459,797,55,12,43,121,99,75,75,167,174,17,7,10,14
S01013460,849,37,13,24,197,126,62,75,142,182,25,17,8,3
S01013461,1098,127,24,103,223,139,80,109,151,222,44,18,26,3
S01013462,830,139,34,105,181,97,77,87,99,140,8,3,5,2
S01013463,590,49,7,42,94,115,42,58,121,75,27,10,17,9
S01013464,698,77,30,47,211,96,42,97,83,82,4,2,2,6
S01013465,669,48,11,37,136,132,63,74,91,102,17,10,7,6
S01013466,295,38,7,31,75,21,61,14,36,41,9,0,9,0
S01013467,950,177,34,143,256,111,83,112,103,95,8,7,1,5
S01013468,597,55,17,38,162,78,74,41,90,83,13,6,7,1
S01013469,744,97,31,66,148,115,73,107,99,94,6,6,0,5
S01013470,742,25,9,16,104,69,42,100,174,201,24,10,14,3
S01013471,935,51,23,28,149,133,69,134,172,187,30,14,16,10
S01013472,624,144,41,103,176,79,83,59,23,50,5,1,4,5
S01013473,682,176,38,138,196,91,93,46,37,38,0,0,0,5
S01013474,639,100,21,79,196,84,71,46,51,81,4,2,2,6
S01013475,613,57,4,53,176,88,66,62,96,51,17,12,5,0
S01013476,626,70,27,43,114,96,69,79,94,83,13,7,6,8
S01013477,605,31,6,25,89,80,62,80,81,157,17,2,15,8
S01013478,851,76,9,67,240,97,87,80,114,125,28,11,17,4
S01013479,781,38,2,36,113,86,47,99,149,206,36,16,20,7
S01013480,671,23,2,21,82,71,47,109,157,162,15,8,7,5
S01013481,451,45,17,28,102,54,60,49,73,63,5,3,2,0
