,All people in households where HRP is aged under 65,1. Higher managerial administrative and professional occupations,1. Higher managerial administrative and professional occupations: 1.1 Large employers and higher managerial and administrative occupations,1. Higher managerial administrative and professional occupations: 1.2 Higher professional occupations,2. Lower managerial administrative and professional occupations,3. Intermediate occupations,4. Small employers and own account workers,5. Lower supervisory and technical occupations,6. Semi-routine occupations,7. Routine occupations,8. Never worked and long-term unemployed,8. Never worked and long-term unemployed: L14.1 Never worked,8. Never worked and long-term unemployed: L14.2 Long-term unemployed,L15 Full-time students
S92000003,4248836,529723,108377,421346,973272,451922,426657,434172,582602,551545,170336,86474,83862,128607
S01006506,713,175,20,155,194,54,74,68,66,60,12,8,4,10
S01006507,675,121,20,101,167,49,78,85,81,80,4,3,1,10
S01006508,579,123,20,103,154,91,62,64,41,33,3,2,1,8
S01006509,466,72,20,52,117,41,57,61,71,45,1,0,1,1
S01006510,453,88,23,65,125,47,46,37,56,39,11,7,4,4
S01006511,545,157,59,98,181,47,65,35,26,26,5,1,4,3
S01006512,438,168,31,137,127,8,68,21,30,9,3,0,3,4
S01006513,433,145,35,110,147,35,29,46,18,13,0,0,0,0
S01006514,789,355,77,278,226,66,64,40,10,26,1,1,0,1
S01006515,658,277,44,233,180,33,72,21,32,21,6,6,0,16
S01006516,365,144,37,107,112,12,60,12,12,3,0,0,0,10
S01006517,804,343,87,256,207,41,74,62,39,18,14,14,0,6
S01006518,490,216,72,144,133,25,57,26,28,0,0,0,0,5
S01006519,699,280,49,231,190,71,60,27,38,23,3,0,3,7
S01006520,688,384,80,304,183,20,27,32,21,7,14,0,14,0
S01006521,596,287,90,197,159,16,76,34,22,1,1,0,1,0
S01006522,483,252,44,208,124,26,31,23,17,7,0,0,0,3
S01006523,726,328,94,234,203,44,47,57,16,12,3,0,3,16
S01006524,545,255,81,174,118,28,67,30,20,17,8,2,6,2
S01006525,598,267,71,196,145,32,56,38,28,14,0,0,0,18
S01006526,717,62,12,50,136,81,33,93,110,78,21,8,13,103
S01006527,541,36,2,34,63,65,26,103,92,116,10,5,5,30
S01006528,778,84,6,78,141,63,39,106,111,106,18,14,4,110
S01006529,716,94,10,84,161,64,43,62,95,61,14,11,3,122
S01006530,602,44,8,36,101,76,40,96,70,102,19,17,2,54
S01006531,771,65,5,60,125,55,33,62,154,166,27,7,20,84
S01006532,522,162,23,139,180,45,52,21,14,13,0,0,0,35
S01006533,561,228,45,183,183,24,40,28,29,10,0,0,0,19
S01006534,760,289,79,210,232,56,50,58,39,14,4,0,4,18
S01006535,932,215,38,177,302,92,57,80,72,44,4,0,4,66
S01006536,918,226,36,190,326,89,38,71,62,45,8,1,7,53
S01006537,529,197,33,164,134,60,52,37,39,6,2,2,0,2
S01006538,427,154,34,120,117,25,40,63,20,4,2,0,2,2
S01006539,551,182,30,152,173,52,43,50,14,23,4,4,0,10
S01006540,780,265,47,218,234,92,43,62,42,15,3,3,0,24
S01006541,550,199,50,149,172,43,31,48,43,10,2,0,2,2
S01006542,695,274,54,220,228,55,37,34,30,26,5,5,0,6
S01006543,544,143,31,112,182,48,54,56,37,15,3,0,3,6
S01006544,872,366,71,295,227,31,103,72,34,15,2,0,2,22
S01006545,773,236,46,190,232,87,57,51,47,36,7,4,3,20
S01006546,488,171,34,137,202,43,18,21,10,17,4,4,0,2
S01006547,655,186,62,124,186,55,37,55,63,45,10,7,3,18
S01006548,486,150,27,123,178,36,59,19,29,6,5,5,0,4
S01006549,597,214,49,165,163,29,71,51,36,24,4,1,3,5
S01006550,648,218,44,174,185,65,52,56,35,23,2,0,2,12
S01006551,497,102,9,93,86,55,62,42,57,83,6,3,3,4
S01006552,724,195,34,161,219,86,75,65,54,27,2,0,2,1
S01006553,539,119,20,99,122,48,83,56,74,25,7,3,4,5
S01006554,540,90,5,85,149,51,43,58,60,70,10,3,7,9
S01006555,688,51,8,43,137,85,35,91,122,142,15,9,6,10
S01006556,636,33,9,24,122,71,57,80,92,154,15,5,10,12
S01006557,587,46,13,33,97,70,36,104,120,92,14,8,6,8
S01006558,525,204,23,181,152,41,26,41,21,17,0,0,0,23
S01006559,539,263,37,226,153,27,18,19,9,8,3,2,1,39
S01006560,822,349,46,303,238,61,63,40,34,15,1,1,0,21
S01006561,637,269,54,215,188,32,57,35,24,11,3,0,3,18
S01006562,541,182,22,160,142,39,31,39,71,27,6,5,1,4
S01006563,658,289,28,261,152,27,29,75,24,44,3,0,3,15
S01006564,861,126,9,117,209,59,63,85,110,75,45,28,17,89
S01006565,788,117,8,109,184,80,34,93,85,68,13,7,6,114
S01006566,682,166,7,159,181,89,22,52,47,31,6,4,2,88
S01006567,735,86,9,77,159,73,20,81,87,60,26,10,16,143
S01006568,894,241,8,233,258,77,22,63,68,39,11,2,9,115
S01006569,501,179,27,152,102,37,26,36,44,34,3,2,1,40
S01006570,677,241,52,189,184,42,44,64,38,15,8,1,7,41
S01006571,778,288,37,251,240,51,46,35,38,26,10,5,5,44
S01006572,732,360,90,270,206,25,73,39,21,4,0,0,0,4
S01006573,644,357,95,262,152,15,39,30,22,3,6,0,6,20
S01006574,852,408,86,322,221,30,57,44,53,8,10,1,9,21
S01006575,795,308,48,260,207,55,49,101,39,9,7,1,6,20
S01006576,640,250,46,204,172,59,37,39,27,19,1,1,0,36
S01006577,701,201,24,177,202,60,58,67,44,22,5,2,3,42
S01006578,979,214,10,204,292,109,21,83,83,68,15,5,10,94
S01006579,909,183,14,169,248,113,14,77,96,52,7,5,2,119
S01006580,649,197,19,178,201,69,28,57,48,22,0,0,0,27
S01006581,731,325,82,243,183,33,78,55,36,17,0,0,0,4
S01006582,765,181,5,176,180,70,34,43,112,40,5,0,5,100
S01006583,686,145,6,139,153,67,11,58,76,25,6,1,5,145
S01006584,603,160,12,148,172,38,27,44,36,22,0,0,0,104
S01006585,695,72,1,71,124,58,50,83,95,103,26,13,13,84
S01006586,875,136,7,129,175,83,31,77,109,69,9,7,2,186
S01006587,520,84,4,80,93,60,38,52,61,39,7,3,4,86
S01006588,586,85,2,83,126,55,12,56,67,41,5,2,3,139
S01006589,658,71,2,69,94,52,24,60,68,96,16,3,13,177
S01006590,596,143,9,134,145,66,27,40,60,34,7,6,1,74
S01006591,680,182,15,167,177,70,24,47,74,45,4,2,2,57
S01006592,651,166,18,148,194,67,37,60,54,28,0,0,0,45
S01006593,703,212,30,182,203,59,18,59,31,38,3,3,0,80
S01006594,420,99,18,81,83,79,25,45,19,24,1,0,1,45
S01006595,872,220,21,199,246,120,27,62,72,40,11,7,4,74
S01006596,627,185,12,173,184,55,44,56,49,25,2,0,2,27
S01006597,487,86,5,81,137,46,23,51,47,30,6,4,2,61
S01006598,829,333,57,276,227,59,65,78,25,22,1,0,1,19
S01006599,636,102,9,93,146,78,34,58,75,58,12,3,9,73
S01006600,828,242,34,208,189,89,65,61,87,48,5,4,1,42
S01006601,867,210,35,175,225,98,58,85,80,53,15,8,7,43
S01006602,685,288,64,224,178,41,57,33,46,17,1,0,1,24
S01006603,645,56,18,38,83,55,22,129,86,180,21,13,8,13
S01006604,537,30,0,30,110,61,72,60,95,102,5,0,5,2
S01006605,607,47,2,45,90,59,29,72,142,125,35,15,20,8
S01006606,574,98,17,81,170,58,65,59,53,51,12,5,7,8
S01006607,737,71,9,62,119,83,61,124,106,138,19,10,9,16
S01006608,597,108,15,93,130,52,95,85,41,60,7,0,7,19
S01006609,822,50,3,47,117,101,66,161,140,156,18,2,16,13
S01006610,340,29,14,15,46,48,9,64,74,62,8,8,0,0
S01006611,714,44,5,39,153,75,45,117,92,155,25,3,22,8
S01006612,698,89,5,84,199,95,64,49,84,97,17,12,5,4
S01006613,561,96,20,76,151,97,50,69,46,51,1,0,1,0
S01006614,644,124,23,101,217,70,43,76,59,43,6,0,6,6
S01006615,758,206,61,145,217,65,88,97,38,32,0,0,0,15
S01006616,746,113,23,90,187,88,53,122,80,84,3,0,3,16
S01006617,551,50,9,41,116,109,71,61,68,68,0,0,0,8
S01006618,415,81,25,56,90,56,30,72,50,36,0,0,0,0
S01006619,760,101,20,81,166,60,86,146,79,109,8,8,0,5
S01006620,705,91,17,74,171,102,44,96,84,106,4,0,4,7
S01006621,449,34,7,27,113,50,33,98,59,55,3,0,3,4
S01006622,639,92,16,76,167,113,87,70,56,53,1,1,0,0
S01006623,594,61,4,57,103,73,36,113,88,107,2,0,2,11
S01006624,710,61,6,55,109,76,37,114,106,133,19,10,9,55
S01006625,522,34,5,29,89,59,42,67,97,117,11,2,9,6
S01006626,578,13,6,7,69,55,29,73,139,161,11,8,3,28
S01006627,781,62,14,48,162,91,28,93,109,193,18,6,12,25
S01006628,1056,84,5,79,147,94,42,163,177,249,22,11,11,78
S01006629,659,29,12,17,76,48,41,95,140,175,25,9,16,30
S01006630,534,16,4,12,45,61,33,98,107,147,18,12,6,9
S01006631,737,38,6,32,113,70,25,109,157,190,23,19,4,12
S01006632,721,36,2,34,88,71,31,77,169,181,42,23,19,26
S01006633,625,21,5,16,50,55,30,79,130,201,39,26,13,20
S01006634,585,28,9,19,54,38,14,78,87,193,83,51,32,10
S01006635,549,40,0,40,72,40,18,96,99,157,11,4,7,16
S01006636,776,15,0,15,66,42,29,115,206,223,49,31,18,31
S01006637,623,109,12,97,119,65,30,50,74,86,15,9,6,75
S01006638,755,92,12,80,150,83,12,54,118,87,14,5,9,145
S01006639,784,77,16,61,144,67,31,72,95,96,28,18,10,174
S01006640,716,159,27,132,168,48,17,66,43,34,2,1,1,179
S01006641,976,143,9,134,180,81,35,92,126,88,23,15,8,208
S01006642,788,100,10,90,138,66,21,60,62,62,10,8,2,269
S01006643,709,92,10,82,114,64,27,38,58,40,10,5,5,266
S01006644,912,129,11,118,149,79,20,67,107,78,7,4,3,276
S01006645,607,51,11,40,119,57,17,71,113,105,21,12,9,53
S01006646,491,50,3,47,111,45,4,42,70,28,5,3,2,136
S01006647,581,44,2,42,119,71,29,54,86,81,15,5,10,82
S01006648,1049,96,7,89,208,104,32,151,129,107,21,6,15,201
S01006649,928,125,2,123,156,109,26,87,138,112,27,12,15,148
S01006650,815,83,5,78,169,56,46,75,94,69,13,7,6,210
S01006651,554,61,0,61,81,58,7,75,41,56,12,4,8,163
S01006652,507,69,1,68,100,42,25,47,41,38,13,4,9,132
S01006653,526,128,10,118,124,33,27,42,40,28,1,0,1,103
S01006654,744,74,3,71,122,90,48,74,126,118,22,11,11,70
S01006655,563,153,17,136,144,40,30,35,37,37,2,1,1,85
S01006656,900,159,4,155,191,114,26,75,104,73,25,3,22,133
S01006657,516,80,9,71,85,62,11,50,70,61,2,1,1,95
S01006658,967,75,1,74,124,77,37,138,140,129,28,9,19,219
S01006659,571,97,8,89,88,37,25,52,35,14,0,0,0,223
S01006660,521,27,1,26,41,25,36,65,80,95,29,16,13,123
S01006661,559,100,15,85,90,46,17,49,38,30,3,0,3,186
S01006662,575,22,2,20,82,40,23,67,104,69,21,16,5,147
S01006663,538,68,4,64,54,39,28,24,26,21,12,7,5,266
S01006664,470,78,1,77,64,10,9,41,55,15,3,2,1,195
S01006665,532,69,3,66,93,41,18,32,40,23,5,3,2,211
S01006666,699,23,0,23,73,47,58,105,139,158,55,31,24,41
S01006667,636,27,4,23,72,32,24,90,117,151,52,31,21,71
S01006668,678,79,1,78,139,70,13,42,74,27,7,3,4,227
S01006669,579,104,3,101,68,37,26,60,98,71,12,6,6,103
S01006670,430,40,6,34,100,58,19,31,53,56,5,1,4,68
S01006671,386,70,19,51,64,36,13,37,36,31,6,3,3,93
S01006672,647,48,0,48,93,38,21,63,120,148,27,16,11,89
S01006673,655,81,1,80,76,53,38,64,133,98,13,5,8,99
S01006674,730,39,7,32,82,74,60,109,120,167,35,15,20,44
S01006675,697,15,2,13,91,41,39,77,158,200,37,18,19,39
S01006676,639,68,0,68,62,43,29,72,113,170,31,13,18,51
S01006677,652,27,1,26,92,43,22,77,114,161,24,8,16,92
S01006678,1012,33,5,28,125,55,45,139,212,274,56,30,26,73
S01006679,515,47,7,40,145,55,28,65,70,75,4,0,4,26
S01006680,759,14,2,12,87,46,45,94,130,263,57,23,34,23
S01006681,573,31,6,25,146,58,26,97,100,87,12,1,11,16
S01006682,775,36,5,31,101,32,66,81,140,234,37,15,22,48
S01006683,824,56,0,56,121,78,30,86,157,186,20,5,15,90
S01006684,631,52,12,40,72,54,33,88,137,133,21,7,14,41
S01006685,643,38,4,34,151,70,24,63,95,145,30,7,23,27
S01006686,523,60,7,53,98,37,35,59,109,99,12,5,7,14
S01006687,657,63,6,57,119,67,26,107,131,97,15,8,7,32
S01006688,613,85,25,60,132,49,74,52,93,87,6,6,0,35
S01006689,567,149,18,131,169,55,52,35,26,12,0,0,0,69
S01006690,482,88,6,82,119,37,15,54,48,34,9,1,8,78
S01006691,482,127,5,122,82,22,36,35,54,22,1,1,0,103
S01006692,586,145,33,112,148,34,42,56,38,28,0,0,0,95
S01006693,886,127,14,113,184,94,50,111,81,145,21,14,7,73
S01006694,531,10,4,6,92,64,33,77,113,112,15,9,6,15
S01006695,527,84,18,66,78,33,39,74,80,119,10,7,3,10
S01006696,685,70,9,61,96,109,34,92,125,87,16,11,5,56
S01006697,736,49,1,48,115,73,58,126,133,138,10,3,7,34
S01006698,516,35,0,35,97,52,8,50,89,133,17,11,6,35
S01006699,376,41,7,34,76,35,30,27,50,94,2,0,2,21
S01006700,610,94,13,81,117,56,55,71,75,85,12,4,8,45
S01006701,623,19,3,16,91,70,35,115,151,112,25,12,13,5
S01006702,583,25,2,23,68,79,49,102,120,127,9,1,8,4
S01006703,575,35,4,31,86,43,33,55,161,140,12,5,7,10
S01006704,515,13,10,3,67,57,13,69,106,139,38,19,19,13
S01006705,567,40,13,27,78,61,49,87,111,127,9,2,7,5
S01006706,523,32,6,26,89,76,32,77,110,87,16,9,7,4
S01006707,586,31,4,27,91,44,38,83,136,117,30,9,21,16
S01006708,575,32,7,25,108,76,45,80,110,106,8,8,0,10
S01006709,723,41,14,27,103,84,79,98,121,148,26,15,11,23
S01006710,611,15,3,12,163,89,47,91,74,110,19,9,10,3
S01006711,712,43,18,25,139,99,75,88,101,138,21,13,8,8
S01006712,391,18,14,4,73,59,25,85,48,78,3,0,3,2
S01006713,745,46,11,35,121,89,53,88,123,215,4,4,0,6
S01006714,520,24,4,20,76,63,23,88,87,133,4,4,0,22
S01006715,558,23,0,23,70,35,32,79,92,160,45,29,16,22
S01006716,527,16,3,13,106,64,54,61,96,97,12,9,3,21
S01006717,744,30,7,23,104,87,53,105,130,188,33,17,16,14
S01006718,507,31,6,25,63,46,53,79,90,111,24,9,15,10
S01006719,790,48,3,45,137,76,57,122,119,193,21,12,9,17
S01006720,494,21,0,21,82,61,23,62,106,126,8,5,3,5
S01006721,742,23,2,21,155,53,51,92,120,197,41,17,24,10
S01006722,644,39,5,34,92,48,31,94,154,155,23,8,15,8
S01006723,534,33,7,26,102,68,44,74,85,115,13,9,4,0
S01006724,952,30,10,20,112,55,57,113,217,279,65,39,26,24
S01006725,586,31,16,15,69,49,38,87,116,163,20,9,11,13
S01006726,1325,27,2,25,120,95,60,184,224,430,149,72,77,36
S01006727,868,28,3,25,93,67,38,126,194,241,57,36,21,24
S01006728,639,54,9,45,117,58,29,71,154,113,26,17,9,17
S01006729,722,19,2,17,95,57,18,90,148,232,56,27,29,7
S01006730,613,38,4,34,120,70,33,70,131,136,7,4,3,8
S01006731,497,8,0,8,79,46,37,73,83,145,23,12,11,3
S01006732,819,251,69,182,223,58,132,67,32,31,16,15,1,9
S01006733,842,290,56,234,253,99,80,40,45,20,0,0,0,15
S01006734,829,307,53,254,239,47,87,65,34,41,4,0,4,5
S01006735,473,202,48,154,144,36,23,22,15,26,0,0,0,5
S01006736,1038,291,52,239,314,103,89,119,42,59,11,3,8,10
S01006737,540,163,52,111,124,45,74,65,32,32,0,0,0,5
S01006738,749,72,9,63,164,135,44,132,91,89,10,5,5,12
S01006739,538,62,12,50,171,57,33,57,72,66,10,4,6,10
S01006740,578,40,12,28,142,65,31,85,90,111,8,3,5,6
S01006741,428,38,4,34,71,67,28,64,69,91,0,0,0,0
S01006742,301,22,4,18,60,31,23,57,52,52,3,1,2,1
S01006743,413,41,4,37,88,76,33,54,46,56,0,0,0,19
S01006744,517,54,19,35,118,60,49,85,90,46,10,6,4,5
S01006745,622,49,11,38,117,81,42,75,112,131,8,7,1,7
S01006746,623,42,7,35,125,89,34,117,108,94,5,3,2,9
S01006747,530,99,17,82,147,77,27,66,55,45,4,4,0,10
S01006748,689,130,40,90,195,65,58,91,66,78,6,5,1,0
S01006749,735,73,10,63,187,65,46,103,136,119,6,4,2,0
S01006750,478,42,14,28,108,59,41,97,60,65,3,3,0,3
S01006751,364,47,23,24,82,18,35,67,66,41,8,8,0,0
S01006752,530,60,7,53,97,69,11,108,90,85,7,5,2,3
S01006753,655,149,35,114,149,63,70,106,43,63,4,3,1,8
S01006754,638,139,25,114,176,65,48,100,46,55,7,1,6,2
S01006755,654,126,17,109,194,72,77,65,58,41,10,0,10,11
S01006756,649,204,47,157,209,62,40,43,61,15,4,0,4,11
S01006757,640,95,19,76,214,98,50,94,31,49,5,0,5,4
S01006758,608,143,30,113,182,54,44,65,68,42,2,0,2,8
S01006759,496,107,28,79,157,45,40,59,25,59,2,2,0,2
S01006760,441,67,15,52,134,75,21,61,31,49,1,0,1,2
S01006761,553,107,30,77,163,65,55,55,44,62,2,0,2,0
S01006762,541,94,16,78,181,45,71,70,42,38,0,0,0,0
S01006763,841,141,25,116,264,87,76,119,64,64,5,2,3,21
S01006764,748,107,33,74,227,88,42,125,63,87,2,0,2,7
S01006765,541,82,13,69,165,70,40,78,51,46,7,3,4,2
S01006766,564,137,38,99,154,77,50,51,45,40,7,7,0,3
S01006767,562,93,22,71,143,70,38,95,73,49,1,0,1,0
S01006768,541,167,59,108,180,48,47,42,28,26,0,0,0,3
S01006769,802,126,27,99,185,101,65,150,106,65,2,2,0,2
S01006770,536,83,28,55,145,77,36,79,58,50,5,3,2,3
S01006771,438,100,19,81,132,23,42,50,54,26,0,0,0,11
S01006772,726,125,28,97,201,82,87,76,86,68,1,0,1,0
S01006773,595,78,10,68,176,84,88,84,58,18,0,0,0,9
S01006774,601,109,40,69,183,57,62,88,70,32,0,0,0,0
S01006775,501,58,14,44,120,79,31,54,88,60,5,1,4,6
S01006776,321,27,12,15,54,34,13,52,71,63,3,2,1,4
S01006777,537,76,15,61,158,72,58,71,40,51,0,0,0,11
S01006778,488,93,25,68,96,71,35,46,66,68,11,4,7,2
S01006779,440,36,6,30,87,47,35,51,76,82,6,0,6,20
S01006780,459,48,10,38,123,52,67,66,47,49,3,1,2,4
S01006781,489,101,29,72,117,69,59,60,36,45,2,0,2,0
S01006782,640,118,38,80,186,61,63,86,57,39,4,4,0,26
S01006783,459,62,10,52,120,73,40,75,35,47,7,3,4,0
S01006784,481,78,15,63,137,61,45,53,46,33,1,0,1,27
S01006785,544,113,38,75,174,60,53,76,46,19,0,0,0,3
S01006786,747,170,23,147,229,72,75,78,57,46,5,3,2,15
S01006787,512,97,23,74,115,76,48,70,51,44,0,0,0,11
S01006788,684,170,42,128,167,52,73,86,67,53,1,0,1,15
S01006789,420,67,16,51,65,28,67,73,69,45,5,0,5,1
S01006790,582,71,22,49,103,41,50,102,117,87,4,0,4,7
S01006791,417,41,5,36,96,20,74,89,43,44,10,4,6,0
S01006792,356,44,11,33,74,26,57,56,48,48,0,0,0,3
S01006793,364,32,16,16,92,8,64,65,38,59,0,0,0,6
S01006794,403,66,17,49,84,18,46,54,65,64,6,3,3,0
S01006795,583,189,42,147,109,47,78,69,35,43,6,0,6,7
S01006796,485,95,25,70,110,45,62,58,61,36,13,10,3,5
S01006797,524,128,39,89,141,25,98,45,38,39,7,0,7,3
S01006798,527,91,26,65,118,54,144,74,23,19,0,0,0,4
S01006799,675,97,19,78,177,61,77,117,72,72,1,0,1,1
S01006800,706,274,61,213,154,29,87,74,41,40,0,0,0,7
S01006801,714,167,38,129,165,64,127,81,51,56,3,0,3,0
S01006802,544,84,21,63,105,29,102,73,66,83,2,0,2,0
S01006803,505,50,14,36,126,57,25,106,46,84,5,3,2,6
S01006804,633,128,47,81,163,47,56,100,70,63,1,0,1,5
S01006805,943,146,42,104,229,60,134,115,125,125,6,0,6,3
S01006806,859,152,28,124,231,47,182,97,77,67,2,2,0,4
S01006807,548,53,6,47,117,52,90,73,71,78,12,0,12,2
S01006808,519,130,29,101,168,34,60,67,29,24,2,0,2,5
S01006809,624,65,31,34,156,37,83,90,78,96,12,1,11,7
S01006810,718,146,34,112,163,55,140,81,49,66,12,4,8,6
S01006811,929,202,52,150,239,94,119,104,84,64,22,12,10,1
S01006812,653,123,19,104,177,53,99,71,64,61,3,0,3,2
S01006813,658,100,21,79,154,47,92,104,66,79,15,3,12,1
S01006814,695,186,46,140,222,59,70,65,53,39,1,1,0,0
S01006815,442,48,17,31,85,36,35,68,81,75,11,0,11,3
S01006816,586,120,49,71,150,61,66,85,60,39,5,5,0,0
S01006817,559,106,20,86,125,55,73,61,58,71,3,0,3,7
S01006818,610,121,30,91,157,26,135,70,63,34,4,0,4,0
S01006819,741,202,48,154,224,33,138,54,36,39,8,6,2,7
S01006820,356,86,25,61,119,43,38,41,16,13,0,0,0,0
S01006821,487,116,23,93,116,40,106,41,30,30,3,0,3,5
S01006822,659,168,54,114,155,49,143,51,49,43,1,0,1,0
S01006823,557,164,26,138,175,72,22,67,35,20,2,1,1,0
S01006824,694,25,10,15,122,57,60,70,160,157,35,16,19,8
S01006825,658,79,13,66,165,67,45,126,80,86,7,5,2,3
S01006826,732,225,81,144,208,33,81,84,39,55,1,1,0,6
S01006827,699,118,26,92,172,87,27,93,91,96,12,2,10,3
S01006828,705,111,38,73,191,89,61,81,97,62,10,5,5,3
S01006829,412,143,33,110,110,31,41,45,21,21,0,0,0,0
S01006830,587,97,14,83,144,73,86,68,65,41,13,8,5,0
S01006831,422,90,26,64,154,33,30,55,43,17,0,0,0,0
S01006832,809,256,90,166,224,48,72,83,54,68,3,3,0,1
S01006833,330,112,29,83,112,16,47,19,19,5,0,0,0,0
S01006834,524,166,51,115,179,47,50,33,25,21,3,2,1,0
S01006835,585,115,29,86,175,38,88,73,55,34,4,4,0,3
S01006836,491,155,33,122,162,35,31,42,34,29,2,0,2,1
S01006837,499,119,23,96,152,39,71,65,22,29,2,2,0,0
S01006838,584,154,31,123,179,42,58,58,28,63,1,1,0,1
S01006839,817,118,22,96,240,97,78,105,72,93,8,1,7,6
S01006840,864,219,42,177,235,92,79,96,70,68,0,0,0,5
S01006841,839,157,19,138,290,100,67,101,56,55,6,0,6,7
S01006842,683,94,28,66,224,102,66,68,73,56,0,0,0,0
S01006843,752,125,32,93,200,135,68,97,75,49,0,0,0,3
S01006844,572,82,6,76,161,89,57,83,55,42,1,0,1,2
S01006845,863,164,47,117,300,81,70,118,87,37,6,3,3,0
S01006846,462,56,17,39,112,81,38,75,55,45,0,0,0,0
S01006847,597,115,27,88,186,70,69,80,37,36,4,0,4,0
S01006848,775,237,56,181,167,34,127,81,49,64,7,0,7,9
S01006849,940,184,40,144,242,139,85,93,79,95,9,7,2,14
S01006850,886,90,25,65,248,120,68,113,120,112,11,2,9,4
S01006851,666,77,35,42,153,74,71,90,99,88,12,11,1,2
S01006852,487,99,33,66,137,46,74,58,50,20,3,2,1,0
S01006853,735,288,89,199,172,15,123,62,14,52,4,1,3,5
S01006854,678,148,41,107,183,58,88,71,57,63,10,0,10,0
S01006855,656,230,56,174,192,31,129,32,15,26,0,0,0,1
S01006856,576,152,33,119,189,26,62,59,37,44,0,0,0,7
S01006857,819,181,39,142,215,31,216,61,44,63,8,2,6,0
S01006858,536,163,17,146,117,19,135,19,49,34,0,0,0,0
S01006859,912,306,101,205,274,48,107,58,84,30,0,0,0,5
S01006860,399,52,9,43,86,26,39,50,52,85,2,1,1,7
S01006861,583,248,48,200,175,56,38,47,12,2,0,0,0,5
S01006862,506,114,22,92,116,54,51,79,39,46,6,0,6,1
S01006863,534,64,22,42,119,59,73,101,58,60,0,0,0,0
S01006864,425,75,21,54,107,49,33,54,56,43,6,1,5,2
S01006865,739,209,60,149,186,39,88,65,71,77,0,0,0,4
S01006866,424,157,26,131,141,20,26,44,17,12,0,0,0,7
S01006867,532,225,60,165,151,22,61,31,25,10,1,1,0,6
S01006868,690,172,36,136,170,56,45,88,82,66,3,0,3,8
S01006869,414,89,18,71,75,36,56,49,56,50,3,0,3,0
S01006870,367,93,10,83,88,29,62,46,14,25,3,0,3,7
S01006871,586,145,44,101,184,53,51,39,52,48,10,0,10,4
S01006872,605,228,66,162,156,18,78,81,23,17,0,0,0,4
S01006873,673,213,40,173,151,23,129,51,52,45,5,1,4,4
S01006874,475,144,43,101,110,24,83,55,40,19,0,0,0,0
S01006875,516,78,15,63,109,26,92,64,72,62,4,0,4,9
S01006876,825,136,36,100,155,63,227,102,50,85,7,1,6,0
S01006877,784,179,38,141,196,56,206,64,44,33,3,1,2,3
S01006878,532,67,11,56,107,52,140,55,63,44,4,1,3,0
S01006879,590,114,32,82,116,24,140,99,31,50,9,1,8,7
S01006880,522,152,32,120,173,27,62,57,24,23,0,0,0,4
S01006881,472,128,43,85,84,26,106,54,43,26,5,0,5,0
S01006882,274,26,8,18,50,20,19,55,46,55,1,1,0,2
S01006883,354,63,10,53,102,40,40,30,32,43,4,0,4,0
S01006884,677,103,28,75,189,65,74,95,79,61,6,0,6,5
S01006885,391,109,30,79,122,28,50,39,16,27,0,0,0,0
S01006886,613,158,31,127,155,30,88,71,60,46,5,1,4,0
S01006887,517,143,36,107,125,33,89,52,23,50,0,0,0,2
S01006888,683,143,25,118,179,52,141,63,53,46,6,3,3,0
S01006889,687,56,19,37,146,38,27,112,108,167,14,3,11,19
S01006890,564,126,15,111,181,42,55,78,39,39,4,1,3,0
S01006891,762,147,27,120,219,54,68,106,81,82,5,1,4,0
S01006892,508,48,6,42,106,36,42,102,68,85,8,5,3,13
S01006893,457,41,15,26,107,44,45,71,57,78,7,7,0,7
S01006894,672,104,18,86,204,61,42,95,57,96,10,8,2,3
S01006895,437,49,8,41,92,52,34,63,66,67,9,5,4,5
S01006896,590,74,21,53,139,63,21,109,63,98,12,6,6,11
S01006897,597,108,34,74,128,57,41,118,77,68,0,0,0,0
S01006898,625,90,20,70,138,63,41,93,87,107,3,3,0,3
S01006899,541,136,43,93,183,68,17,73,17,47,0,0,0,0
S01006900,507,97,30,67,127,46,44,76,42,70,4,4,0,1
S01006901,474,33,9,24,126,49,30,58,64,105,3,2,1,6
S01006902,596,83,22,61,172,52,42,66,89,84,8,4,4,0
S01006903,643,66,15,51,126,74,46,76,101,136,9,6,3,9
S01006904,543,78,18,60,125,52,33,76,84,88,1,1,0,6
S01006905,624,140,41,99,157,50,75,63,75,60,2,2,0,2
S01006906,571,43,10,33,125,57,62,72,87,101,18,8,10,6
S01006907,496,38,7,31,127,47,49,61,47,114,11,9,2,2
S01006908,618,64,12,52,148,63,36,81,66,139,18,6,12,3
S01006909,702,192,57,135,230,76,65,76,40,23,0,0,0,0
S01006910,766,214,48,166,179,65,126,70,36,59,6,2,4,11
S01006911,658,202,34,168,207,65,18,65,59,38,4,0,4,0
S01006912,353,80,15,65,101,22,66,20,34,30,0,0,0,0
S01006913,528,137,39,98,173,45,36,47,42,41,0,0,0,7
S01006914,658,191,36,155,152,40,89,86,21,77,0,0,0,2
S01006915,736,164,31,133,180,53,118,107,48,59,6,6,0,1
S01006916,532,99,23,76,115,64,32,86,75,51,5,3,2,5
S01006917,973,314,58,256,295,84,94,84,56,34,4,0,4,8
S01006918,419,116,22,94,97,43,43,46,37,33,4,0,4,0
S01006919,374,94,15,79,101,39,54,34,24,24,1,0,1,3
S01006920,378,73,19,54,118,36,31,43,49,28,0,0,0,0
S01006921,793,178,35,143,286,70,51,114,48,40,6,3,3,0
S01006922,418,112,34,78,106,14,75,21,51,29,3,0,3,7
S01006923,575,164,45,119,131,34,101,66,42,33,4,0,4,0
S01006924,496,157,52,105,124,31,97,41,29,15,0,0,0,2
S01006925,409,79,24,55,120,50,34,43,32,44,0,0,0,7
S01006926,679,176,43,133,228,47,70,79,48,22,5,0,5,4
S01006927,989,251,33,218,312,138,79,101,54,44,6,0,6,4
S01006928,894,174,12,162,273,80,88,147,67,48,8,3,5,9
S01006929,780,367,112,255,206,80,50,30,31,14,1,1,0,1
S01006930,769,218,52,166,311,70,56,60,22,28,4,3,1,0
S01006931,338,104,15,89,97,29,61,22,17,8,0,0,0,0
S01006932,598,160,54,106,183,73,58,51,35,22,3,3,0,13
S01006933,542,149,8,141,173,58,32,49,32,49,0,0,0,0
S01006934,455,110,23,87,98,35,73,56,45,33,2,0,2,3
S01006935,546,148,41,107,171,58,46,40,44,34,0,0,0,5
S01006936,518,93,30,63,203,58,47,54,31,30,2,2,0,0
S01006937,619,129,27,102,215,65,46,61,66,21,9,3,6,7
S01006938,413,78,12,66,114,63,35,42,43,34,3,2,1,1
S01006939,511,143,50,93,134,65,34,41,46,45,0,0,0,3
S01006940,803,207,53,154,285,73,68,83,55,24,2,2,0,6
S01006941,532,90,14,76,170,73,26,70,60,41,2,0,2,0
S01006942,956,233,68,165,315,92,124,98,60,26,0,0,0,8
S01006943,672,247,49,198,243,42,52,39,31,15,3,0,3,0
S01006944,862,187,42,145,264,125,60,94,68,51,5,0,5,8
S01006945,444,135,37,98,137,42,37,46,30,15,2,0,2,0
S01006946,703,174,42,132,222,46,81,68,48,50,1,1,0,13
S01006947,830,194,25,169,221,114,58,110,46,77,3,3,0,7
S01006948,690,146,41,105,206,63,82,93,41,50,1,0,1,8
S01006949,590,172,37,135,163,51,83,60,34,19,2,2,0,6
S01006950,540,119,18,101,135,45,46,86,53,55,0,0,0,1
S01006951,401,73,15,58,91,52,32,93,24,32,4,2,2,0
S01006952,669,154,49,105,124,63,110,72,62,83,1,1,0,0
S01006953,706,205,71,134,195,56,94,83,38,35,0,0,0,0
S01006954,708,153,34,119,203,66,75,109,56,38,4,0,4,4
S01006955,551,69,18,51,144,79,44,94,60,52,4,3,1,5
S01006956,1052,214,44,170,364,89,86,151,71,65,6,0,6,6
S01006957,961,209,42,167,281,63,167,141,57,34,0,0,0,9
S01006958,603,131,23,108,206,53,48,64,50,44,2,0,2,5
S01006959,485,78,17,61,95,56,36,69,59,79,10,5,5,3
S01006960,939,298,103,195,264,55,95,122,55,39,2,0,2,9
S01006961,962,196,39,157,346,96,77,120,70,50,0,0,0,7
S01006962,627,112,16,96,183,55,45,106,68,57,1,0,1,0
S01006963,575,101,29,72,191,47,50,92,35,48,4,2,2,7
S01006964,675,94,28,66,181,68,43,114,80,89,4,0,4,2
S01006965,392,89,22,67,107,29,39,48,30,44,6,2,4,0
S01006966,504,38,2,36,125,68,47,57,63,90,9,0,9,7
S01006967,568,105,21,84,191,40,34,106,32,56,0,0,0,4
S01006968,411,38,2,36,101,48,36,67,57,59,1,0,1,4
S01006969,697,117,38,79,211,75,47,90,61,91,0,0,0,5
S01006970,627,143,47,96,207,90,26,111,37,8,0,0,0,5
S01006971,371,43,12,31,87,27,41,36,64,62,6,5,1,5
S01006972,452,106,29,77,103,38,104,38,36,27,0,0,0,0
S01006973,413,103,29,74,118,42,53,34,39,23,0,0,0,1
S01006974,917,237,55,182,276,90,82,127,74,29,2,0,2,0
S01006975,834,168,41,127,172,73,171,98,83,66,0,0,0,3
S01006976,388,76,27,49,125,18,72,38,19,28,4,0,4,8
S01006977,727,182,41,141,153,37,171,72,58,45,0,0,0,9
S01006978,697,153,31,122,178,43,93,95,61,59,6,1,5,9
S01006979,659,142,54,88,148,39,116,76,66,61,3,1,2,8
S01006980,726,160,44,116,204,45,96,75,71,49,17,8,9,9
S01006981,719,154,55,99,166,64,115,67,87,61,4,2,2,1
S01006982,810,153,51,102,195,74,116,107,82,78,3,1,2,2
S01006983,654,143,52,91,176,58,106,72,45,43,11,2,9,0
S01006984,603,197,12,185,164,40,79,53,44,22,0,0,0,4
S01006985,810,142,23,119,217,60,99,106,61,124,0,0,0,1
S01006986,594,136,28,108,151,50,44,94,44,60,3,3,0,12
S01006987,514,102,22,80,142,56,33,61,48,49,22,9,13,1
S01006988,564,110,33,77,138,63,92,53,50,44,5,2,3,9
S01006989,924,301,71,230,223,75,135,85,50,47,0,0,0,8
S01006990,858,229,54,175,250,59,110,104,55,43,8,0,8,0
S01006991,329,49,7,42,72,21,51,51,49,36,0,0,0,0
S01006992,498,89,20,69,165,34,95,46,27,36,0,0,0,6
S01006993,456,52,11,41,108,28,101,71,43,50,0,0,0,3
S01006994,498,102,20,82,122,27,106,65,19,57,0,0,0,0
S01006995,742,146,45,101,191,46,121,98,59,72,9,0,9,0
S01006996,681,93,29,64,159,25,101,104,66,125,2,1,1,6
S01006997,708,242,61,181,178,38,92,74,34,45,5,1,4,0
S01006998,928,146,40,106,257,73,158,110,81,90,6,1,5,7
S01006999,709,83,18,65,146,25,202,111,61,65,3,1,2,13
S01007000,744,134,32,102,193,72,103,97,54,82,6,2,4,3
S01007001,731,153,30,123,189,60,95,104,57,71,2,0,2,0
S01007002,526,64,14,50,110,49,81,53,66,91,12,10,2,0
S01007003,431,59,8,51,78,30,152,31,24,52,5,0,5,0
S01007004,604,101,16,85,105,61,148,61,53,65,0,0,0,10
S01007005,770,159,31,128,197,41,159,78,43,90,2,0,2,1
S01007006,728,109,25,84,148,36,117,91,105,116,3,0,3,3
S01007007,697,70,18,52,130,29,208,122,51,82,5,0,5,0
S01007008,777,101,33,68,117,46,79,143,128,151,10,7,3,2
S01007009,763,51,11,40,163,73,85,99,129,150,13,5,8,0
S01007010,537,75,17,58,117,46,66,61,79,87,3,1,2,3
S01007011,635,33,15,18,82,51,68,84,137,144,23,7,16,13
S01007012,537,17,9,8,61,39,23,77,125,141,44,20,24,10
S01007013,461,48,5,43,79,14,168,64,32,50,3,0,3,3
S01007014,887,104,32,72,200,59,189,160,107,57,3,1,2,8
S01007015,517,48,21,27,81,24,183,86,28,59,2,0,2,6
S01007016,525,75,13,62,96,34,105,73,62,73,7,1,6,0
S01007017,753,73,10,63,94,59,68,132,151,158,15,5,10,3
S01007018,742,68,26,42,142,74,92,140,103,121,2,0,2,0
S01007019,491,29,3,26,82,34,48,85,68,124,10,1,9,11
S01007020,550,53,24,29,95,31,42,126,90,90,18,8,10,5
S01007021,636,58,25,33,134,55,50,80,126,123,2,2,0,8
S01007022,385,29,11,18,68,12,54,62,61,89,8,5,3,2
S01007023,388,18,2,16,83,16,134,46,52,38,1,1,0,0
S01007024,811,41,7,34,161,30,239,108,115,89,18,12,6,10
S01007025,661,32,13,19,94,38,61,125,92,207,12,4,8,0
S01007026,588,34,11,23,115,37,109,97,88,105,1,0,1,2
S01007027,825,69,25,44,175,24,172,119,96,147,15,12,3,8
S01007028,563,44,13,31,128,40,138,64,72,61,11,8,3,5
S01007029,422,35,2,33,73,25,167,32,23,61,6,0,6,0
S01007030,633,26,14,12,130,27,109,88,93,154,6,4,2,0
S01007031,479,28,4,24,83,13,75,77,105,86,11,3,8,1
S01007032,731,43,11,32,142,50,69,89,172,135,27,12,15,4
S01007033,589,21,4,17,96,49,24,92,129,164,10,7,3,4
S01007034,496,35,13,22,107,32,45,65,95,96,14,4,10,7
S01007035,597,22,16,6,54,33,50,63,167,194,10,3,7,4
S01007036,717,77,27,50,170,37,116,122,95,81,3,3,0,16
S01007037,785,36,15,21,105,96,79,114,124,207,20,6,14,4
S01007038,642,24,9,15,115,52,70,78,142,140,14,3,11,7
S01007039,699,30,18,12,121,37,83,126,105,169,15,5,10,13
S01007040,500,33,16,17,51,38,58,72,112,114,13,7,6,9
S01007041,554,36,8,28,126,25,93,104,87,60,22,16,6,1
S01007042,573,58,11,47,83,49,91,107,64,101,20,9,11,0
S01007043,810,102,23,79,153,43,223,120,91,69,9,2,7,0
S01007044,484,41,9,32,89,24,136,71,58,52,3,1,2,10
S01007045,628,73,8,65,132,34,190,80,65,50,4,0,4,0
S01007046,461,21,0,21,100,24,78,80,77,78,3,3,0,0
S01007047,525,30,5,25,113,46,121,86,51,75,3,0,3,0
S01007048,685,72,18,54,128,34,160,100,85,93,9,8,1,4
S01007049,759,39,12,27,138,65,72,117,140,167,20,7,13,1
S01007050,493,65,25,40,85,24,95,82,62,71,8,8,0,1
S01007051,633,76,23,53,109,59,80,129,65,97,15,11,4,3
S01007052,465,43,16,27,73,48,76,86,58,75,4,1,3,2
S01007053,406,64,22,42,84,39,67,88,26,37,0,0,0,1
S01007054,729,59,15,44,125,39,90,137,102,153,18,3,15,6
S01007055,437,49,15,34,82,23,145,48,34,49,2,1,1,5
S01007056,533,71,14,57,124,32,147,50,58,33,6,5,1,12
S01007057,355,25,4,21,89,59,32,65,38,45,2,2,0,0
S01007058,376,25,5,20,75,49,46,75,39,60,1,0,1,6
S01007059,816,101,29,72,174,85,89,132,107,114,12,5,7,2
S01007060,501,19,4,15,71,39,32,110,83,114,25,4,21,8
S01007061,826,138,28,110,252,77,127,108,66,50,8,1,7,0
S01007062,548,109,34,75,103,25,142,81,41,43,2,2,0,2
S01007063,536,58,8,50,139,28,92,75,50,89,0,0,0,5
S01007064,528,74,9,65,101,50,126,67,42,63,3,3,0,2
S01007065,467,76,19,57,153,48,60,51,28,45,3,3,0,3
S01007066,551,86,25,61,138,17,94,82,37,77,5,2,3,15
S01007067,443,56,21,35,126,56,27,92,32,44,4,0,4,6
S01007068,557,89,28,61,118,51,82,90,48,56,15,9,6,8
S01007069,724,56,25,31,154,81,69,106,119,97,20,11,9,22
S01007070,403,12,2,10,86,49,38,65,78,66,8,1,7,1
S01007071,707,91,22,69,190,62,54,109,90,94,13,1,12,4
S01007072,571,61,33,28,142,62,79,98,66,53,5,0,5,5
S01007073,722,67,15,52,159,81,109,124,78,100,0,0,0,4
S01007074,561,35,8,27,83,52,57,88,119,111,13,5,8,3
S01007075,597,30,2,28,81,75,27,105,97,162,11,7,4,9
S01007076,677,39,9,30,115,58,59,132,106,151,12,12,0,5
S01007077,486,37,12,25,97,37,32,95,106,74,3,1,2,5
S01007078,633,58,32,26,82,51,70,127,65,136,33,12,21,11
S01007079,710,50,12,38,140,48,62,122,132,133,16,10,6,7
S01007080,577,27,18,9,103,70,47,102,107,81,27,2,25,13
S01007081,818,37,20,17,113,30,101,131,140,238,26,16,10,2
S01007082,483,19,0,19,83,14,42,110,92,107,13,6,7,3
S01007083,692,15,2,13,82,43,35,100,142,226,30,19,11,19
S01007084,403,35,13,22,92,47,46,68,64,48,1,1,0,2
S01007085,661,69,20,49,122,42,48,117,112,116,27,4,23,8
S01007086,1024,34,8,26,121,47,52,122,235,320,59,21,38,34
S01007087,722,44,3,41,57,36,60,100,161,211,41,29,12,12
S01007088,458,16,2,14,31,20,30,74,115,136,28,11,17,8
S01007089,433,62,33,29,111,27,68,92,43,28,2,0,2,0
S01007090,467,31,14,17,132,52,43,75,67,64,3,1,2,0
S01007091,794,67,25,42,139,63,56,159,109,171,19,8,11,11
S01007092,446,22,11,11,84,38,27,86,76,98,7,2,5,8
S01007093,761,100,22,78,184,81,83,151,79,76,4,2,2,3
S01007094,694,62,17,45,191,44,112,117,74,91,0,0,0,3
S01007095,452,77,24,53,108,23,97,62,46,33,6,4,2,0
S01007096,725,109,25,84,169,41,111,145,56,83,2,0,2,9
S01007097,420,70,22,48,77,17,86,75,45,49,1,0,1,0
S01007098,692,85,42,43,189,21,165,106,78,44,0,0,0,4
S01007099,753,58,26,32,204,45,185,120,58,79,4,0,4,0
S01007100,591,52,17,35,156,39,83,109,55,73,8,2,6,16
S01007101,663,32,5,27,106,30,52,93,131,195,22,12,10,2
S01007102,569,45,19,26,104,29,119,115,81,61,10,7,3,5
S01007103,673,55,21,34,137,32,125,129,88,105,0,0,0,2
S01007104,376,49,9,40,46,36,115,26,67,35,2,2,0,0
S01007105,401,41,4,37,101,29,63,66,37,57,6,4,2,1
S01007106,545,33,6,27,120,36,94,83,87,61,28,14,14,3
S01007107,576,70,34,36,141,34,130,85,38,62,1,0,1,15
S01007108,463,43,15,28,93,11,140,59,59,52,5,1,4,1
S01007109,660,22,15,7,95,39,72,76,112,212,21,11,10,11
S01007110,670,57,37,20,111,55,84,125,91,124,23,5,18,0
S01007111,412,25,10,15,79,26,59,91,62,55,8,5,3,7
S01007112,395,36,9,27,69,15,97,74,39,52,10,6,4,3
S01007113,373,59,20,39,88,17,69,60,49,30,1,0,1,0
S01007114,676,42,2,40,108,71,61,144,99,144,2,2,0,5
S01007115,514,56,28,28,120,26,58,110,57,68,9,9,0,10
S01007116,932,127,42,85,230,51,189,179,95,43,12,4,8,6
S01007117,385,58,35,23,80,14,74,71,42,43,0,0,0,3
S01007118,602,11,2,9,68,39,50,97,135,163,34,15,19,5
S01007119,696,18,7,11,83,27,59,153,116,188,29,11,18,23
S01007120,916,29,13,16,133,25,53,177,203,238,53,15,38,5
S01007121,361,10,4,6,53,24,41,40,72,107,7,1,6,7
S01007122,487,41,13,28,112,34,61,86,63,78,7,6,1,5
S01007123,472,17,11,6,75,41,31,76,55,154,10,7,3,13
S01007124,726,53,22,31,122,39,95,148,106,150,7,0,7,6
S01007125,724,52,9,43,81,28,61,74,167,231,16,10,6,14
S01007126,814,10,0,10,74,24,59,136,167,250,69,35,34,25
S01007127,906,44,24,20,72,40,65,128,203,296,43,6,37,15
S01007128,638,5,0,5,77,43,49,142,119,153,35,10,25,15
S01007129,825,264,37,227,283,85,78,34,41,34,6,3,3,0
S01007130,441,84,13,71,134,55,46,43,40,34,2,1,1,3
S01007131,603,85,31,54,198,85,55,71,49,50,5,2,3,5
S01007132,532,114,10,104,150,74,47,62,41,42,2,1,1,0
S01007133,552,112,10,102,130,54,123,60,30,41,1,1,0,1
S01007134,599,111,22,89,134,51,109,72,49,68,4,4,0,1
S01007135,468,108,24,84,131,45,105,25,23,28,1,1,0,2
S01007136,470,152,28,124,113,33,106,28,16,10,4,0,4,8
S01007137,730,192,47,145,257,45,97,70,43,24,2,0,2,0
S01007138,493,75,9,66,163,43,88,53,32,26,6,1,5,7
S01007139,613,76,23,53,133,70,108,85,88,46,7,0,7,0
S01007140,829,129,32,97,297,56,150,69,40,74,3,0,3,11
S01007141,573,103,33,70,142,53,113,49,55,53,0,0,0,5
S01007142,561,161,40,121,213,64,50,29,24,20,0,0,0,0
S01007143,655,119,35,84,227,63,63,100,46,36,1,0,1,0
S01007144,484,66,10,56,149,29,119,26,51,32,12,9,3,0
S01007145,615,88,18,70,192,86,95,34,53,51,13,10,3,3
S01007146,560,92,14,78,193,74,57,54,41,34,3,0,3,12
S01007147,520,56,10,46,178,74,36,55,61,41,12,4,8,7
S01007148,435,90,12,78,120,55,43,36,48,35,8,0,8,0
S01007149,373,41,8,33,120,65,29,52,27,38,1,1,0,0
S01007150,380,70,15,55,146,41,58,25,27,7,1,1,0,5
S01007151,703,142,33,109,225,91,75,65,78,25,2,0,2,0
S01007152,412,81,31,50,145,56,42,36,30,18,1,1,0,3
S01007153,469,50,16,34,167,80,51,45,31,37,2,2,0,6
S01007154,506,53,12,41,181,83,26,25,74,43,10,7,3,11
S01007155,441,64,15,49,159,63,43,40,38,29,2,1,1,3
S01007156,596,44,9,35,161,62,56,69,107,79,11,9,2,7
S01007157,558,19,3,16,126,82,48,97,95,79,4,1,3,8
S01007158,819,81,19,62,238,120,52,132,99,64,21,6,15,12
S01007159,658,28,9,19,135,89,58,69,112,139,18,4,14,10
S01007160,635,36,11,25,145,61,47,102,116,104,21,10,11,3
S01007161,557,54,18,36,147,77,59,67,72,60,19,14,5,2
S01007162,405,44,13,31,114,51,22,45,53,55,10,4,6,11
S01007163,608,85,23,62,173,108,48,56,80,48,5,5,0,5
S01007164,401,49,4,45,135,34,38,34,43,61,1,0,1,6
S01007165,622,112,25,87,211,61,76,52,44,40,11,5,6,15
S01007166,519,90,20,70,164,64,37,64,32,56,8,4,4,4
S01007167,611,104,31,73,194,62,73,59,45,55,4,0,4,15
S01007168,729,154,29,125,234,99,79,57,50,54,0,0,0,2
S01007169,589,109,18,91,187,54,45,69,60,52,8,2,6,5
S01007170,540,64,22,42,92,50,130,72,61,48,17,7,10,6
S01007171,649,75,15,60,122,43,144,57,120,74,9,1,8,5
S01007172,599,127,24,103,163,23,98,69,80,35,2,0,2,2
S01007173,803,69,13,56,248,138,80,89,109,56,6,3,3,8
S01007174,787,78,27,51,195,95,95,102,115,68,35,23,12,4
S01007175,449,59,30,29,124,42,33,29,93,64,0,0,0,5
S01007176,555,54,21,33,157,83,51,72,76,41,16,0,16,5
S01007177,487,20,7,13,96,52,28,50,114,92,26,6,20,9
S01007178,870,29,5,24,135,95,84,100,201,163,57,22,35,6
S01007179,684,102,28,74,232,66,67,82,60,73,0,0,0,2
S01007180,503,60,28,32,181,63,65,24,61,41,5,4,1,3
S01007181,550,82,23,59,175,62,107,56,29,20,11,1,10,8
S01007182,786,113,38,75,188,89,72,96,103,101,17,5,12,7
S01007183,776,79,31,48,174,66,65,104,142,123,14,6,8,9
S01007184,812,38,2,36,225,56,57,123,146,121,26,8,18,20
S01007185,672,33,8,25,113,77,59,68,89,170,51,26,25,12
S01007186,523,23,3,20,61,50,42,61,96,121,55,24,31,14
S01007187,607,42,13,29,131,55,52,70,112,114,13,1,12,18
S01007188,516,25,3,22,83,36,75,85,84,85,31,13,18,12
S01007189,544,27,6,21,107,68,46,68,103,81,35,22,13,9
S01007190,530,30,13,17,120,47,87,56,87,90,8,7,1,5
S01007191,500,23,0,23,79,38,53,50,113,110,22,5,17,12
S01007192,500,23,11,12,48,36,44,67,139,113,23,15,8,7
S01007193,640,23,11,12,82,28,94,86,136,166,23,4,19,2
S01007194,542,9,2,7,47,53,25,75,138,111,81,43,38,3
S01007195,472,21,5,16,77,20,52,47,112,103,35,16,19,5
S01007196,709,21,5,16,112,84,56,116,170,121,23,8,15,6
S01007197,581,12,0,12,83,36,41,93,127,130,50,16,34,9
S01007198,454,12,8,4,67,32,40,67,76,97,53,22,31,10
S01007199,704,33,14,19,56,55,25,96,160,149,102,55,47,28
S01007200,710,22,5,17,138,46,51,115,142,166,26,8,18,4
S01007201,559,37,9,28,117,53,49,81,61,138,18,3,15,5
S01007202,602,29,1,28,94,48,51,79,140,111,45,18,27,5
S01007203,537,24,4,20,115,50,52,90,93,93,13,4,9,7
S01007204,810,72,19,53,236,59,127,116,75,102,11,9,2,12
S01007205,548,71,13,58,119,36,108,54,82,71,2,2,0,5
S01007206,295,13,0,13,76,11,33,39,62,44,11,5,6,6
S01007207,704,57,14,43,184,61,76,124,97,82,15,3,12,8
S01007208,828,60,21,39,150,100,39,110,131,160,57,14,43,21
S01007209,574,36,6,30,164,58,71,46,70,92,31,18,13,6
S01007210,646,18,0,18,108,46,45,122,131,130,41,30,11,5
S01007211,772,23,10,13,170,55,58,119,158,131,41,21,20,17
S01007212,451,31,5,26,127,36,39,61,68,68,17,5,12,4
S01007213,644,74,8,66,207,60,57,80,95,57,6,2,4,8
S01007214,524,38,3,35,119,56,44,47,101,85,26,14,12,8
S01007215,608,50,5,45,119,57,42,102,82,105,31,15,16,20
S01007216,530,70,18,52,134,63,35,88,61,60,16,13,3,3
S01007217,761,63,24,39,137,63,61,111,152,130,34,11,23,10
S01007218,678,121,38,83,193,70,66,74,84,60,6,1,5,4
S01007219,642,29,20,9,142,51,75,87,97,130,28,14,14,3
S01007220,593,19,4,15,81,72,54,116,96,133,20,16,4,2
S01007221,551,93,18,75,162,50,62,87,33,49,2,2,0,13
S01007222,690,56,22,34,126,42,62,107,139,131,24,10,14,3
S01007223,435,94,29,65,117,32,38,61,42,43,8,5,3,0
S01007224,451,77,22,55,122,28,54,66,40,59,3,0,3,2
S01007225,722,108,31,77,193,54,123,97,69,58,15,11,4,5
S01007226,635,96,19,77,162,18,157,71,92,28,11,4,7,0
S01007227,741,94,22,72,174,55,101,96,101,99,13,7,6,8
S01007228,534,50,15,35,139,28,155,57,54,45,3,2,1,3
S01007229,902,93,35,58,217,64,205,107,90,107,18,7,11,1
S01007230,623,16,10,6,56,41,52,90,168,162,25,9,16,13
S01007231,540,23,7,16,71,36,25,80,124,126,46,19,27,9
S01007232,573,23,6,17,54,50,34,79,137,114,67,28,39,15
S01007233,647,62,7,55,131,61,72,86,85,121,26,16,10,3
S01007234,476,28,14,14,103,31,38,47,90,120,18,1,17,1
S01007235,575,43,18,25,129,41,56,75,93,109,24,4,20,5
S01007236,487,63,25,38,90,51,54,73,64,69,10,2,8,13
S01007237,536,51,25,26,130,51,66,79,89,54,11,0,11,5
S01007238,695,44,13,31,154,78,51,108,102,132,17,3,14,9
S01007239,578,128,45,83,140,62,71,75,37,58,3,2,1,4
S01007240,431,45,10,35,113,22,98,40,71,39,0,0,0,3
S01007241,491,87,25,62,79,48,109,70,51,43,4,0,4,0
S01007242,757,67,13,54,213,66,97,106,86,95,20,7,13,7
S01007243,446,61,18,43,149,42,67,48,30,38,11,3,8,0
S01007244,548,75,22,53,153,33,97,63,49,74,3,0,3,1
S01007245,497,26,6,20,126,47,124,58,69,42,2,0,2,3
S01007246,482,46,12,34,90,50,100,45,34,108,5,4,1,4
S01007247,530,69,15,54,134,32,83,49,87,71,3,2,1,2
S01007248,566,81,21,60,174,65,77,83,30,51,1,0,1,4
S01007249,286,37,14,23,71,48,39,18,29,33,10,6,4,1
S01007250,659,62,14,48,156,77,71,63,94,110,23,7,16,3
S01007251,392,25,5,20,87,37,51,30,74,81,2,1,1,5
S01007252,659,53,20,33,103,55,96,109,94,123,14,7,7,12
S01007253,570,72,25,47,158,62,58,84,49,70,8,0,8,9
S01007254,603,33,9,24,119,59,38,78,106,127,35,27,8,8
S01007255,686,25,6,19,104,48,35,97,145,170,59,19,40,3
S01007256,655,41,16,25,111,41,44,85,158,145,21,4,17,9
S01007257,491,20,2,18,63,25,54,53,118,104,35,15,20,19
S01007258,685,52,11,41,130,21,87,99,154,100,31,21,10,11
S01007259,638,33,4,29,109,41,49,91,120,159,31,14,17,5
S01007260,760,37,14,23,116,68,45,84,152,169,62,31,31,27
S01007261,564,91,36,55,147,47,61,62,50,93,13,4,9,0
S01007262,559,11,1,10,107,37,15,102,115,139,24,11,13,9
S01007263,578,31,6,25,102,69,33,80,96,128,16,4,12,23
S01007264,534,63,14,49,154,52,34,55,84,84,7,3,4,1
S01007265,857,48,17,31,168,97,67,116,141,182,24,9,15,14
S01007266,526,38,8,30,134,56,47,76,67,102,6,2,4,0
S01007267,414,71,8,63,87,14,102,41,52,34,4,0,4,9
S01007268,488,79,14,65,104,22,121,55,46,47,8,0,8,6
S01007269,386,70,19,51,113,36,42,51,24,36,3,2,1,11
S01007270,360,36,3,33,99,16,103,26,50,28,2,0,2,0
S01007271,741,75,10,65,182,77,115,116,66,84,17,6,11,9
S01007272,682,19,6,13,113,49,55,90,144,163,32,19,13,17
S01007273,521,49,24,25,126,42,52,74,73,78,14,2,12,13
S01007274,609,74,13,61,165,51,47,66,83,102,13,4,9,8
S01007275,409,60,2,58,111,32,45,29,48,78,5,4,1,1
S01007276,667,79,20,59,146,75,52,80,94,106,22,17,5,13
S01007277,551,97,26,71,172,44,56,58,71,44,4,0,4,5
S01007278,424,61,19,42,155,39,35,48,46,35,2,2,0,3
S01007279,431,95,23,72,93,4,130,25,48,31,5,1,4,0
S01007280,463,60,15,45,96,46,94,55,49,48,8,0,8,7
S01007281,762,93,35,58,159,83,163,109,91,57,5,0,5,2
S01007282,459,48,19,29,67,13,127,87,62,41,11,4,7,3
S01007283,670,144,28,116,174,33,100,86,55,68,4,2,2,6
S01007284,641,30,3,27,140,100,176,58,69,63,2,1,1,3
S01007285,606,31,1,30,137,36,220,57,91,30,4,0,4,0
S01007286,738,44,11,33,207,54,174,89,85,80,5,0,5,0
S01007287,427,34,6,28,75,26,158,52,47,18,15,1,14,2
S01007288,399,34,9,25,87,27,133,44,19,47,8,1,7,0
S01007289,635,68,24,44,203,68,96,80,83,32,0,0,0,5
S01007290,765,47,11,36,156,57,124,77,141,138,23,5,18,2
S01007291,481,36,4,32,107,55,42,69,60,84,15,5,10,13
S01007292,641,37,12,25,187,65,106,71,93,77,5,1,4,0
S01007293,702,28,3,25,118,24,62,95,175,165,33,15,18,2
S01007294,706,38,16,22,141,52,121,118,107,100,13,11,2,16
S01007295,418,18,1,17,65,24,31,61,92,89,31,26,5,7
S01007296,416,36,2,34,75,24,53,74,66,62,14,3,11,12
S01007297,721,105,15,90,209,56,120,79,65,65,12,5,7,10
S01007298,404,25,3,22,115,38,48,54,52,61,2,0,2,9
S01007299,662,44,12,32,134,43,82,129,90,104,15,5,10,21
S01007300,369,9,2,7,52,46,49,61,66,65,20,8,12,1
S01007301,530,104,25,79,129,31,103,48,46,60,4,0,4,5
S01007302,500,35,7,28,103,37,80,81,99,47,6,3,3,12
S01007303,675,79,19,60,178,43,157,86,74,39,10,8,2,9
S01007304,447,45,13,32,115,31,115,49,50,38,2,0,2,2
S01007305,575,106,25,81,134,26,126,66,56,56,5,3,2,0
S01007306,580,76,18,58,145,43,113,62,68,57,8,6,2,8
S01007307,610,95,23,72,162,56,164,52,48,29,4,1,3,0
S01007308,567,54,21,33,151,40,104,61,98,49,10,1,9,0
S01007309,482,71,20,51,134,35,88,28,69,51,2,0,2,4
S01007310,563,69,13,56,97,37,159,64,74,49,9,2,7,5
S01007311,572,37,14,23,101,23,132,82,100,93,4,0,4,0
S01007312,558,52,7,45,163,53,98,76,47,57,10,3,7,2
S01007313,705,89,17,72,241,46,171,47,39,68,4,4,0,0
S01007314,528,54,9,45,154,58,81,53,54,52,12,4,8,10
S01007315,743,115,43,72,217,92,77,72,72,84,14,4,10,0
S01007316,647,52,21,31,179,60,82,65,85,93,28,6,22,3
S01007317,561,54,15,39,195,63,50,54,57,72,14,3,11,2
S01007318,493,30,8,22,94,54,91,51,84,65,20,3,17,4
S01007319,540,54,12,42,161,50,90,56,37,69,14,3,11,9
S01007320,530,75,39,36,175,40,118,45,54,18,0,0,0,5
S01007321,405,54,20,34,108,18,110,27,55,31,2,0,2,0
S01007322,550,24,2,22,120,59,131,47,42,108,10,3,7,9
S01007323,340,10,5,5,72,35,84,48,25,64,0,0,0,2
S01007324,255,49,36,13,57,7,41,23,44,26,8,2,6,0
S01007325,610,34,13,21,125,52,187,65,89,53,3,1,2,2
S01007326,539,28,12,16,106,19,129,88,111,52,6,2,4,0
S01007327,558,38,3,35,108,32,80,83,90,105,13,4,9,9
S01007328,635,37,15,22,83,45,140,44,194,67,25,4,21,0
S01007329,526,30,13,17,124,31,149,57,61,55,15,7,8,4
S01007330,484,23,7,16,114,27,155,39,83,35,8,3,5,0
S01007331,768,35,2,33,155,76,224,75,97,97,7,0,7,2
S01007332,357,32,4,28,86,6,156,15,22,29,10,5,5,1
S01007333,571,55,10,45,154,52,102,40,85,65,14,6,8,4
S01007334,574,22,7,15,61,53,50,60,136,132,50,24,26,10
S01007335,613,6,0,6,104,68,54,96,100,148,33,23,10,4
S01007336,413,20,12,8,83,49,68,36,73,53,28,15,13,3
S01007337,438,23,15,8,80,57,64,59,75,64,11,3,8,5
S01007338,581,26,8,18,100,75,61,125,67,122,5,1,4,0
S01007339,413,24,4,20,129,41,68,63,45,41,2,1,1,0
S01007340,324,22,5,17,68,30,43,51,39,60,11,6,5,0
S01007341,471,38,14,24,78,49,96,47,60,78,24,16,8,1
S01007342,558,96,13,83,174,45,116,43,49,27,7,3,4,1
S01007343,440,38,8,30,62,23,167,55,57,34,0,0,0,4
S01007344,270,18,4,14,62,34,49,28,39,35,2,2,0,3
S01007345,480,6,5,1,62,68,62,58,99,79,40,17,23,6
S01007346,376,14,5,9,76,42,35,32,68,70,33,12,21,6
S01007347,422,21,14,7,71,37,48,29,90,90,24,9,15,12
S01007348,473,11,0,11,61,79,60,65,94,81,16,8,8,6
S01007349,390,12,7,5,69,63,36,45,78,56,23,15,8,8
S01007350,373,13,3,10,77,33,60,42,56,69,23,10,13,0
S01007351,403,19,1,18,91,21,132,52,48,31,5,2,3,4
S01007352,346,34,12,22,75,30,115,29,33,21,6,0,6,3
S01007353,443,49,22,27,117,49,88,46,38,50,6,2,4,0
S01007354,491,53,19,34,143,77,81,22,50,51,12,1,11,2
S01007355,632,60,13,47,182,28,161,42,87,53,16,7,9,3
S01007356,481,66,14,52,130,26,78,27,74,65,11,3,8,4
S01007357,547,65,17,48,148,33,118,57,62,56,8,0,8,0
S01007358,709,73,24,49,182,96,96,90,95,59,16,4,12,2
S01007359,610,37,19,18,127,68,62,56,122,103,35,10,25,0
S01007360,311,30,12,18,116,25,35,25,41,29,7,0,7,3
S01007361,650,65,23,42,174,74,124,59,75,54,15,4,11,10
S01007362,507,28,8,20,150,48,64,27,90,71,11,1,10,18
S01007363,429,26,8,18,104,61,46,54,45,77,13,3,10,3
S01007364,757,15,0,15,122,105,52,52,196,144,52,21,31,19
S01007365,364,15,0,15,62,28,45,40,84,76,11,8,3,3
S01007366,329,13,0,13,52,19,27,46,49,94,23,18,5,6
S01007367,413,41,8,33,55,34,60,43,80,72,26,11,15,2
S01007368,464,12,6,6,79,67,38,60,66,98,29,2,27,15
S01007369,648,25,13,12,155,64,82,45,155,85,30,9,21,7
S01007370,617,50,4,46,137,52,66,106,96,89,18,9,9,3
S01007371,589,38,7,31,144,63,88,57,104,69,21,7,14,5
S01007372,569,57,7,50,173,54,85,64,77,47,10,1,9,2
S01007373,433,81,19,62,124,42,82,50,26,22,5,3,2,1
S01007374,437,52,15,37,115,49,67,54,42,54,3,0,3,1
S01007375,332,78,44,34,85,28,53,24,29,29,5,1,4,1
S01007376,701,31,4,27,143,80,56,84,125,122,58,21,37,2
S01007377,536,78,19,59,225,60,53,44,29,32,4,2,2,11
S01007378,423,91,21,70,133,58,64,23,22,25,5,3,2,2
S01007379,352,15,2,13,64,50,16,63,61,64,17,2,15,2
S01007380,508,56,20,36,109,64,24,66,84,91,14,1,13,0
S01007381,343,145,79,66,95,25,35,7,11,20,0,0,0,5
S01007382,522,113,35,78,181,55,61,26,30,39,11,0,11,6
S01007383,543,108,27,81,185,52,67,47,51,25,8,7,1,0
S01007384,673,164,110,54,204,83,34,33,79,54,21,5,16,1
S01007385,564,76,17,59,178,66,59,42,66,54,12,3,9,11
S01007386,588,194,35,159,189,44,82,29,39,7,2,1,1,2
S01007387,622,209,51,158,223,23,67,43,23,31,0,0,0,3
S01007388,531,141,55,86,175,79,47,19,36,26,4,0,4,4
S01007389,574,21,2,19,243,87,20,47,109,29,16,2,14,2
S01007390,560,27,6,21,205,128,17,58,49,52,17,14,3,7
S01007391,446,84,25,59,169,64,39,39,26,20,2,0,2,3
S01007392,315,79,24,55,96,48,28,19,22,21,1,1,0,1
S01007393,442,157,34,123,115,29,61,18,33,24,3,2,1,2
S01007394,384,100,30,70,143,39,32,27,27,10,6,1,5,0
S01007395,594,35,7,28,149,84,61,72,100,51,26,11,15,16
S01007396,585,48,12,36,153,70,46,65,100,61,26,12,14,16
S01007397,687,142,32,110,212,70,70,56,63,47,11,3,8,16
S01007398,619,8,4,4,62,48,52,77,132,211,27,15,12,2
S01007399,568,31,6,25,116,36,37,53,103,104,81,35,46,7
S01007400,512,77,23,54,139,85,50,40,50,63,7,2,5,1
S01007401,531,56,12,44,183,72,47,48,61,46,15,10,5,3
S01007402,457,64,17,47,132,61,50,44,59,34,7,7,0,6
S01007403,795,69,30,39,456,106,40,28,44,42,8,6,2,2
S01007404,310,51,10,41,70,25,69,47,23,23,2,0,2,0
S01007405,552,127,23,104,187,64,100,18,21,27,8,5,3,0
S01007406,466,110,27,83,180,65,55,13,15,22,4,0,4,2
S01007407,536,111,33,78,168,51,69,47,43,38,7,6,1,2
S01007408,490,36,7,29,120,62,58,92,55,48,19,5,14,0
S01007409,554,56,9,47,98,74,53,93,88,75,13,8,5,4
S01007410,582,8,5,3,49,34,47,96,134,152,58,32,26,4
S01007411,744,34,13,21,97,85,63,75,124,174,75,46,29,17
S01007412,373,16,0,16,47,37,27,49,61,125,11,3,8,0
S01007413,835,82,22,60,215,114,74,142,95,89,16,9,7,8
S01007414,641,149,45,104,206,60,46,88,32,34,7,0,7,19
S01007415,714,27,3,24,72,53,41,99,144,234,33,10,23,11
S01007416,553,11,2,9,44,40,34,59,139,150,65,35,30,11
S01007417,870,131,25,106,294,127,73,95,55,66,19,2,17,10
S01007418,559,15,0,15,78,59,27,61,135,139,34,18,16,11
S01007419,782,17,3,14,77,106,50,65,179,198,66,29,37,24
S01007420,716,115,17,98,189,100,65,79,59,84,17,6,11,8
S01007421,562,101,10,91,147,42,54,48,81,69,15,10,5,5
S01007422,464,54,16,38,119,63,50,80,48,40,5,1,4,5
S01007423,645,98,27,71,214,62,43,76,69,62,12,7,5,9
S01007424,592,99,17,82,219,64,33,49,59,66,0,0,0,3
S01007425,703,86,14,72,195,51,43,110,90,95,21,7,14,12
S01007426,518,43,2,41,86,38,47,49,114,72,23,7,16,46
S01007427,487,30,13,17,81,45,35,62,80,105,37,2,35,12
S01007428,694,29,13,16,195,87,65,68,88,117,30,7,23,15
S01007429,608,57,5,52,173,55,54,63,95,84,23,5,18,4
S01007430,343,45,11,34,80,35,43,56,47,27,5,0,5,5
S01007431,455,68,22,46,149,50,45,51,56,31,5,0,5,0
S01007432,608,45,11,34,161,80,49,73,104,86,8,1,7,2
S01007433,618,102,27,75,153,44,79,44,90,87,16,3,13,3
S01007434,426,16,3,13,77,38,41,55,73,102,17,6,11,7
S01007435,536,51,15,36,104,71,51,63,64,99,22,9,13,11
S01007436,565,38,10,28,83,52,25,53,114,129,47,28,19,24
S01007437,370,33,4,29,78,45,29,32,71,47,29,15,14,6
S01007438,505,38,7,31,98,55,32,73,78,89,36,16,20,6
S01007439,520,51,10,41,129,57,55,71,71,67,13,1,12,6
S01007440,521,36,10,26,103,46,49,82,105,83,9,4,5,8
S01007441,445,59,19,40,121,57,29,72,65,38,0,0,0,4
S01007442,373,109,25,84,115,34,47,30,25,12,1,1,0,0
S01007443,600,175,26,149,160,36,66,53,40,49,9,4,5,12
S01007444,718,222,60,162,228,31,90,45,51,32,6,3,3,13
S01007445,501,175,42,133,189,34,43,22,23,12,2,0,2,1
S01007446,438,171,39,132,145,29,44,16,19,7,4,0,4,3
S01007447,362,111,24,87,111,8,68,30,10,19,2,1,1,3
S01007448,661,109,26,83,155,69,109,61,63,83,12,4,8,0
S01007449,786,55,17,38,121,67,55,81,167,149,76,29,47,15
S01007450,645,30,13,17,92,53,47,81,120,131,78,38,40,13
S01007451,473,46,12,34,95,61,42,43,103,74,4,1,3,5
S01007452,433,40,3,37,70,37,60,36,70,87,30,10,20,3
S01007453,614,102,30,72,242,59,59,83,43,19,7,4,3,0
S01007454,425,20,10,10,72,27,43,47,85,108,23,14,9,0
S01007455,724,19,7,12,128,75,20,72,173,153,78,45,33,6
S01007456,746,7,0,7,100,58,50,68,202,192,52,28,24,17
S01007457,900,62,17,45,159,80,80,151,123,155,67,22,45,23
S01007458,403,44,18,26,92,54,27,92,37,45,3,0,3,9
S01007459,447,28,3,25,113,62,46,73,46,65,10,4,6,4
S01007460,565,23,7,16,95,41,58,96,106,101,36,23,13,9
S01007461,573,14,6,8,53,45,41,73,130,127,83,50,33,7
S01007462,679,49,6,43,131,68,79,76,122,121,33,12,21,0
S01007463,854,25,9,16,46,58,67,70,243,201,131,65,66,13
S01007464,562,17,7,10,61,39,19,56,155,163,45,28,17,7
S01007465,668,15,5,10,36,45,28,54,142,199,139,82,57,10
S01007466,826,44,5,39,107,63,50,75,180,184,84,53,31,39
S01007467,756,54,12,42,163,83,42,111,127,118,37,18,19,21
S01007468,602,76,34,42,123,76,56,111,77,73,7,6,1,3
S01007469,520,27,17,10,62,50,27,89,123,91,43,21,22,8
S01007470,552,41,11,30,96,62,32,64,104,85,61,35,26,7
S01007471,420,33,10,23,79,40,18,55,68,89,34,5,29,4
S01007472,419,10,0,10,56,32,31,41,108,113,24,5,19,4
S01007473,357,12,4,8,72,43,10,47,71,81,16,10,6,5
S01007474,451,61,16,45,103,60,56,67,66,38,0,0,0,0
S01007475,512,83,21,62,145,57,36,77,55,43,13,3,10,3
S01007476,447,65,14,51,108,52,36,63,67,47,3,1,2,6
S01007477,438,89,7,82,113,63,45,55,27,37,8,2,6,1
S01007478,720,125,18,107,215,66,76,62,88,65,13,3,10,10
S01007479,515,39,1,38,125,95,19,80,72,73,8,6,2,4
S01007480,702,59,14,45,175,72,56,112,118,95,12,5,7,3
S01007481,504,74,29,45,132,51,83,67,50,44,0,0,0,3
S01007482,312,14,3,11,70,25,30,47,64,42,18,13,5,2
S01007483,622,12,2,10,85,45,106,103,81,159,24,9,15,7
S01007484,420,11,2,9,76,13,57,60,82,78,32,10,22,11
S01007485,420,0,0,0,27,11,24,50,121,124,53,23,30,10
S01007486,465,3,3,0,37,34,24,49,109,133,72,34,38,4
S01007487,713,13,0,13,107,51,76,94,140,158,60,37,23,14
S01007488,824,38,5,33,177,87,119,88,117,151,34,11,23,13
S01007489,630,42,15,27,92,72,100,64,92,132,23,11,12,13
S01007490,644,27,7,20,79,52,72,106,128,151,27,15,12,2
S01007491,1006,27,6,21,153,95,91,115,234,217,67,28,39,7
S01007492,521,26,11,15,97,57,53,71,90,102,23,8,15,2
S01007493,665,19,8,11,102,70,51,112,109,161,33,14,19,8
S01007494,392,33,4,29,69,21,113,34,83,23,13,9,4,3
S01007495,676,39,6,33,130,54,223,65,84,69,4,2,2,8
S01007496,694,40,17,23,179,42,214,52,98,55,9,4,5,5
S01007497,464,16,4,12,59,20,123,51,81,87,24,20,4,3
S01007498,589,33,3,30,95,60,100,76,98,105,18,16,2,4
S01007499,673,30,11,19,102,49,166,71,105,117,19,4,15,14
S01007500,433,15,0,15,43,27,104,65,98,59,22,4,18,0
S01007501,461,19,3,16,82,31,167,28,73,39,22,2,20,0
S01007502,402,17,5,12,82,11,125,58,49,56,2,0,2,2
S01007503,762,30,9,21,126,35,236,63,113,119,35,10,25,5
S01007504,496,35,4,31,95,28,167,42,57,51,17,8,9,4
S01007505,348,32,10,22,42,28,117,27,50,37,11,7,4,4
S01007506,337,25,5,20,80,12,139,35,27,19,0,0,0,0
S01007507,654,45,4,41,69,37,205,39,104,133,19,12,7,3
S01007508,512,26,2,24,88,25,145,54,85,73,16,8,8,0
S01007509,450,35,1,34,79,31,153,24,76,34,14,2,12,4
S01007510,671,40,0,40,125,29,204,75,117,53,25,10,15,3
S01007511,628,6,0,6,55,41,140,42,160,134,30,21,9,20
S01007512,374,15,0,15,89,10,144,23,55,25,8,1,7,5
S01007513,854,35,15,20,132,69,117,99,185,156,61,31,30,0
S01007514,397,22,6,16,56,49,60,63,63,59,18,8,10,7
S01007515,393,42,9,33,126,41,50,45,44,38,3,1,2,4
S01007516,503,26,3,23,60,18,73,66,140,97,21,7,14,2
S01007517,261,28,6,22,49,17,55,28,53,22,9,8,1,0
S01007518,617,13,0,13,82,35,98,96,96,145,45,21,24,7
S01007519,273,35,9,26,65,7,82,22,29,27,6,1,5,0
S01007520,698,57,16,41,120,52,143,55,142,90,29,13,16,10
S01007521,342,32,14,18,55,19,86,50,86,11,3,0,3,0
S01007522,600,55,12,43,111,33,127,89,92,64,25,10,15,4
S01007523,397,48,13,35,69,33,105,27,56,47,9,4,5,3
S01007524,668,66,11,55,111,44,201,59,85,82,20,10,10,0
S01007525,359,18,10,8,77,29,72,50,75,34,4,1,3,0
S01007526,499,24,10,14,101,40,81,55,100,82,16,8,8,0
S01007527,546,40,13,27,122,45,86,68,77,101,7,2,5,0
S01007528,544,28,1,27,90,41,94,71,106,77,24,16,8,13
S01007529,447,57,14,43,107,28,87,33,65,54,12,3,9,4
S01007530,383,36,4,32,87,14,134,39,45,17,4,4,0,7
S01007531,541,27,2,25,112,48,145,46,95,48,7,5,2,13
S01007532,481,31,9,22,103,27,138,76,44,47,10,7,3,5
S01007533,419,27,7,20,88,31,161,35,46,24,6,0,6,1
S01007534,674,46,21,25,86,37,149,63,138,127,27,17,10,1
S01007535,781,48,22,26,131,58,102,93,169,108,64,20,44,8
S01007536,702,46,7,39,100,59,109,108,141,126,13,7,6,0
S01007537,695,75,8,67,125,49,96,72,119,132,21,11,10,6
S01007538,725,60,8,52,153,43,209,77,83,88,8,4,4,4
S01007539,423,67,18,49,114,47,56,46,53,38,2,1,1,0
S01007540,594,30,14,16,105,62,87,73,87,122,22,8,14,6
S01007541,513,29,5,24,111,65,85,65,63,91,4,1,3,0
S01007542,691,38,11,27,121,41,97,76,134,147,35,3,32,2
S01007543,894,27,5,22,136,69,120,93,222,185,32,7,25,10
S01007544,619,90,11,79,143,49,215,34,44,34,4,4,0,6
S01007545,591,69,14,55,93,41,169,66,100,48,5,1,4,0
S01007546,444,58,11,47,94,49,105,56,45,36,1,0,1,0
S01007547,432,51,14,37,86,27,119,27,66,51,3,0,3,2
S01007548,534,30,4,26,133,45,98,65,76,57,25,6,19,5
S01007549,440,60,20,40,80,38,105,47,55,32,16,6,10,7
S01007550,615,86,15,71,132,50,104,64,87,83,8,5,3,1
S01007551,604,81,5,76,125,37,234,49,42,25,11,8,3,0
S01007552,772,24,10,14,79,47,85,139,153,174,55,23,32,16
S01007553,698,19,3,16,59,48,46,138,163,154,61,19,42,10
S01007554,324,7,3,4,15,13,20,32,87,106,34,28,6,10
S01007555,366,39,4,35,60,22,71,53,55,53,13,1,12,0
S01007556,340,21,3,18,44,17,51,42,75,68,22,8,14,0
S01007557,891,21,13,8,74,83,81,133,182,254,45,19,26,18
S01007558,322,17,2,15,70,16,106,25,30,49,9,6,3,0
S01007559,601,64,10,54,116,55,159,84,69,45,4,2,2,5
S01007560,664,74,24,50,117,59,100,82,101,115,14,5,9,2
S01007561,446,16,1,15,75,48,68,41,108,78,8,7,1,4
S01007562,672,67,15,52,152,47,137,61,130,66,6,2,4,6
S01007563,674,63,12,51,166,67,191,45,93,44,0,0,0,5
S01007564,562,73,7,66,131,39,158,32,73,45,10,1,9,1
S01007565,757,70,13,57,181,61,119,64,134,102,18,14,4,8
S01007566,580,60,11,49,116,40,160,31,115,52,1,0,1,5
S01007567,488,39,17,22,124,30,171,42,41,34,6,3,3,1
S01007568,523,68,37,31,125,49,106,58,51,57,3,0,3,6
S01007569,591,46,10,36,106,37,114,52,122,102,7,4,3,5
S01007570,546,88,28,60,145,39,73,48,69,56,25,7,18,3
S01007571,409,55,14,41,124,39,84,30,40,29,5,3,2,3
S01007572,716,64,13,51,142,85,101,70,64,131,49,19,30,10
S01007573,830,113,32,81,253,128,70,86,104,74,2,2,0,0
S01007574,826,22,7,15,153,63,62,92,198,185,38,14,24,13
S01007575,636,16,4,12,73,62,59,78,143,135,59,26,33,11
S01007576,616,18,1,17,48,33,32,57,158,136,133,55,78,1
S01007577,599,4,0,4,51,46,36,68,175,157,49,20,29,13
S01007578,575,11,7,4,36,48,48,83,153,146,40,26,14,10
S01007579,582,6,5,1,78,61,23,53,157,146,48,15,33,10
S01007580,715,19,14,5,81,30,30,105,167,198,60,25,35,25
S01007581,435,3,3,0,47,36,39,79,87,108,34,20,14,2
S01007582,548,13,0,13,74,45,57,77,121,120,35,18,17,6
S01007583,885,20,5,15,88,70,53,85,275,222,60,32,28,12
S01007584,518,36,5,31,63,42,43,53,121,107,44,30,14,9
S01007585,580,59,16,43,140,68,50,68,74,99,10,3,7,12
S01007586,718,24,8,16,114,53,48,52,197,177,46,12,34,7
S01007587,458,64,15,49,142,61,45,43,41,52,8,5,3,2
S01007588,626,121,20,101,225,49,79,39,69,38,3,3,0,3
S01007589,609,68,24,44,174,68,54,46,96,59,33,13,20,11
S01007590,467,115,26,89,169,55,47,34,29,15,0,0,0,3
S01007591,482,70,6,64,97,44,42,76,67,79,7,3,4,0
S01007592,575,36,9,27,74,65,24,57,160,118,26,6,20,15
S01007593,771,78,24,54,180,73,115,133,98,80,10,3,7,4
S01007594,645,57,14,43,162,72,114,76,74,81,5,2,3,4
S01007595,748,82,13,69,149,56,207,66,103,82,3,0,3,0
S01007596,380,36,15,21,86,28,93,40,44,45,7,6,1,1
S01007597,521,75,19,56,149,46,109,39,51,41,6,0,6,5
S01007598,472,59,19,40,114,35,83,55,42,63,8,1,7,13
S01007599,672,89,20,69,183,59,67,49,106,94,11,8,3,14
S01007600,782,152,31,121,230,59,99,71,68,85,8,1,7,10
S01007601,576,33,12,21,166,68,50,78,87,78,9,1,8,7
S01007602,579,56,13,43,148,88,55,72,70,80,2,0,2,8
S01007603,688,95,22,73,245,80,39,74,69,66,13,7,6,7
S01007604,681,89,34,55,221,84,66,96,69,51,2,1,1,3
S01007605,630,73,16,57,173,81,54,76,82,91,0,0,0,0
S01007606,476,40,20,20,135,63,41,59,84,39,3,1,2,12
S01007607,558,69,15,54,147,72,35,81,90,62,0,0,0,2
S01007608,582,38,5,33,215,80,50,68,65,66,0,0,0,0
S01007609,765,40,6,34,123,87,46,69,176,167,42,20,22,15
S01007610,362,26,8,18,82,44,30,37,77,50,12,8,4,4
S01007611,681,53,4,49,81,71,37,89,165,118,48,34,14,19
S01007612,861,30,0,30,163,81,85,92,168,132,75,27,48,35
S01007613,593,100,18,82,150,68,98,43,80,40,7,1,6,7
S01007614,652,156,44,112,254,69,56,21,58,36,0,0,0,2
S01007615,859,105,42,63,257,102,77,66,132,95,21,11,10,4
S01007616,588,25,2,23,138,75,59,61,101,91,19,12,7,19
S01007617,401,14,3,11,74,45,51,35,74,86,17,7,10,5
S01007618,444,4,3,1,83,29,43,42,99,126,11,1,10,7
S01007619,500,15,2,13,80,35,47,56,115,128,20,11,9,4
S01007620,423,26,2,24,105,55,61,57,83,36,0,0,0,0
S01007621,472,26,19,7,109,54,73,90,67,46,4,0,4,3
S01007622,430,32,7,25,107,43,38,55,83,63,9,6,3,0
S01007623,477,63,10,53,148,55,57,47,60,42,5,5,0,0
S01007624,575,53,15,38,97,72,44,101,109,99,0,0,0,0
S01007625,399,31,3,28,97,30,48,62,55,62,10,7,3,4
S01007626,585,46,5,41,139,59,56,108,100,66,3,0,3,8
S01007627,433,56,7,49,122,34,59,63,57,33,9,9,0,0
S01007628,503,37,7,30,156,66,84,63,32,62,3,3,0,0
S01007629,530,49,14,35,141,38,92,52,54,99,5,0,5,0
S01007630,635,55,11,44,182,50,162,50,89,41,0,0,0,6
S01007631,477,61,6,55,74,40,168,59,49,13,10,4,6,3
S01007632,725,61,22,39,119,49,95,102,127,151,19,13,6,2
S01007633,728,44,10,34,124,74,97,100,131,125,24,6,18,9
S01007634,434,55,12,43,106,35,72,28,84,42,12,0,12,0
S01007635,383,43,5,38,98,18,62,58,69,35,0,0,0,0
S01007636,579,39,18,21,111,60,61,60,125,107,13,7,6,3
S01007637,646,34,6,28,79,52,110,72,136,140,23,6,17,0
S01007638,586,47,10,37,118,39,61,92,103,111,13,7,6,2
S01007639,916,53,18,35,148,61,81,94,229,206,37,15,22,7
S01007640,576,37,4,33,72,42,176,92,84,66,6,1,5,1
S01007641,672,75,35,40,141,53,144,70,80,89,15,6,9,5
S01007642,555,88,18,70,144,50,85,66,61,52,4,0,4,5
S01007643,656,76,18,58,174,34,112,99,72,68,13,0,13,8
S01007644,604,70,16,54,141,25,78,79,118,71,16,5,11,6
S01007645,389,42,4,38,75,22,112,38,50,42,6,2,4,2
S01007646,432,42,11,31,103,39,113,42,53,38,1,0,1,1
S01007647,509,24,0,24,145,54,80,51,67,70,17,2,15,1
S01007648,640,38,11,27,133,100,67,72,87,129,6,1,5,8
S01007649,560,20,6,14,88,58,96,61,84,134,17,5,12,2
S01007650,704,59,9,50,146,71,171,63,72,104,13,1,12,5
S01007651,452,62,26,36,63,16,174,32,49,54,2,0,2,0
S01007652,450,23,5,18,97,35,98,62,52,70,11,5,6,2
S01007653,691,49,13,36,132,39,172,108,99,82,5,0,5,5
S01007654,820,28,11,17,123,35,185,77,161,183,24,11,13,4
S01007655,593,54,12,42,122,46,214,41,68,47,1,0,1,0
S01007656,662,39,14,25,107,46,198,59,121,82,10,2,8,0
S01007657,350,21,12,9,58,25,89,48,71,33,5,2,3,0
S01007658,373,29,3,26,90,18,99,42,51,34,7,0,7,3
S01007659,601,54,6,48,135,27,113,69,90,97,13,5,8,3
S01007660,734,14,7,7,79,46,64,120,217,154,37,19,18,3
S01007661,491,18,9,9,102,39,62,53,94,111,10,3,7,2
S01007662,636,37,11,26,135,48,60,89,137,107,11,7,4,12
S01007663,610,45,3,42,148,51,79,74,99,105,3,1,2,6
S01007664,434,26,7,19,70,20,33,70,115,93,5,4,1,2
S01007665,538,26,11,15,91,36,37,96,117,119,14,8,6,2
S01007666,373,36,2,34,105,54,27,54,26,70,1,1,0,0
S01007667,550,55,10,45,160,49,77,83,58,62,0,0,0,6
S01007668,851,37,11,26,100,76,67,91,207,239,31,11,20,3
S01007669,556,12,3,9,43,23,38,44,180,178,38,11,27,0
S01007670,626,29,4,25,61,59,31,108,146,113,65,22,43,14
S01007671,554,85,19,66,126,51,131,64,58,39,0,0,0,0
S01007672,589,92,28,64,178,51,74,66,75,53,0,0,0,0
S01007673,569,30,8,22,120,56,72,113,63,104,7,1,6,4
S01007674,621,22,4,18,78,43,47,107,155,133,36,16,20,0
S01007675,483,54,15,39,79,39,93,77,67,73,1,0,1,0
S01007676,537,64,20,44,97,22,173,55,59,61,2,0,2,4
S01007677,392,30,8,22,73,23,41,73,61,79,6,0,6,6
S01007678,549,16,8,8,87,49,46,69,128,132,17,11,6,5
S01007679,623,34,19,15,57,39,50,100,149,161,28,14,14,5
S01007680,706,34,15,19,135,58,94,137,113,133,1,0,1,1
S01007681,267,14,6,8,30,22,45,53,54,45,1,1,0,3
S01007682,684,176,23,153,184,68,89,52,50,17,7,2,5,41
S01007683,568,243,16,227,121,44,43,27,8,13,3,1,2,66
S01007684,552,173,13,160,208,36,28,31,29,20,6,2,4,21
S01007685,508,245,19,226,136,30,40,9,12,22,0,0,0,14
S01007686,518,143,9,134,140,59,43,29,20,13,11,10,1,60
S01007687,732,157,8,149,175,51,55,24,43,32,17,13,4,178
S01007688,961,152,8,144,180,85,41,34,74,53,20,15,5,322
S01007689,525,114,0,114,98,21,32,20,25,17,14,12,2,184
S01007690,779,84,13,71,142,25,16,27,59,29,19,12,7,378
S01007691,966,82,3,79,123,70,35,24,85,56,61,31,30,430
S01007692,875,90,6,84,118,36,22,50,62,31,18,14,4,448
S01007693,543,40,1,39,49,24,7,34,59,37,39,21,18,254
S01007694,938,56,5,51,80,88,40,53,127,53,54,34,20,387
S01007695,720,135,4,131,132,54,34,42,91,41,27,11,16,164
S01007696,743,37,3,34,61,39,25,34,66,62,71,46,25,348
S01007697,717,111,9,102,163,70,37,40,76,55,16,8,8,149
S01007698,1026,89,6,83,173,122,58,64,125,91,34,15,19,270
S01007699,758,65,4,61,105,57,34,56,118,66,37,19,18,220
S01007700,819,228,37,191,233,83,56,36,38,78,21,16,5,46
S01007701,458,30,6,24,69,29,10,15,50,73,46,15,31,136
S01007702,540,95,3,92,102,32,17,17,42,25,7,0,7,203
S01007703,629,92,11,81,159,66,30,49,93,39,22,8,14,79
S01007704,788,24,3,21,93,49,37,52,128,121,133,64,69,151
S01007705,540,21,4,17,46,28,11,32,54,28,9,5,4,311
S01007706,763,25,1,24,67,43,5,32,40,21,18,12,6,512
S01007707,839,156,9,147,180,58,45,62,39,28,14,11,3,257
S01007708,561,29,0,29,102,82,38,53,100,54,49,32,17,54
S01007709,446,49,3,46,66,43,17,47,72,48,41,17,24,63
S01007710,767,53,5,48,127,70,32,57,84,66,33,21,12,245
S01007711,841,41,6,35,90,67,23,70,131,126,19,10,9,274
S01007712,606,60,0,60,134,64,24,49,62,37,11,8,3,165
S01007713,415,36,6,30,50,43,55,35,58,64,30,12,18,44
S01007714,575,30,4,26,131,80,28,71,86,114,14,9,5,21
S01007715,443,28,0,28,69,47,15,32,93,69,42,20,22,48
S01007716,777,53,8,45,106,77,58,51,120,119,63,33,30,130
S01007717,871,13,4,9,104,85,85,54,188,144,88,36,52,110
S01007718,518,16,2,14,77,44,46,46,100,80,43,27,16,66
S01007719,726,31,4,27,113,99,51,95,124,114,48,18,30,51
S01007720,440,30,8,22,68,69,38,43,84,75,23,6,17,10
S01007721,579,17,3,14,118,64,53,97,85,83,33,5,28,29
S01007722,665,26,3,23,100,99,44,64,126,113,58,41,17,35
S01007723,676,25,4,21,95,56,37,79,132,137,83,65,18,32
S01007724,618,21,0,21,58,74,13,69,143,112,57,27,30,71
S01007725,650,31,0,31,78,80,18,53,118,144,79,41,38,49
S01007726,699,33,4,29,122,77,32,95,131,87,59,45,14,63
S01007727,902,22,4,18,138,92,66,69,156,146,89,60,29,124
S01007728,645,22,2,20,95,71,32,62,126,104,54,22,32,79
S01007729,727,25,1,24,121,70,31,64,131,113,62,23,39,110
S01007730,720,47,1,46,159,83,36,63,124,77,48,17,31,83
S01007731,674,41,5,36,170,63,34,79,103,94,36,17,19,54
S01007732,608,48,1,47,121,68,27,64,84,79,32,6,26,85
S01007733,739,126,25,101,179,99,119,55,91,39,22,18,4,9
S01007734,608,111,17,94,158,100,75,46,48,62,6,1,5,2
S01007735,642,103,18,85,157,96,83,61,56,66,17,11,6,3
S01007736,560,73,11,62,125,70,92,74,75,38,5,5,0,8
S01007737,823,93,10,83,192,107,68,83,136,79,31,18,13,34
S01007738,497,57,20,37,124,62,45,50,69,68,14,3,11,8
S01007739,327,24,6,18,55,38,35,47,57,61,9,1,8,1
S01007740,424,56,5,51,100,86,41,36,55,29,8,5,3,13
S01007741,477,53,19,34,90,75,34,22,70,95,19,7,12,19
S01007742,438,54,19,35,108,72,41,38,45,65,12,3,9,3
S01007743,756,56,14,42,130,91,47,86,143,132,51,24,27,20
S01007744,589,19,0,19,69,67,26,51,138,123,73,43,30,23
S01007745,538,11,3,8,69,63,51,78,115,109,31,9,22,11
S01007746,772,11,0,11,103,64,57,86,155,211,73,40,33,12
S01007747,424,10,1,9,52,35,39,63,111,67,47,22,25,0
S01007748,607,5,0,5,90,51,36,61,129,131,84,44,40,20
S01007749,570,78,18,60,165,94,62,74,39,28,27,15,12,3
S01007750,504,116,14,102,127,84,73,35,43,19,2,2,0,5
S01007751,473,144,20,124,126,50,53,19,29,36,14,6,8,2
S01007752,405,122,24,98,122,41,32,33,25,24,5,5,0,1
S01007753,459,3,0,3,67,35,37,62,95,124,30,16,14,6
S01007754,712,9,0,9,94,77,49,61,153,166,95,38,57,8
S01007755,685,6,0,6,77,68,37,49,172,165,102,48,54,9
S01007756,492,11,0,11,64,54,30,45,151,88,40,23,17,9
S01007757,552,73,16,57,207,90,56,44,55,25,0,0,0,2
S01007758,556,167,36,131,197,29,62,23,32,36,6,4,2,4
S01007759,700,75,12,63,174,92,65,81,102,62,31,12,19,18
S01007760,423,134,35,99,162,34,50,8,20,13,1,0,1,1
S01007761,653,169,19,150,246,56,55,45,35,27,13,3,10,7
S01007762,555,82,16,66,188,74,45,42,49,53,9,4,5,13
S01007763,299,14,0,14,86,33,33,29,42,43,13,3,10,6
S01007764,607,87,25,62,200,101,75,61,35,45,0,0,0,3
S01007765,477,65,7,58,171,88,37,54,35,17,7,1,6,3
S01007766,653,128,22,106,245,85,33,60,52,40,0,0,0,10
S01007767,632,125,36,89,217,74,70,59,43,33,5,2,3,6
S01007768,462,105,13,92,174,50,32,18,28,29,16,4,12,10
S01007769,489,111,30,81,194,39,55,13,39,29,8,6,2,1
S01007770,529,192,48,144,158,49,46,30,27,11,2,2,0,14
S01007771,335,97,20,77,109,32,27,38,3,19,8,2,6,2
S01007772,666,48,4,44,135,131,47,81,111,78,25,10,15,10
S01007773,537,64,14,50,174,104,63,53,41,30,8,3,5,0
S01007774,923,172,37,135,350,126,82,90,50,44,4,0,4,5
S01007775,733,179,35,144,217,90,51,69,76,44,2,1,1,5
S01007776,645,133,44,89,248,63,73,59,29,31,5,2,3,4
S01007777,939,225,46,179,356,99,90,66,55,41,4,0,4,3
S01007778,422,117,24,93,174,18,50,32,27,4,0,0,0,0
S01007779,594,37,22,15,143,92,66,80,78,90,5,1,4,3
S01007780,720,45,13,32,184,116,74,95,107,81,9,0,9,9
S01007781,829,59,23,36,206,113,61,123,118,133,16,4,12,0
S01007782,452,11,3,8,92,36,24,25,84,110,48,26,22,22
S01007783,569,4,0,4,34,57,24,44,107,152,126,65,61,21
S01007784,681,43,19,24,114,115,45,63,152,105,35,10,25,9
S01007785,528,6,0,6,56,56,21,39,149,102,76,36,40,23
S01007786,596,8,0,8,112,73,49,56,124,151,22,8,14,1
S01007787,562,11,4,7,73,55,47,66,138,119,50,24,26,3
S01007788,669,12,1,11,64,51,50,70,181,97,132,63,69,12
S01007789,593,14,0,14,95,58,28,49,132,156,47,29,18,14
S01007790,864,23,15,8,87,74,27,74,247,172,137,60,77,23
S01007791,437,51,18,33,127,38,54,34,70,57,5,0,5,1
S01007792,713,6,4,2,107,63,49,78,132,214,56,36,20,8
S01007793,763,17,2,15,71,73,40,84,197,146,114,44,70,21
S01007794,473,6,2,4,83,60,18,85,96,99,12,1,11,14
S01007795,520,11,4,7,66,59,25,85,117,138,13,8,5,6
S01007796,634,27,10,17,125,79,21,90,122,99,46,20,26,25
S01007797,431,10,3,7,50,36,18,57,77,121,50,24,26,12
S01007798,634,72,12,60,153,92,65,90,75,65,10,7,3,12
S01007799,611,73,5,68,188,66,65,92,47,63,13,11,2,4
S01007800,796,9,2,7,112,71,41,74,185,187,95,42,53,22
S01007801,700,5,3,2,92,56,20,63,176,179,102,57,45,7
S01007802,534,26,0,26,139,87,54,69,66,68,15,2,13,10
S01007803,895,30,4,26,60,89,36,114,201,217,118,73,45,30
S01007804,571,13,5,8,77,82,46,40,95,135,66,45,21,17
S01007805,493,14,0,14,48,73,18,41,122,94,65,37,28,18
S01007806,499,14,3,11,77,80,34,48,89,134,18,11,7,5
S01007807,623,70,12,58,186,97,68,65,68,55,11,4,7,3
S01007808,783,37,0,37,128,80,45,81,176,171,43,36,7,22
S01007809,686,94,30,64,182,104,77,71,81,65,10,10,0,2
S01007810,716,2,1,1,132,59,33,60,137,206,79,45,34,8
S01007811,766,25,2,23,105,71,30,52,193,198,86,56,30,6
S01007812,803,37,0,37,89,44,57,70,158,211,120,51,69,17
S01007813,698,9,0,9,54,124,24,62,154,173,78,31,47,20
S01007814,458,15,2,13,86,63,50,57,68,101,12,12,0,6
S01007815,684,65,31,34,192,91,55,100,100,70,0,0,0,11
S01007816,551,22,0,22,128,96,55,92,83,75,0,0,0,0
S01007817,293,22,14,8,77,28,27,28,38,69,2,0,2,2
S01007818,650,48,24,24,146,94,74,68,116,81,17,9,8,6
S01007819,585,23,2,21,166,67,59,60,68,111,23,11,12,8
S01007820,730,44,10,34,164,98,70,78,104,128,33,11,22,11
S01007821,410,28,3,25,104,47,41,42,88,49,8,8,0,3
S01007822,523,54,10,44,155,77,46,52,38,87,12,1,11,2
S01007823,525,68,17,51,155,89,43,80,48,32,7,7,0,3
S01007824,515,61,15,46,132,56,68,72,56,58,6,6,0,6
S01007825,746,87,11,76,224,88,102,70,94,61,9,6,3,11
S01007826,459,8,3,5,84,35,27,46,102,122,22,15,7,13
S01007827,539,50,9,41,157,61,31,68,84,48,26,13,13,14
S01007828,695,46,4,42,126,127,52,80,101,93,43,23,20,27
S01007829,329,26,7,19,79,59,33,27,32,49,9,8,1,15
S01007830,646,32,6,26,98,94,32,74,117,107,37,21,16,55
S01007831,684,35,5,30,132,92,46,62,122,84,68,37,31,43
S01007832,471,14,2,12,105,56,28,48,79,88,33,12,21,20
S01007833,377,7,0,7,103,45,30,36,48,65,20,9,11,23
S01007834,612,59,7,52,79,93,29,61,97,104,50,18,32,40
S01007835,521,73,3,70,157,48,26,56,71,69,13,10,3,8
S01007836,377,53,13,40,121,50,28,22,47,28,22,16,6,6
S01007837,546,61,25,36,182,88,69,66,28,42,2,2,0,8
S01007838,565,71,8,63,156,78,66,53,66,51,9,9,0,15
S01007839,301,24,0,24,65,23,31,27,43,58,10,6,4,20
S01007840,586,34,6,28,104,116,29,62,91,94,33,19,14,23
S01007841,574,20,3,17,105,84,33,30,125,104,42,19,23,31
S01007842,699,30,6,24,65,98,34,56,124,140,113,61,52,39
S01007843,584,34,1,33,99,119,19,68,97,65,39,18,21,44
S01007844,808,52,4,48,118,109,37,92,153,129,68,22,46,50
S01007845,767,22,11,11,113,112,32,62,151,153,116,70,46,6
S01007846,600,9,0,9,100,67,31,70,131,124,59,19,40,9
S01007847,747,30,6,24,129,86,42,87,136,170,62,24,38,5
S01007848,694,17,0,17,143,75,21,58,169,110,70,27,43,31
S01007849,817,19,4,15,76,104,45,93,169,203,84,44,40,24
S01007850,574,12,0,12,66,77,67,48,128,124,45,32,13,7
S01007851,594,37,14,23,117,90,58,56,116,105,7,2,5,8
S01007852,573,21,0,21,82,66,49,41,140,84,80,48,32,10
S01007853,461,7,0,7,54,57,18,32,105,86,77,40,37,25
S01007854,905,29,1,28,151,90,42,88,189,152,139,71,68,25
S01007855,412,17,2,15,70,46,27,37,82,75,41,11,30,17
S01007856,711,27,3,24,138,85,49,80,135,143,35,18,17,19
S01007857,405,6,2,4,66,50,23,10,97,102,34,22,12,17
S01007858,794,22,4,18,154,119,56,58,164,136,66,30,36,19
S01007859,451,3,2,1,68,53,43,48,75,124,34,17,17,3
S01007860,610,59,15,44,144,52,65,72,97,76,39,20,19,6
S01007861,556,6,0,6,101,78,31,19,123,159,34,14,20,5
S01007862,579,14,0,14,103,54,37,55,120,150,33,11,22,13
S01007863,781,3,0,3,94,88,36,88,162,168,114,80,34,28
S01007864,718,32,6,26,104,86,38,89,135,141,69,36,33,24
S01007865,676,122,18,104,178,77,59,121,65,36,13,8,5,5
S01007866,563,51,10,41,207,70,80,73,42,36,4,3,1,0
S01007867,406,69,8,61,126,51,54,33,21,40,3,0,3,9
S01007868,714,108,7,101,222,102,54,77,71,64,8,0,8,8
S01007869,782,206,21,185,187,87,68,67,80,54,9,9,0,24
S01007870,435,28,10,18,79,35,84,70,71,59,7,3,4,2
S01007871,530,11,2,9,35,24,59,65,130,127,74,43,31,5
S01007872,598,13,0,13,70,37,45,56,148,146,78,58,20,5
S01007873,503,16,0,16,82,60,46,112,68,89,30,17,13,0
S01007874,503,14,6,8,64,45,48,74,135,102,21,9,12,0
S01007875,438,28,1,27,81,41,37,70,85,86,8,6,2,2
S01007876,849,35,7,28,201,113,94,92,120,147,35,22,13,12
S01007877,594,18,3,15,79,69,68,64,96,157,33,20,13,10
S01007878,478,25,0,25,64,33,21,66,98,128,29,16,13,14
S01007879,654,2,0,2,66,41,39,91,169,191,52,33,19,3
S01007880,296,45,10,35,84,13,61,27,32,26,8,0,8,0
S01007881,433,17,3,14,81,25,59,50,70,91,36,16,20,4
S01007882,644,93,27,66,189,32,159,55,45,56,6,1,5,9
S01007883,863,51,15,36,226,108,118,101,111,119,15,2,13,14
S01007884,524,13,5,8,101,45,57,53,110,115,21,11,10,9
S01007885,598,25,0,25,74,36,51,89,115,132,71,26,45,5
S01007886,681,63,9,54,127,86,87,101,82,95,33,22,11,7
S01007887,471,55,16,39,118,40,130,52,26,32,9,6,3,9
S01007888,937,18,1,17,86,78,34,120,206,282,91,46,45,22
S01007889,389,12,4,8,59,47,22,56,89,96,5,1,4,3
S01007890,610,30,0,30,91,75,73,90,84,129,29,5,24,9
S01007891,690,33,9,24,144,89,66,117,111,109,17,9,8,4
S01007892,574,63,15,48,162,66,77,63,80,47,16,9,7,0
S01007893,787,87,13,74,254,49,142,81,83,66,21,16,5,4
S01007894,751,52,9,43,108,55,83,95,131,191,19,12,7,17
S01007895,389,41,11,30,82,50,51,43,63,43,11,1,10,5
S01007896,696,6,0,6,105,53,39,90,155,206,36,8,28,6
S01007897,353,38,5,33,85,27,117,26,32,20,8,4,4,0
S01007898,381,21,4,17,62,35,107,34,61,49,6,4,2,6
S01007899,274,16,5,11,62,27,96,18,12,37,5,0,5,1
S01007900,434,12,5,7,56,38,21,62,119,82,38,26,12,6
S01007901,578,20,7,13,63,58,50,84,89,142,66,31,35,6
S01007902,690,3,1,2,57,68,57,94,130,200,73,44,29,8
S01007903,469,22,5,17,59,54,57,88,61,102,25,9,16,1
S01007904,633,89,40,49,139,42,161,81,41,76,1,1,0,3
S01007905,569,5,0,5,36,42,24,81,142,139,94,38,56,6
S01007906,486,17,7,10,38,32,45,73,99,143,33,17,16,6
S01007907,391,21,6,15,44,25,16,59,75,116,35,15,20,0
S01007908,647,29,11,18,142,58,71,78,126,121,18,9,9,4
S01007909,463,22,4,18,47,30,48,80,66,133,27,15,12,10
S01007910,811,25,15,10,119,34,47,115,161,198,80,46,34,32
S01007911,613,23,6,17,115,72,49,85,121,126,8,4,4,14
S01007912,573,10,0,10,99,54,57,70,124,130,28,13,15,1
S01007913,468,1,0,1,68,26,41,68,99,121,38,20,18,6
S01007914,508,9,3,6,75,30,42,53,144,106,37,21,16,12
S01007915,691,18,7,11,99,87,72,107,140,113,41,11,30,14
S01007916,564,16,2,14,83,85,68,59,92,121,37,19,18,3
S01007917,665,14,10,4,134,50,52,80,119,183,26,17,9,7
S01007918,721,53,5,48,135,66,71,111,92,134,47,26,21,12
S01007919,620,96,25,71,205,58,51,82,68,54,2,0,2,4
S01007920,522,60,16,44,112,60,61,90,47,84,8,1,7,0
S01007921,729,27,4,23,59,48,63,104,156,226,45,17,28,1
S01007922,717,16,3,13,85,53,85,64,170,197,45,15,30,2
S01007923,804,38,14,24,163,83,101,112,110,178,18,10,8,1
S01007924,836,31,8,23,114,64,80,93,195,188,53,18,35,18
S01007925,380,69,23,46,89,21,131,37,18,12,3,3,0,0
S01007926,398,72,8,64,113,25,101,24,35,25,1,1,0,2
S01007927,513,93,21,72,131,40,156,23,45,20,5,2,3,0
S01007928,774,145,48,97,239,56,103,68,67,81,14,10,4,1
S01007929,659,117,26,91,178,58,179,50,25,42,5,2,3,5
S01007930,497,108,33,75,125,26,145,37,28,26,0,0,0,2
S01007931,870,207,57,150,243,66,65,72,93,91,19,15,4,14
S01007932,611,117,22,95,208,53,81,54,43,34,8,5,3,13
S01007933,770,114,27,87,198,80,80,55,100,97,32,14,18,14
S01007934,600,80,12,68,164,66,68,51,69,74,23,15,8,5
S01007935,640,79,10,69,159,73,68,55,73,85,43,20,23,5
S01007936,874,212,31,181,323,94,72,83,56,19,11,7,4,4
S01007937,910,178,31,147,277,94,105,84,80,79,8,7,1,5
S01007938,566,43,10,33,111,97,47,74,92,57,34,11,23,11
S01007939,705,13,0,13,105,101,56,62,186,123,52,20,32,7
S01007940,821,110,14,96,147,92,68,100,120,147,27,13,14,10
S01007941,534,64,27,37,161,81,52,54,50,61,11,7,4,0
S01007942,460,37,6,31,92,55,32,59,50,91,39,20,19,5
S01007943,478,67,16,51,116,57,46,48,45,77,16,7,9,6
S01007944,708,46,11,35,151,54,78,106,123,108,33,24,9,9
S01007945,660,59,16,43,145,76,78,54,98,101,41,16,25,8
S01007946,631,52,19,33,123,75,64,74,95,91,42,18,24,15
S01007947,595,104,36,68,112,65,65,54,66,84,44,16,28,1
S01007948,547,32,7,25,56,36,53,60,85,144,75,36,39,6
S01007949,575,66,11,55,159,62,48,103,68,54,12,5,7,3
S01007950,719,95,22,73,246,78,90,85,46,58,14,5,9,7
S01007951,607,61,11,50,127,75,57,89,78,80,19,9,10,21
S01007952,448,22,6,16,69,55,59,48,80,68,40,21,19,7
S01007953,782,23,5,18,142,74,87,98,171,152,18,1,17,17
S01007954,620,13,0,13,77,39,24,95,142,146,65,23,42,19
S01007955,742,17,5,12,66,76,58,103,166,181,65,32,33,10
S01007956,619,33,17,16,80,55,45,83,138,128,36,8,28,21
S01007957,704,27,5,22,134,90,55,94,136,115,39,27,12,14
S01007958,703,40,5,35,93,73,44,100,145,114,87,39,48,7
S01007959,530,36,16,20,130,45,42,127,61,77,10,2,8,2
S01007960,579,30,3,27,108,41,27,83,146,116,28,10,18,0
S01007961,545,58,6,52,93,67,205,44,54,19,4,4,0,1
S01007962,526,26,9,17,56,71,47,55,101,112,49,31,18,9
S01007963,893,9,1,8,43,74,55,87,186,226,191,102,89,22
S01007964,610,25,7,18,47,48,51,94,138,138,52,24,28,17
S01007965,463,9,4,5,73,36,31,55,88,106,57,21,36,8
S01007966,822,38,8,30,105,68,38,94,174,179,112,49,63,14
S01007967,569,4,0,4,49,60,39,31,155,123,99,46,53,9
S01007968,649,20,8,12,114,85,53,79,155,116,26,6,20,1
S01007969,638,19,4,15,97,104,48,72,145,102,42,21,21,9
S01007970,703,16,3,13,152,71,43,78,162,132,40,9,31,9
S01007971,711,24,12,12,108,80,49,104,140,151,41,20,21,14
S01007972,617,20,3,17,113,66,51,113,119,116,11,3,8,8
S01007973,660,55,20,35,203,112,34,100,70,74,12,9,3,0
S01007974,617,24,8,16,87,62,35,70,133,124,67,35,32,15
S01007975,490,13,3,10,104,48,51,67,95,69,32,16,16,11
S01007976,483,35,4,31,92,61,23,49,85,84,40,13,27,14
S01007977,525,59,14,45,132,56,35,83,99,42,13,6,7,6
S01007978,462,30,14,16,100,72,24,66,82,56,24,11,13,8
S01007979,661,105,20,85,220,77,58,73,74,32,10,2,8,12
S01007980,519,63,16,47,111,74,58,52,67,79,10,1,9,5
S01007981,386,22,7,15,131,57,37,38,49,46,4,0,4,2
S01007982,381,36,13,23,113,52,35,56,44,37,8,3,5,0
S01007983,528,22,4,18,73,61,44,73,115,93,37,9,28,10
S01007984,598,76,21,55,146,72,42,56,106,72,22,17,5,6
S01007985,731,34,13,21,96,57,45,104,150,163,63,22,41,19
S01007986,413,39,11,28,86,64,36,54,71,59,3,3,0,1
S01007987,631,85,11,74,151,107,50,57,82,59,32,5,27,8
S01007988,618,25,5,20,89,86,41,79,141,113,41,18,23,3
S01007989,642,19,11,8,108,40,47,90,159,130,39,21,18,10
S01007990,856,45,11,34,167,111,50,144,128,149,47,17,30,15
S01007991,905,210,44,166,352,101,76,50,60,37,15,4,11,4
S01007992,626,91,9,82,216,34,84,134,36,24,0,0,0,7
S01007993,691,87,14,73,182,105,61,92,95,58,7,5,2,4
S01007994,824,178,49,129,312,93,71,63,47,43,7,2,5,10
S01007995,821,124,25,99,260,132,42,110,83,61,6,1,5,3
S01007996,387,65,19,46,128,32,78,28,29,18,9,2,7,0
S01007997,503,91,18,73,180,71,62,39,20,19,19,10,9,2
S01007998,400,83,11,72,113,50,49,32,30,20,23,7,16,0
S01007999,557,5,3,2,72,49,57,52,151,126,37,11,26,8
S01008000,728,23,1,22,90,85,32,64,197,164,54,32,22,19
S01008001,738,14,3,11,61,60,39,82,177,193,94,41,53,18
S01008002,674,16,13,3,63,43,48,83,152,131,113,52,61,25
S01008003,540,39,9,30,103,66,56,67,100,77,15,5,10,17
S01008004,641,68,8,60,145,97,45,91,73,94,20,7,13,8
S01008005,554,66,6,60,126,73,47,55,93,63,22,15,7,9
S01008006,487,2,0,2,67,13,45,68,109,99,73,51,22,11
S01008007,402,7,0,7,42,27,12,52,83,113,60,25,35,6
S01008008,576,21,0,21,102,34,52,72,67,118,79,50,29,31
S01008009,718,42,8,34,97,108,43,86,133,122,62,40,22,25
S01008010,757,44,16,28,129,99,77,89,129,83,93,49,44,14
S01008011,432,15,1,14,85,68,24,28,72,64,63,31,32,13
S01008012,638,67,12,55,150,76,65,59,84,82,34,15,19,21
S01008013,467,46,13,33,114,75,47,42,56,59,21,13,8,7
S01008014,498,63,10,53,151,59,40,55,53,55,14,7,7,8
S01008015,602,30,2,28,119,74,22,67,121,118,44,18,26,7
S01008016,553,31,5,26,128,83,54,46,75,93,29,9,20,14
S01008017,608,141,47,94,207,74,59,42,38,36,8,5,3,3
S01008018,448,78,25,53,168,57,47,36,36,18,4,3,1,4
S01008019,582,137,27,110,190,40,86,39,55,31,3,2,1,1
S01008020,494,52,12,40,135,94,52,65,41,44,7,5,2,4
S01008021,418,85,18,67,113,37,90,39,43,4,6,0,6,1
S01008022,591,95,28,67,242,58,66,51,46,28,0,0,0,5
S01008023,674,164,37,127,209,59,85,72,49,25,6,0,6,5
S01008024,669,166,33,133,244,66,70,72,34,17,0,0,0,0
S01008025,570,62,12,50,124,104,55,90,58,67,5,3,2,5
S01008026,813,63,19,44,170,94,65,97,120,153,41,15,26,10
S01008027,427,21,1,20,92,46,13,75,57,95,24,13,11,4
S01008028,507,31,3,28,128,56,73,70,65,75,4,2,2,5
S01008029,640,103,12,91,146,67,124,48,101,37,6,2,4,8
S01008030,798,101,15,86,268,88,99,90,77,69,5,1,4,1
S01008031,717,69,11,58,136,95,66,80,127,97,42,24,18,5
S01008032,739,68,25,43,162,90,64,80,123,118,21,10,11,13
S01008033,730,273,61,212,229,47,105,40,24,12,0,0,0,0
S01008034,726,254,48,206,241,56,91,42,21,19,1,0,1,1
S01008035,495,96,21,75,188,79,45,36,31,16,4,2,2,0
S01008036,506,116,20,96,189,62,49,24,43,14,7,0,7,2
S01008037,829,87,15,72,175,128,101,85,157,83,9,6,3,4
S01008038,642,60,6,54,125,87,67,69,115,97,12,2,10,10
S01008039,760,105,30,75,202,84,60,101,119,67,11,3,8,11
S01008040,599,166,39,127,211,44,60,38,49,20,3,0,3,8
S01008041,491,133,17,116,166,28,48,29,41,32,5,1,4,9
S01008042,440,161,12,149,146,35,54,5,21,10,5,2,3,3
S01008043,693,281,61,220,203,55,93,24,19,6,10,6,4,2
S01008044,715,215,39,176,256,56,74,51,37,14,7,7,0,5
S01008045,680,228,17,211,194,50,77,40,29,31,31,17,14,0
S01008046,525,97,19,78,149,64,35,31,56,41,36,23,13,16
S01008047,490,188,20,168,134,35,73,21,20,12,2,1,1,5
S01008048,421,118,32,86,172,43,26,25,13,12,4,4,0,8
S01008049,595,194,26,168,210,60,87,27,8,7,0,0,0,2
S01008050,418,164,48,116,132,37,50,6,12,8,3,0,3,6
S01008051,695,220,42,178,270,63,51,25,26,27,3,3,0,10
S01008052,684,251,27,224,291,40,51,16,14,11,3,3,0,7
S01008053,404,109,17,92,178,38,48,11,17,3,0,0,0,0
S01008054,537,184,46,138,183,41,86,11,11,12,9,4,5,0
S01008055,834,372,80,292,255,58,83,26,25,7,2,2,0,6
S01008056,519,217,17,200,152,39,58,18,17,11,0,0,0,7
S01008057,707,228,54,174,255,65,88,24,35,1,1,0,1,10
S01008058,796,318,46,272,223,43,159,17,17,9,3,0,3,7
S01008059,547,145,12,133,194,64,61,21,31,23,2,0,2,6
S01008060,766,206,44,162,256,119,78,47,31,22,7,0,7,0
S01008061,622,149,26,123,248,50,72,24,50,20,6,4,2,3
S01008062,675,117,25,92,208,105,81,81,45,29,7,1,6,2
S01008063,701,179,20,159,263,65,96,40,36,10,4,4,0,8
S01008064,584,60,5,55,129,86,68,54,66,74,35,12,23,12
S01008065,815,291,54,237,330,60,67,16,10,22,5,3,2,14
S01008066,748,357,51,306,222,26,109,17,10,2,2,0,2,3
S01008067,469,202,15,187,134,40,42,14,18,10,0,0,0,9
S01008068,676,161,24,137,221,70,92,52,50,22,4,4,0,4
S01008069,736,86,11,75,258,114,68,70,71,57,10,3,7,2
S01008070,715,84,23,61,226,138,68,69,58,59,9,0,9,4
S01008071,574,98,5,93,233,74,65,43,25,32,2,1,1,2
S01008072,680,249,44,205,222,48,69,21,28,21,11,0,11,11
S01008073,346,148,13,135,90,19,59,9,5,16,0,0,0,0
S01008074,783,233,41,192,256,94,108,32,45,11,0,0,0,4
S01008075,424,156,24,132,126,32,67,2,9,20,7,3,4,5
S01008076,356,139,16,123,115,35,29,21,4,6,0,0,0,7
S01008077,619,274,43,231,184,51,67,16,10,5,9,2,7,3
S01008078,641,171,23,148,200,65,121,36,36,8,2,1,1,2
S01008079,647,227,44,183,199,38,108,8,38,20,9,3,6,0
S01008080,545,141,25,116,169,43,116,34,18,18,1,0,1,5
S01008081,475,175,37,138,131,21,64,38,28,11,4,4,0,3
S01008082,629,145,23,122,227,76,97,22,40,7,4,0,4,11
S01008083,552,165,39,126,179,60,62,21,50,12,0,0,0,3
S01008084,683,128,24,104,225,89,75,67,53,30,7,3,4,9
S01008085,840,180,20,160,312,82,125,48,53,22,9,3,6,9
S01008086,934,203,42,161,238,136,137,56,70,75,8,6,2,11
S01008087,621,159,37,122,182,82,59,56,39,17,14,9,5,13
S01008088,648,126,27,99,220,100,44,59,46,35,9,2,7,9
S01008089,497,91,28,63,172,58,56,50,43,24,3,1,2,0
S01008090,619,150,24,126,171,94,60,42,33,64,0,0,0,5
S01008091,288,64,9,55,93,28,45,6,24,22,4,1,3,2
S01008092,610,145,12,133,224,71,89,32,30,18,0,0,0,1
S01008093,596,90,30,60,191,100,91,56,32,27,6,4,2,3
S01008094,490,102,10,92,170,41,77,51,31,9,9,5,4,0
S01008095,533,73,16,57,173,70,65,51,37,53,9,0,9,2
S01008096,521,114,26,88,182,48,53,40,44,37,1,0,1,2
S01008097,416,98,41,57,132,57,55,14,21,30,8,0,8,1
S01008098,585,115,29,86,166,90,50,59,49,41,10,9,1,5
S01008099,428,62,11,51,102,60,50,52,48,45,7,2,5,2
S01008100,655,207,32,175,191,54,97,24,29,34,15,1,14,4
S01008101,696,142,16,126,209,93,64,78,56,39,9,1,8,6
S01008102,609,57,11,46,196,76,91,50,66,57,10,4,6,6
S01008103,454,55,12,43,121,67,43,31,73,34,25,13,12,5
S01008104,703,43,10,33,132,135,66,85,95,98,34,19,15,15
S01008105,889,74,22,52,195,129,101,55,146,119,55,27,28,15
S01008106,630,19,0,19,128,73,39,55,136,126,51,29,22,3
S01008107,883,172,41,131,247,73,201,92,56,27,5,0,5,10
S01008108,596,119,26,93,172,72,90,54,50,32,6,3,3,1
S01008109,774,107,30,77,208,132,95,81,82,52,10,3,7,7
S01008110,753,74,9,65,291,108,92,71,57,52,2,0,2,6
S01008111,635,168,44,124,196,90,70,49,41,19,0,0,0,2
S01008112,563,91,22,69,166,78,49,84,52,34,0,0,0,9
S01008113,657,126,22,104,217,96,71,62,59,22,0,0,0,4
S01008114,519,71,11,60,189,71,43,54,46,37,8,4,4,0
S01008115,808,90,21,69,183,160,106,111,70,72,12,4,8,4
S01008116,749,144,24,120,294,105,52,33,54,49,8,5,3,10
S01008117,584,147,35,112,212,56,65,33,37,18,16,11,5,0
S01008118,671,110,21,89,208,82,68,53,77,50,12,1,11,11
S01008119,518,31,5,26,61,60,47,56,125,98,27,14,13,13
S01008120,450,105,12,93,148,75,33,18,43,11,13,8,5,4
S01008121,457,161,31,130,145,35,44,18,32,17,3,1,2,2
S01008122,618,219,34,185,235,30,66,21,22,11,7,0,7,7
S01008123,656,261,38,223,206,51,82,17,25,7,0,0,0,7
S01008124,693,164,26,138,212,105,73,48,37,42,3,0,3,9
S01008125,700,193,62,131,222,86,65,33,30,64,2,2,0,5
S01008126,707,196,33,163,245,91,68,47,26,25,9,1,8,0
S01008127,381,113,35,78,123,53,32,19,13,21,6,0,6,1
S01008128,709,172,25,147,241,93,71,51,28,37,8,0,8,8
S01008129,739,70,20,50,207,92,62,64,117,75,43,19,24,9
S01008130,781,85,26,59,194,151,60,55,93,79,42,18,24,22
S01008131,619,39,4,35,153,103,54,63,98,72,24,10,14,13
S01008132,720,150,32,118,255,80,78,74,51,27,3,0,3,2
S01008133,450,89,17,72,106,37,45,48,55,50,17,11,6,3
S01008134,494,110,18,92,137,68,39,40,45,31,19,8,11,5
S01008135,1011,114,29,85,302,144,99,102,126,71,30,13,17,23
S01008136,684,70,16,54,139,100,64,70,121,82,28,21,7,10
S01008137,806,29,7,22,96,68,41,118,245,127,67,34,33,15
S01008138,762,32,9,23,115,67,33,80,192,161,67,32,35,15
S01008139,714,36,4,32,140,103,66,83,81,145,48,16,32,12
S01008140,417,42,6,36,80,35,28,40,69,90,33,23,10,0
S01008141,651,75,9,66,195,82,83,96,58,45,6,1,5,11
S01008142,713,117,42,75,239,79,56,98,42,62,5,4,1,15
S01008143,726,61,0,61,188,95,43,84,115,91,36,15,21,13
S01008144,510,74,16,58,160,55,78,42,57,41,0,0,0,3
S01008145,683,35,9,26,113,72,65,113,87,173,21,6,15,4
S01008146,384,35,13,22,56,9,45,53,68,100,17,8,9,1
S01008147,661,58,21,37,148,105,59,66,102,102,12,5,7,9
S01008148,636,58,4,54,183,119,64,66,53,65,16,11,5,12
S01008149,592,35,10,25,134,121,38,58,90,84,21,5,16,11
S01008150,727,50,18,32,171,151,44,65,116,109,18,8,10,3
S01008151,546,40,8,32,102,56,49,78,124,81,11,5,6,5
S01008152,778,59,12,47,196,109,65,77,139,77,41,21,20,15
S01008153,697,115,17,98,227,103,78,61,47,53,5,0,5,8
S01008154,603,115,35,80,181,88,67,38,36,56,16,3,13,6
S01008155,543,80,23,57,157,93,60,36,61,49,7,4,3,0
S01008156,713,68,16,52,169,64,126,55,103,99,26,12,14,3
S01008157,651,128,8,120,187,88,60,74,54,41,5,0,5,14
S01008158,645,76,16,60,204,100,74,73,58,52,6,0,6,2
S01008159,831,62,10,52,136,94,78,97,185,104,62,34,28,13
S01008160,798,62,12,50,133,78,63,111,178,109,48,11,37,16
S01008161,937,131,26,105,341,75,133,85,107,57,6,4,2,2
S01008162,773,126,18,108,234,53,93,70,98,89,5,0,5,5
S01008163,622,40,2,38,102,58,67,72,109,140,27,12,15,7
S01008164,569,28,2,26,88,78,76,51,113,108,16,5,11,11
S01008165,726,98,14,84,235,98,128,67,39,54,2,1,1,5
S01008166,461,9,2,7,79,26,42,74,115,99,7,6,1,10
S01008167,594,23,10,13,91,50,44,68,113,158,34,9,25,13
S01008168,709,32,7,25,118,80,40,95,169,139,29,16,13,7
S01008169,582,34,6,28,119,62,59,73,125,99,7,7,0,4
S01008170,505,143,27,116,127,64,67,26,32,41,4,2,2,1
S01008171,568,52,7,45,130,102,32,64,102,65,3,3,0,18
S01008172,427,36,14,22,120,72,59,33,55,45,4,1,3,3
S01008173,571,87,14,73,136,114,61,55,62,44,8,7,1,4
S01008174,456,56,6,50,116,96,66,40,30,46,0,0,0,6
S01008175,651,67,8,59,153,99,58,62,82,97,26,11,15,7
S01008176,598,164,37,127,170,50,76,51,34,32,4,2,2,17
S01008177,586,78,28,50,129,75,50,40,93,92,25,10,15,4
S01008178,479,57,11,46,129,91,59,44,44,40,13,7,6,2
S01008179,485,95,30,65,142,63,80,29,36,40,0,0,0,0
S01008180,451,89,10,79,154,61,52,40,47,5,0,0,0,3
S01008181,508,104,30,74,157,53,68,41,41,32,3,3,0,9
S01008182,781,95,11,84,169,110,47,83,130,83,29,10,19,35
S01008183,537,79,18,61,135,66,52,76,48,44,10,0,10,27
S01008184,575,61,19,42,162,92,49,31,65,70,15,4,11,30
S01008185,775,46,10,36,190,127,72,73,106,93,41,17,24,27
S01008186,490,40,4,36,164,65,38,58,40,47,17,8,9,21
S01008187,513,66,10,56,107,62,40,35,104,71,19,11,8,9
S01008188,707,50,8,42,136,59,55,70,125,141,27,19,8,44
S01008189,417,55,8,47,75,78,64,37,41,50,5,2,3,12
S01008190,712,39,3,36,122,78,67,71,148,139,30,7,23,18
S01008191,374,30,9,21,109,45,26,47,54,41,16,8,8,6
S01008192,662,59,6,53,166,81,61,59,100,103,22,10,12,11
S01008193,637,129,17,112,141,59,53,48,120,75,11,3,8,1
S01008194,493,83,14,69,98,42,58,38,77,74,18,6,12,5
S01008195,728,28,3,25,127,105,64,86,150,133,23,20,3,12
S01008196,717,22,7,15,96,100,80,98,111,147,53,26,27,10
S01008197,915,116,17,99,239,129,65,130,114,85,26,11,15,11
S01008198,527,14,1,13,93,72,41,81,120,88,15,8,7,3
S01008199,690,4,0,4,77,62,49,93,179,189,37,24,13,0
S01008200,443,29,1,28,47,61,56,46,88,87,21,18,3,8
S01008201,657,40,8,32,89,88,24,90,126,147,42,11,31,11
S01008202,426,25,10,15,110,87,27,29,70,62,9,9,0,7
S01008203,461,12,4,8,75,69,33,34,92,99,41,10,31,6
S01008204,555,55,12,43,166,47,74,54,63,73,21,15,6,2
S01008205,541,31,14,17,101,61,65,76,109,85,11,1,10,2
S01008206,498,23,7,16,83,66,33,74,73,112,31,16,15,3
S01008207,542,16,8,8,62,71,80,69,102,111,22,0,22,9
S01008208,742,74,16,58,185,105,79,86,93,93,15,0,15,12
S01008209,540,46,6,40,143,85,118,62,37,42,3,3,0,4
S01008210,768,62,8,54,190,100,108,98,92,92,23,8,15,3
S01008211,705,76,21,55,165,125,75,48,95,91,21,10,11,9
S01008212,536,67,11,56,168,68,75,63,54,32,3,0,3,6
S01008213,886,171,30,141,237,86,111,99,107,53,14,3,11,8
S01008214,490,41,19,22,133,71,56,65,58,50,16,8,8,0
S01008215,597,45,5,40,177,88,46,66,109,55,11,5,6,0
S01008216,455,54,11,43,118,81,58,43,48,40,4,1,3,9
S01008217,440,105,26,79,169,38,46,47,17,16,2,0,2,0
S01008218,980,175,27,148,327,118,163,50,60,75,2,0,2,10
S01008219,805,91,14,77,175,107,109,48,140,108,20,12,8,7
S01008220,578,27,4,23,89,14,51,92,135,130,33,28,5,7
S01008221,635,39,9,30,88,31,45,71,144,157,51,35,16,9
S01008222,468,23,7,16,96,39,47,69,85,83,19,8,11,7
S01008223,429,23,5,18,92,71,23,31,93,62,30,17,13,4
S01008224,775,65,9,56,167,152,77,122,104,78,6,5,1,4
S01008225,596,27,8,19,168,87,58,78,75,95,3,1,2,5
S01008226,564,15,0,15,81,81,61,42,140,123,16,10,6,5
S01008227,625,18,0,18,85,57,42,82,134,179,21,11,10,7
S01008228,497,48,10,38,138,72,89,43,54,42,11,5,6,0
S01008229,545,21,6,15,107,70,48,54,106,118,17,8,9,4
S01008230,775,78,17,61,209,127,103,74,91,72,17,8,9,4
S01008231,773,101,17,84,221,93,138,100,35,69,2,0,2,14
S01008232,674,88,11,77,166,87,77,56,81,76,38,15,23,5
S01008233,441,58,16,42,136,55,59,42,34,43,11,6,5,3
S01008234,273,8,0,8,58,35,35,22,59,49,3,3,0,4
S01008235,623,42,4,38,115,81,85,89,98,92,15,6,9,6
S01008236,663,90,20,70,161,76,106,70,84,52,15,1,14,9
S01008237,708,65,12,53,168,95,105,46,141,62,26,10,16,0
S01008238,555,26,2,24,115,72,50,86,66,109,25,7,18,6
S01008239,608,78,28,50,157,62,83,70,97,52,9,3,6,0
S01008240,675,165,18,147,236,71,97,41,39,26,0,0,0,0
S01008241,475,88,19,69,188,60,77,16,31,3,5,1,4,7
S01008242,612,114,21,93,165,67,90,43,69,48,14,13,1,2
S01008243,784,209,32,177,240,48,121,80,42,38,1,0,1,5
S01008244,404,90,16,74,131,26,71,22,39,21,4,2,2,0
S01008245,806,176,16,160,288,70,86,67,72,39,8,4,4,0
S01008246,806,264,34,230,245,57,91,41,66,31,4,0,4,7
S01008247,684,167,56,111,167,52,140,57,48,40,12,5,7,1
S01008248,728,147,15,132,181,70,101,69,73,67,9,8,1,11
S01008249,688,154,40,114,207,50,129,45,62,40,1,0,1,0
S01008250,823,237,44,193,255,54,144,28,67,23,5,3,2,10
S01008251,669,214,42,172,229,67,73,31,25,22,2,2,0,6
S01008252,627,146,22,124,205,64,88,39,39,31,8,0,8,7
S01008253,532,51,5,46,102,50,53,45,93,110,19,5,14,9
S01008254,748,59,8,51,175,68,59,115,104,132,36,23,13,0
S01008255,604,70,13,57,170,79,72,51,81,63,12,8,4,6
S01008256,697,45,5,40,116,58,93,91,147,111,17,8,9,19
S01008257,403,60,9,51,101,27,52,33,60,52,12,6,6,6
S01008258,663,109,22,87,218,88,71,30,75,67,3,2,1,2
S01008259,591,126,36,90,153,50,94,31,66,52,11,3,8,8
S01008260,661,34,4,30,126,67,52,90,164,97,28,17,11,3
S01008261,774,58,20,38,135,62,84,111,117,170,23,9,14,14
S01008262,529,136,22,114,111,25,84,57,72,36,8,7,1,0
S01008263,408,127,23,104,107,47,45,21,38,18,3,3,0,2
S01008264,591,92,11,81,151,74,62,54,99,41,15,5,10,3
S01008265,479,140,22,118,192,29,50,30,19,14,1,0,1,4
S01008266,417,143,36,107,141,17,57,19,24,15,1,1,0,0
S01008267,626,151,34,117,168,57,95,33,75,39,6,1,5,2
S01008268,583,223,31,192,191,40,71,21,14,13,6,0,6,4
S01008269,491,159,35,124,159,43,49,31,34,12,1,0,1,3
S01008270,500,162,27,135,191,25,63,6,22,16,11,1,10,4
S01008271,518,55,11,44,165,40,84,43,74,27,22,11,11,8
S01008272,797,182,32,150,275,44,98,69,75,48,6,0,6,0
S01008273,638,158,42,116,190,66,72,61,55,30,4,2,2,2
S01008274,534,74,13,61,68,52,50,94,102,55,30,9,21,9
S01008275,413,115,23,92,123,30,43,32,19,32,13,8,5,6
S01008276,483,157,37,120,140,44,58,20,45,17,2,2,0,0
S01008277,410,93,11,82,120,14,103,33,21,6,20,2,18,0
S01008278,584,208,34,174,183,27,72,19,47,26,2,0,2,0
S01008279,536,65,17,48,144,50,69,46,76,79,7,0,7,0
S01008280,736,147,21,126,205,50,143,58,68,51,11,3,8,3
S01008281,612,107,32,75,168,31,99,48,74,71,9,2,7,5
S01008282,552,85,15,70,150,41,125,64,40,37,6,1,5,4
S01008283,461,141,21,120,142,37,69,27,27,12,6,0,6,0
S01008284,767,159,39,120,196,83,99,72,81,59,18,5,13,0
S01008285,564,20,2,18,95,49,66,80,132,104,14,9,5,4
S01008286,580,64,15,49,113,42,65,84,92,111,6,4,2,3
S01008287,613,87,21,66,115,59,80,65,71,107,19,1,18,10
S01008288,663,125,27,98,193,35,87,44,81,87,11,2,9,0
S01008289,523,27,4,23,125,67,54,61,88,86,10,8,2,5
S01008290,735,125,36,89,220,51,84,55,93,59,35,15,20,13
S01008291,452,63,26,37,84,59,29,95,69,47,6,0,6,0
S01008292,754,105,15,90,126,80,66,62,127,135,39,16,23,14
S01008293,544,163,20,143,188,71,57,30,27,5,3,0,3,0
S01008294,834,222,46,176,241,56,92,83,60,62,10,6,4,8
S01008295,858,91,26,65,191,133,57,154,111,99,12,7,5,10
S01008296,516,56,12,44,96,48,70,66,73,64,29,14,15,14
S01008297,700,114,21,93,167,89,77,76,86,59,26,18,8,6
S01008298,616,54,5,49,157,73,77,94,75,61,24,21,3,1
S01008299,662,36,10,26,154,57,74,45,105,107,72,18,54,12
S01008300,669,37,17,20,155,95,79,67,133,69,30,20,10,4
S01008301,741,139,30,109,197,127,76,64,51,79,2,1,1,6
S01008302,560,137,23,114,183,51,88,37,17,39,4,0,4,4
S01008303,439,69,18,51,97,69,48,31,66,42,14,6,8,3
S01008304,377,91,14,77,100,32,28,54,41,25,3,3,0,3
S01008305,622,110,29,81,199,95,37,72,71,29,5,2,3,4
S01008306,499,48,4,44,157,74,57,60,49,54,0,0,0,0
S01008307,527,96,28,68,158,79,51,44,51,37,8,0,8,3
S01008308,410,65,25,40,149,47,32,64,32,8,9,6,3,4
S01008309,569,52,9,43,88,61,36,72,108,91,53,35,18,8
S01008310,719,62,11,51,187,88,68,102,83,85,35,11,24,9
S01008311,325,50,10,40,68,43,11,39,50,47,12,4,8,5
S01008312,348,45,6,39,101,49,13,25,53,32,20,17,3,10
S01008313,652,36,17,19,123,59,56,63,140,131,43,34,9,1
S01008314,524,18,3,15,93,66,31,57,145,76,23,9,14,15
S01008315,640,31,8,23,90,74,51,79,134,89,63,42,21,29
S01008316,570,42,5,37,66,46,30,44,89,150,95,65,30,8
S01008317,692,46,11,35,179,78,78,62,114,79,44,25,19,12
S01008318,752,125,45,80,239,75,103,55,80,53,15,11,4,7
S01008319,532,50,3,47,123,78,59,54,74,66,19,14,5,9
S01008320,399,48,15,33,120,46,25,57,46,33,19,16,3,5
S01008321,483,58,21,37,138,61,54,71,49,40,12,4,8,0
S01008322,880,83,20,63,177,145,76,102,144,104,32,9,23,17
S01008323,676,27,8,19,87,64,57,75,150,135,67,34,33,14
S01008324,571,64,15,49,97,63,47,58,93,100,24,11,13,25
S01008325,693,28,0,28,106,83,27,96,99,169,61,43,18,24
S01008326,831,29,7,22,121,117,59,87,188,154,46,22,24,30
S01008327,673,52,7,45,100,99,41,98,152,91,36,17,19,4
S01008328,633,166,18,148,219,109,70,25,24,9,7,7,0,4
S01008329,793,163,28,135,287,93,117,55,35,31,6,0,6,6
S01008330,752,136,51,85,249,83,117,40,80,33,14,4,10,0
S01008331,546,98,18,80,173,55,84,39,52,32,10,1,9,3
S01008332,654,171,32,139,234,46,101,27,46,16,5,2,3,8
S01008333,599,216,57,159,203,35,88,8,28,6,13,5,8,2
S01008334,563,143,27,116,178,62,75,36,49,5,12,5,7,3
S01008335,588,100,22,78,174,71,58,38,86,40,8,3,5,13
S01008336,536,84,13,71,142,73,83,27,65,34,24,12,12,4
S01008337,810,211,40,171,275,83,36,83,55,27,23,17,6,17
S01008338,843,296,43,253,292,51,95,36,48,14,4,0,4,7
S01008339,586,168,29,139,182,91,42,20,65,11,6,5,1,1
S01008340,761,182,17,165,248,78,110,40,65,19,9,0,9,10
S01008341,675,204,32,172,238,53,122,14,30,14,0,0,0,0
S01008342,712,216,36,180,230,41,71,42,40,42,21,14,7,9
S01008343,645,261,51,210,218,27,91,17,14,13,4,0,4,0
S01008344,667,260,49,211,206,25,135,12,14,7,8,1,7,0
S01008345,680,252,47,205,217,26,111,20,28,12,12,11,1,2
S01008346,836,286,86,200,282,49,133,33,24,24,3,2,1,2
S01008347,651,180,31,149,228,55,114,15,29,16,10,3,7,4
S01008348,523,185,40,145,162,46,58,16,32,8,10,0,10,6
S01008349,750,293,48,245,281,34,109,11,13,0,6,4,2,3
S01008350,385,113,27,86,150,22,72,12,7,1,5,0,5,3
S01008351,696,246,61,185,256,62,82,14,23,8,2,1,1,3
S01008352,521,227,23,204,161,24,72,14,14,2,3,3,0,4
S01008353,422,151,28,123,96,31,81,12,17,13,12,7,5,9
S01008354,539,161,25,136,140,27,121,33,26,19,10,8,2,2
S01008355,477,75,32,43,125,68,61,30,36,47,21,7,14,14
S01008356,529,121,25,96,161,53,57,42,52,26,4,1,3,13
S01008357,549,141,33,108,153,80,59,32,56,22,3,3,0,3
S01008358,506,66,18,48,146,65,77,57,37,38,16,5,11,4
S01008359,504,91,22,69,147,73,102,60,8,13,7,6,1,3
S01008360,646,203,45,158,218,76,86,16,28,15,2,0,2,2
S01008361,430,75,21,54,150,67,57,27,14,30,2,2,0,8
S01008362,846,162,14,148,341,116,87,47,40,35,10,5,5,8
S01008363,608,181,37,144,170,84,53,37,36,14,7,3,4,26
S01008364,584,161,34,127,173,57,89,23,54,13,5,1,4,9
S01008365,501,160,40,120,173,34,74,25,17,9,7,5,2,2
S01008366,666,96,9,87,194,98,52,25,92,59,24,15,9,26
S01008367,580,76,13,63,167,64,62,28,80,58,20,10,10,25
S01008368,533,98,9,89,202,70,53,24,30,42,4,1,3,10
S01008369,438,87,29,58,137,41,21,24,49,46,23,7,16,10
S01008370,571,136,26,110,164,89,83,18,54,3,16,12,4,8
S01008371,671,149,34,115,236,94,82,44,28,23,7,6,1,8
S01008372,668,159,44,115,209,91,52,80,24,33,12,1,11,8
S01008373,685,209,18,191,299,63,50,36,14,9,5,5,0,0
S01008374,564,117,16,101,246,79,41,22,33,20,0,0,0,6
S01008375,626,151,55,96,245,61,70,33,37,17,7,1,6,5
S01008376,468,184,53,131,109,42,42,26,35,15,12,1,11,3
S01008377,631,169,15,154,234,57,72,34,39,19,2,2,0,5
S01008378,769,231,59,172,264,80,93,36,45,4,12,11,1,4
S01008379,391,73,32,41,187,27,39,32,19,8,4,4,0,2
S01008380,554,146,17,129,239,70,43,22,20,9,5,3,2,0
S01008381,583,156,19,137,216,62,71,21,23,20,6,0,6,8
S01008382,513,159,34,125,178,56,49,29,19,14,3,2,1,6
S01008383,387,127,16,111,138,27,38,24,9,18,2,2,0,4
S01008384,802,165,16,149,225,112,73,80,99,44,0,0,0,4
S01008385,519,180,33,147,186,43,67,14,10,14,5,1,4,0
S01008386,651,106,17,89,205,104,56,70,48,41,7,5,2,14
S01008387,529,75,17,58,180,103,66,17,50,33,5,1,4,0
S01008388,601,86,8,78,208,78,75,33,69,49,0,0,0,3
S01008389,344,118,21,97,87,21,52,18,36,9,3,2,1,0
S01008390,478,166,26,140,159,27,59,23,30,12,0,0,0,2
S01008391,557,200,31,169,191,37,46,19,28,21,12,11,1,3
S01008392,775,303,64,239,293,45,65,30,26,2,7,4,3,4
S01008393,613,201,32,169,235,54,63,10,17,20,10,2,8,3
S01008394,733,371,90,281,232,29,51,14,5,24,0,0,0,7
S01008395,482,85,25,60,209,70,55,28,11,18,2,0,2,4
S01008396,397,80,13,67,148,52,63,11,23,17,3,1,2,0
S01008397,770,256,50,206,255,41,86,72,28,25,4,3,1,3
S01008398,432,135,19,116,129,59,46,24,25,8,5,0,5,1
S01008399,343,84,12,72,119,41,49,20,24,4,1,1,0,1
S01008400,549,150,23,127,175,66,59,13,52,7,18,17,1,9
S01008401,718,146,9,137,247,102,101,32,44,17,13,13,0,16
S01008402,796,299,53,246,247,47,150,14,27,10,0,0,0,2
S01008403,470,198,32,166,141,27,68,9,15,5,2,1,1,5
S01008404,679,242,27,215,233,57,82,13,30,9,13,6,7,0
S01008405,645,282,50,232,174,42,78,15,38,4,4,4,0,8
S01008406,681,220,24,196,230,46,102,14,33,9,17,15,2,10
S01008407,362,79,24,55,134,42,27,13,36,11,17,16,1,3
S01008408,576,125,17,108,184,59,67,28,28,66,10,9,1,9
S01008409,673,111,27,84,138,157,50,53,87,44,27,15,12,6
S01008410,418,112,28,84,93,54,69,15,28,21,23,20,3,3
S01008411,491,65,17,48,160,72,62,26,72,21,11,5,6,2
S01008412,574,114,38,76,181,47,75,57,66,11,13,10,3,10
S01008413,473,109,10,99,115,48,58,21,65,35,17,12,5,5
S01008414,384,97,22,75,136,32,60,14,30,8,0,0,0,7
S01008415,699,85,11,74,181,60,106,70,107,76,9,5,4,5
S01008416,790,71,15,56,177,123,76,79,98,92,64,36,28,10
S01008417,558,173,43,130,179,62,62,19,35,21,6,3,3,1
S01008418,513,149,10,139,155,57,67,20,34,18,2,0,2,11
S01008419,438,166,55,111,164,18,43,6,21,13,2,0,2,5
S01008420,368,132,11,121,111,25,27,35,16,16,2,0,2,4
S01008421,717,136,13,123,197,90,77,44,89,56,15,6,9,13
S01008422,474,179,31,148,196,20,44,4,6,21,0,0,0,4
S01008423,876,346,70,276,267,70,111,16,14,37,11,4,7,4
S01008424,575,228,55,173,184,30,72,25,12,12,3,3,0,9
S01008425,726,200,25,175,187,87,95,40,54,44,7,3,4,12
S01008426,415,40,6,34,87,69,27,49,76,63,0,0,0,4
S01008427,985,267,67,200,241,132,116,91,80,44,3,0,3,11
S01008428,490,64,13,51,106,73,61,35,63,60,10,3,7,18
S01008429,603,166,40,126,171,82,72,25,27,43,10,8,2,7
S01008430,501,141,29,112,149,50,41,25,56,31,2,0,2,6
S01008431,617,151,10,141,196,102,59,28,32,27,15,9,6,7
S01008432,486,115,5,110,141,83,62,41,30,5,6,1,5,3
S01008433,656,93,26,67,182,112,79,65,55,67,2,1,1,1
S01008434,663,134,15,119,234,108,71,48,33,25,3,0,3,7
S01008435,583,132,30,102,149,78,76,67,38,24,0,0,0,19
S01008436,678,187,17,170,226,68,74,38,47,21,9,6,3,8
S01008437,530,177,24,153,131,65,67,19,43,9,5,1,4,14
S01008438,377,89,11,78,165,39,50,2,15,13,0,0,0,4
S01008439,920,379,95,284,335,50,64,37,26,15,4,0,4,10
S01008440,732,334,47,287,238,51,54,16,18,13,7,0,7,1
S01008441,364,164,47,117,111,17,41,8,15,7,1,0,1,0
S01008442,593,224,56,168,202,48,72,18,20,6,3,1,2,0
S01008443,430,163,17,146,127,29,48,13,20,19,5,0,5,6
S01008444,549,195,90,105,144,49,63,29,31,24,8,2,6,6
S01008445,633,130,28,102,297,94,36,13,20,17,14,14,0,12
S01008446,592,243,53,190,205,50,57,15,13,9,0,0,0,0
S01008447,521,182,48,134,174,44,78,11,17,12,3,3,0,0
S01008448,588,128,27,101,136,89,105,29,48,28,2,1,1,23
S01008449,737,42,11,31,95,44,72,71,152,135,97,59,38,29
S01008450,525,16,4,12,55,34,32,42,163,138,25,15,10,20
S01008451,675,25,3,22,32,68,43,59,151,145,118,77,41,34
S01008452,596,11,5,6,54,44,45,62,162,133,39,26,13,46
S01008453,490,34,0,34,69,46,52,52,96,60,48,26,22,33
S01008454,907,15,1,14,107,106,41,67,204,188,156,137,19,23
S01008455,863,34,2,32,89,85,48,101,175,139,103,66,37,89
S01008456,873,23,0,23,104,77,41,106,180,180,108,57,51,54
S01008457,461,8,0,8,61,54,18,35,119,106,46,38,8,14
S01008458,883,52,3,49,178,117,76,94,146,140,49,22,27,31
S01008459,672,17,2,15,62,59,25,89,159,139,85,46,39,37
S01008460,751,13,3,10,51,84,13,72,171,198,122,83,39,27
S01008461,857,12,0,12,81,110,42,84,185,202,106,71,35,35
S01008462,480,12,5,7,31,56,15,40,119,120,77,36,41,10
S01008463,607,30,4,26,64,60,37,67,118,133,70,38,32,28
S01008464,702,45,7,38,131,111,37,98,115,111,36,28,8,18
S01008465,616,28,5,23,85,102,54,65,120,85,41,30,11,36
S01008466,632,30,0,30,77,79,40,74,142,117,17,5,12,56
S01008467,643,18,3,15,86,69,82,106,142,87,29,13,16,24
S01008468,544,21,2,19,47,88,43,77,99,90,47,42,5,32
S01008469,495,35,4,31,105,47,45,45,73,76,4,2,2,65
S01008470,615,24,2,22,43,57,33,59,107,192,70,50,20,30
S01008471,799,36,5,31,95,74,45,52,239,169,71,47,24,18
S01008472,632,23,2,21,100,62,62,68,98,104,45,33,12,70
S01008473,584,33,7,26,77,84,31,56,149,102,32,21,11,20
S01008474,608,28,1,27,63,76,28,84,151,108,37,15,22,33
S01008475,476,17,9,8,82,63,20,46,122,76,19,13,6,31
S01008476,523,38,3,35,92,78,35,54,74,105,33,20,13,14
S01008477,593,24,8,16,109,98,32,83,94,116,23,14,9,14
S01008478,628,53,8,45,134,78,44,44,95,85,45,26,19,50
S01008479,582,34,2,32,100,67,35,54,126,100,42,23,19,24
S01008480,557,45,2,43,116,71,9,42,88,73,49,38,11,64
S01008481,808,70,11,59,124,91,72,85,172,159,21,9,12,14
S01008482,449,30,7,23,90,72,27,33,82,74,19,9,10,22
S01008483,456,21,0,21,74,61,58,36,81,70,16,10,6,39
S01008484,598,62,13,49,121,69,90,68,99,62,14,4,10,13
S01008485,866,63,25,38,285,161,90,60,69,70,19,10,9,49
S01008486,602,59,11,48,159,72,77,46,94,48,19,8,11,28
S01008487,693,156,23,133,179,94,53,52,62,36,5,2,3,56
S01008488,625,86,8,78,139,85,48,54,68,62,8,4,4,75
S01008489,499,51,5,46,88,95,38,33,53,88,20,9,11,33
S01008490,757,104,17,87,177,116,43,65,97,87,21,7,14,47
S01008491,812,142,9,133,142,98,37,30,113,75,17,16,1,158
S01008492,901,110,7,103,228,141,42,59,119,71,40,32,8,91
S01008493,631,62,8,54,119,101,50,32,108,62,24,13,11,73
S01008494,616,50,2,48,129,103,36,51,72,76,36,25,11,63
S01008495,844,108,2,106,202,118,29,56,78,58,33,18,15,162
S01008496,916,158,9,149,220,131,38,68,65,62,29,8,21,145
S01008497,749,126,8,118,184,110,21,47,97,63,18,8,10,83
S01008498,720,116,8,108,162,88,25,80,96,45,27,16,11,81
S01008499,958,154,10,144,183,117,55,66,91,67,35,17,18,190
S01008500,397,44,1,43,58,68,23,21,47,47,34,23,11,55
S01008501,593,164,7,157,162,44,12,27,29,29,12,8,4,114
S01008502,623,107,6,101,165,103,16,24,55,14,18,15,3,121
S01008503,779,191,6,185,259,84,27,51,53,25,5,2,3,84
S01008504,1017,316,34,282,355,94,50,32,42,16,16,7,9,96
S01008505,646,206,29,177,235,45,39,23,26,21,12,1,11,39
S01008506,582,184,28,156,209,41,20,9,54,23,4,2,2,38
S01008507,713,199,12,187,263,73,29,30,36,14,4,4,0,65
S01008508,695,265,24,241,238,42,83,13,23,17,2,0,2,12
S01008509,750,268,44,224,258,84,37,28,35,5,4,2,2,31
S01008510,702,193,35,158,265,48,77,30,26,14,9,9,0,40
S01008511,694,291,42,249,189,40,98,17,25,21,2,0,2,11
S01008512,389,168,41,127,126,24,29,24,6,8,0,0,0,4
S01008513,522,238,53,185,129,41,62,6,28,9,2,2,0,7
S01008514,676,317,30,287,217,34,50,15,14,9,6,3,3,14
S01008515,665,271,38,233,219,46,58,18,27,14,3,0,3,9
S01008516,803,188,14,174,233,79,33,39,58,32,12,1,11,129
S01008517,713,176,17,159,229,77,25,19,22,13,8,6,2,144
S01008518,783,343,39,304,270,37,32,11,28,7,1,1,0,54
S01008519,670,352,38,314,206,26,51,6,20,3,0,0,0,6
S01008520,787,301,48,253,267,45,105,27,19,5,6,1,5,12
S01008521,723,373,50,323,211,51,53,15,18,2,0,0,0,0
S01008522,433,194,33,161,147,25,42,4,5,0,9,5,4,7
S01008523,841,361,98,263,326,45,49,14,24,6,5,2,3,11
S01008524,732,35,11,24,134,105,56,69,137,97,55,32,23,44
S01008525,597,26,2,24,123,64,34,64,143,88,36,16,20,19
S01008526,650,72,6,66,143,112,62,51,87,82,23,11,12,18
S01008527,631,63,15,48,175,95,43,62,99,70,9,4,5,15
S01008528,616,73,9,64,162,98,64,58,96,42,23,3,20,0
S01008529,561,59,19,40,127,89,37,66,101,58,9,4,5,15
S01008530,608,17,2,15,102,78,41,73,161,84,40,23,17,12
S01008531,585,45,11,34,90,104,40,54,107,92,49,41,8,4
S01008532,337,25,3,22,56,58,34,34,52,39,29,13,16,10
S01008533,513,46,6,40,241,153,22,12,14,14,11,10,1,0
S01008534,651,121,22,99,238,131,58,25,36,23,5,4,1,14
S01008535,561,168,29,139,196,51,59,10,27,42,5,1,4,3
S01008536,386,132,11,121,114,44,52,12,23,7,1,0,1,1
S01008537,496,164,25,139,191,38,46,23,21,10,1,0,1,2
S01008538,364,137,22,115,142,26,47,5,4,0,1,1,0,2
S01008539,660,251,40,211,218,57,64,17,23,23,2,0,2,5
S01008540,616,217,30,187,214,47,83,20,13,9,3,0,3,10
S01008541,732,197,27,170,280,112,54,16,32,25,4,1,3,12
S01008542,800,266,49,217,298,109,62,11,27,13,5,4,1,9
S01008543,664,195,27,168,228,59,93,52,13,21,0,0,0,3
S01008544,628,272,36,236,205,25,45,37,24,12,5,1,4,3
S01008545,727,278,47,231,254,57,87,20,17,9,4,1,3,1
S01008546,611,264,61,203,218,32,69,9,14,2,3,3,0,0
S01008547,910,128,17,111,253,128,118,89,97,63,16,13,3,18
S01008548,793,97,20,77,222,103,99,69,77,81,22,8,14,23
S01008549,766,91,18,73,214,107,105,82,92,42,20,12,8,13
S01008550,682,154,24,130,241,76,79,26,63,19,21,19,2,3
S01008551,746,137,19,118,202,118,124,37,69,36,9,6,3,14
S01008552,684,132,17,115,204,86,78,42,80,46,15,7,8,1
S01008553,400,63,8,55,91,54,46,21,55,43,19,16,3,8
S01008554,987,84,11,73,87,67,88,82,184,220,164,114,50,11
S01008555,904,44,10,34,161,93,52,66,172,176,112,73,39,28
S01008556,643,20,5,15,94,68,40,63,105,136,98,67,31,19
S01008557,738,28,6,22,113,70,42,68,185,153,68,54,14,11
S01008558,720,44,10,34,109,73,59,87,147,120,57,40,17,24
S01008559,588,30,4,26,105,54,50,45,122,134,28,21,7,20
S01008560,563,21,4,17,112,52,47,55,101,110,49,42,7,16
S01008561,563,49,13,36,119,57,49,53,112,95,25,19,6,4
S01008562,552,29,4,25,71,74,33,42,130,108,50,27,23,15
S01008563,692,44,3,41,112,66,40,90,162,124,48,22,26,6
S01008564,418,23,4,19,66,62,42,61,78,69,9,4,5,8
S01008565,764,22,3,19,84,107,73,78,149,151,62,31,31,38
S01008566,891,39,10,29,153,79,74,107,182,178,73,53,20,6
S01008567,635,59,7,52,113,71,39,65,120,105,30,26,4,33
S01008568,701,69,7,62,178,99,87,49,123,59,27,18,9,10
S01008569,599,30,0,30,55,36,44,58,105,135,100,62,38,36
S01008570,846,39,4,35,105,63,97,89,162,178,82,48,34,31
S01008571,491,36,6,30,73,54,61,38,104,79,31,22,9,15
S01008572,651,70,10,60,130,58,77,57,103,99,25,19,6,32
S01008573,740,160,23,137,169,116,109,58,40,55,13,12,1,20
S01008574,683,164,26,138,183,81,95,62,46,33,5,2,3,14
S01008575,692,180,28,152,209,74,108,35,49,15,8,6,2,14
S01008576,634,110,5,105,153,71,101,30,72,53,8,5,3,36
S01008577,589,156,17,139,184,51,100,22,41,16,8,4,4,11
S01008578,592,266,52,214,178,35,70,2,14,0,4,4,0,23
S01008579,440,128,23,105,157,37,49,26,12,17,12,6,6,2
S01008580,438,109,12,97,83,70,36,28,44,32,11,1,10,25
S01008581,685,59,8,51,149,82,59,63,133,93,26,10,16,21
S01008582,832,105,9,96,166,110,91,64,86,139,43,23,20,28
S01008583,566,87,8,79,92,56,54,49,87,60,16,10,6,65
S01008584,697,98,11,87,105,66,49,43,122,94,28,15,13,92
S01008585,503,42,3,39,108,56,28,61,91,71,29,26,3,17
S01008586,640,48,2,46,128,66,55,71,84,106,55,33,22,27
S01008587,595,201,25,176,154,47,61,36,30,11,24,23,1,31
S01008588,631,240,13,227,181,45,35,19,26,20,2,2,0,63
S01008589,287,94,10,84,87,43,19,6,21,2,7,7,0,8
S01008590,540,161,23,138,178,46,20,13,26,13,9,6,3,74
S01008591,694,225,12,213,207,35,53,20,48,16,13,8,5,77
S01008592,631,129,11,118,160,29,62,48,55,54,14,8,6,80
S01008593,596,279,42,237,182,25,75,8,5,4,0,0,0,18
S01008594,789,380,40,340,173,47,59,4,27,12,11,9,2,76
S01008595,627,88,13,75,143,64,27,52,77,87,42,34,8,47
S01008596,680,84,2,82,119,95,34,47,84,68,48,37,11,101
S01008597,664,157,29,128,194,96,86,32,48,34,3,0,3,14
S01008598,723,110,3,107,149,57,15,15,55,18,18,11,7,286
S01008599,786,264,42,222,202,26,40,35,30,7,3,3,0,179
S01008600,695,194,25,169,133,36,71,28,27,19,14,7,7,173
S01008601,680,96,9,87,100,30,14,23,55,27,6,6,0,329
S01008602,510,96,11,85,92,32,36,19,29,25,24,15,9,157
S01008603,1055,168,9,159,178,72,43,32,62,31,32,13,19,437
S01008604,765,237,29,208,180,32,54,23,30,13,1,1,0,195
S01008605,654,214,33,181,126,57,25,17,28,14,2,2,0,171
S01008606,657,269,37,232,187,35,52,24,25,14,0,0,0,51
S01008607,446,273,48,225,113,10,17,3,11,6,6,4,2,7
S01008608,515,228,5,223,160,23,36,14,9,5,0,0,0,40
S01008609,692,255,26,229,226,36,82,14,32,3,7,2,5,37
S01008610,607,197,23,174,174,32,51,24,11,9,0,0,0,109
S01008611,1013,228,8,220,195,92,37,32,42,28,13,8,5,346
S01008612,745,146,5,141,120,47,28,28,50,18,16,11,5,292
S01008613,688,212,18,194,153,30,9,16,32,21,20,15,5,195
S01008614,622,146,17,129,77,23,26,10,15,18,7,4,3,300
S01008615,796,185,8,177,133,32,32,16,20,18,4,4,0,356
S01008616,711,123,1,122,124,15,33,5,35,12,9,3,6,355
S01008617,782,118,11,107,119,21,46,17,16,11,1,1,0,433
S01008618,711,128,20,108,79,22,24,14,43,4,9,3,6,388
S01008619,492,94,4,90,109,18,30,9,31,1,7,6,1,193
S01008620,779,143,10,133,128,23,15,27,25,27,4,1,3,387
S01008621,727,132,6,126,95,28,39,8,29,13,12,5,7,371
S01008622,468,133,11,122,102,32,20,13,6,9,1,0,1,152
S01008623,762,221,23,198,151,28,50,4,20,21,2,1,1,265
S01008624,444,180,22,158,130,24,72,13,3,7,1,0,1,14
S01008625,445,261,58,203,108,12,37,0,4,4,10,3,7,9
S01008626,785,344,43,301,230,50,61,29,19,6,7,7,0,39
S01008627,602,245,41,204,239,17,47,12,10,13,4,4,0,15
S01008628,503,159,10,149,163,35,36,6,24,12,4,4,0,64
S01008629,489,139,16,123,158,56,15,8,28,19,8,2,6,58
S01008630,471,85,12,73,130,34,27,3,29,17,14,7,7,132
S01008631,716,209,11,198,201,64,35,23,44,28,20,6,14,92
S01008632,612,164,15,149,250,40,33,17,41,8,7,1,6,52
S01008633,653,283,74,209,177,43,52,4,17,7,11,8,3,59
S01008634,628,232,38,194,159,23,73,9,16,12,1,1,0,103
S01008635,730,267,15,252,179,39,65,22,10,13,8,6,2,127
S01008636,712,221,31,190,191,35,49,16,24,15,5,3,2,156
S01008637,563,200,27,173,154,51,41,15,16,9,0,0,0,77
S01008638,656,139,10,129,153,47,52,26,35,27,12,7,5,165
S01008639,808,246,15,231,222,72,42,41,46,19,5,4,1,115
S01008640,746,237,8,229,160,42,37,12,47,17,7,3,4,187
S01008641,791,166,14,152,183,58,26,26,43,16,4,4,0,269
S01008642,861,268,16,252,244,59,36,14,41,29,2,0,2,168
S01008643,664,200,17,183,229,40,39,32,24,7,7,5,2,86
S01008644,678,130,18,112,199,58,24,21,37,15,21,13,8,173
S01008645,756,139,25,114,200,60,31,38,54,35,4,1,3,195
S01008646,743,184,19,165,208,68,38,31,68,24,11,4,7,111
S01008647,559,153,13,140,142,39,29,28,45,24,5,0,5,94
S01008648,560,116,10,106,109,64,24,48,45,36,10,6,4,108
S01008649,789,143,15,128,224,104,11,52,77,60,7,2,5,111
S01008650,698,168,15,153,154,90,22,45,71,29,7,7,0,112
S01008651,649,137,10,127,130,64,31,33,58,51,41,32,9,104
S01008652,534,86,4,82,91,64,22,36,97,49,24,13,11,65
S01008653,638,99,1,98,135,51,11,56,86,55,25,12,13,120
S01008654,899,159,13,146,218,93,36,37,85,67,29,14,15,175
S01008655,756,171,9,162,171,96,34,36,39,32,16,15,1,161
S01008656,604,66,2,64,135,67,24,32,95,53,30,16,14,102
S01008657,615,95,14,81,153,75,32,36,44,42,44,37,7,94
S01008658,807,141,14,127,162,86,33,57,78,60,40,16,24,150
S01008659,783,87,8,79,127,52,27,72,75,54,17,10,7,272
S01008660,903,196,18,178,169,60,31,38,48,36,54,31,23,271
S01008661,676,80,5,75,113,96,41,53,67,47,25,8,17,154
S01008662,501,77,1,76,78,28,11,31,43,20,18,11,7,195
S01008663,749,76,3,73,147,70,37,27,45,52,17,4,13,278
S01008664,668,154,9,145,126,51,29,24,50,42,19,9,10,173
S01008665,897,163,14,149,218,72,51,64,73,66,34,20,14,156
S01008666,719,136,5,131,145,38,29,34,45,6,10,5,5,276
S01008667,664,123,17,106,129,49,35,26,42,36,17,8,9,207
S01008668,531,86,2,84,85,51,18,15,35,8,13,12,1,220
S01008669,563,24,0,24,56,24,20,10,55,8,9,9,0,357
S01008670,716,48,4,44,93,43,24,18,36,10,10,8,2,434
S01008671,712,71,1,70,75,39,18,18,30,21,8,6,2,432
S01008672,624,111,12,99,73,42,19,12,43,30,5,5,0,289
S01008673,1012,143,14,129,165,55,46,16,72,36,23,14,9,456
S01008674,748,78,0,78,129,47,28,14,54,42,19,9,10,337
S01008675,644,98,22,76,145,46,27,30,63,40,23,10,13,172
S01008676,648,112,7,105,180,57,47,29,40,17,12,9,3,154
S01008677,688,88,5,83,145,49,46,30,46,28,9,7,2,247
S01008678,698,75,16,59,85,44,31,19,41,27,25,18,7,351
S01008679,787,64,8,56,128,40,38,36,73,53,31,20,11,324
S01008680,564,56,6,50,72,50,14,22,43,46,27,14,13,234
S01008681,860,94,7,87,85,47,35,36,54,55,27,17,10,427
S01008682,723,123,11,112,123,44,35,34,81,46,23,15,8,214
S01008683,980,66,6,60,142,70,40,71,150,120,103,60,43,218
S01008684,837,89,10,79,142,63,48,49,137,105,71,40,31,133
S01008685,678,90,5,85,130,79,44,41,78,44,30,11,19,142
S01008686,763,71,7,64,140,82,52,74,127,83,44,33,11,90
S01008687,609,108,18,90,155,73,29,26,61,52,15,8,7,90
S01008688,769,147,22,125,218,87,48,51,77,47,28,17,11,66
S01008689,756,101,15,86,239,84,41,70,80,64,16,8,8,61
S01008690,904,166,13,153,260,122,68,68,90,40,20,9,11,70
S01008691,980,133,27,106,307,144,57,90,103,53,29,12,17,64
S01008692,569,67,9,58,159,80,25,56,67,42,21,10,11,52
S01008693,362,31,0,31,85,44,74,51,38,27,7,0,7,5
S01008694,914,143,14,129,272,146,39,68,115,59,18,7,11,54
S01008695,633,126,11,115,243,84,50,20,48,16,20,8,12,26
S01008696,579,113,18,95,244,59,62,38,16,31,10,4,6,6
S01008697,817,214,28,186,238,98,104,52,50,36,10,6,4,15
S01008698,377,57,8,49,104,56,69,31,50,6,0,0,0,4
S01008699,691,80,19,61,138,108,77,47,106,67,51,33,18,17
S01008700,434,120,41,79,126,53,58,17,15,19,10,9,1,16
S01008701,374,22,0,22,28,42,19,12,108,73,55,21,34,15
S01008702,559,63,10,53,96,77,33,38,88,47,50,26,24,67
S01008703,879,53,0,53,81,62,88,67,150,212,124,89,35,42
S01008704,618,32,13,19,98,70,44,66,135,105,48,31,17,20
S01008705,401,13,0,13,50,29,30,54,69,110,34,21,13,12
S01008706,530,25,3,22,67,60,24,25,133,103,56,29,27,37
S01008707,803,15,1,14,64,100,67,66,195,168,96,78,18,32
S01008708,805,25,0,25,70,75,40,88,188,165,103,63,40,51
S01008709,684,20,0,20,67,51,70,98,167,132,64,40,24,15
S01008710,466,20,0,20,57,34,29,58,114,77,43,16,27,34
S01008711,568,9,0,9,87,35,32,78,126,133,51,36,15,17
S01008712,790,45,4,41,54,63,59,106,175,171,72,47,25,45
S01008713,567,10,3,7,37,64,37,58,166,94,82,47,35,19
S01008714,426,38,4,34,63,51,38,29,81,74,46,31,15,6
S01008715,561,32,8,24,94,68,38,62,103,127,28,21,7,9
S01008716,373,15,11,4,70,45,59,29,51,80,14,11,3,10
S01008717,408,12,0,12,67,68,53,27,102,54,16,6,10,9
S01008718,433,42,10,32,69,76,62,33,78,55,7,5,2,11
S01008719,900,46,5,41,129,121,177,98,161,100,51,40,11,17
S01008720,404,37,1,36,45,57,56,35,73,47,24,14,10,30
S01008721,740,122,15,107,203,102,111,89,45,52,8,0,8,8
S01008722,729,162,49,113,200,88,138,40,47,37,6,4,2,11
S01008723,510,119,18,101,136,91,78,41,26,19,0,0,0,0
S01008724,713,174,20,154,264,53,101,53,37,12,10,7,3,9
S01008725,612,148,19,129,205,58,73,27,36,40,16,9,7,9
S01008726,488,169,28,141,195,36,44,11,14,16,0,0,0,3
S01008727,853,259,44,215,288,63,80,39,47,27,16,13,3,34
S01008728,471,64,5,59,117,44,44,34,85,33,44,32,12,6
S01008729,637,214,42,172,214,33,84,11,42,25,8,7,1,6
S01008730,740,145,23,122,235,87,76,42,54,41,46,21,25,14
S01008731,279,31,9,22,83,34,25,27,48,16,13,5,8,2
S01008732,511,32,7,25,116,79,61,40,82,47,42,20,22,12
S01008733,680,107,14,93,158,118,43,48,93,90,9,1,8,14
S01008734,448,91,8,83,169,44,48,15,33,14,25,14,11,9
S01008735,756,181,34,147,271,52,105,44,75,19,9,5,4,0
S01008736,533,95,31,64,174,27,95,53,41,25,11,8,3,12
S01008737,582,107,22,85,188,73,82,37,42,36,9,5,4,8
S01008738,552,150,28,122,143,66,95,38,26,26,8,8,0,0
S01008739,448,52,13,39,101,74,73,45,54,41,6,0,6,2
S01008740,404,37,8,29,123,66,55,37,41,29,11,7,4,5
S01008741,694,98,26,72,175,95,99,74,88,42,18,8,10,5
S01008742,301,39,3,36,86,50,52,6,35,20,9,8,1,4
S01008743,733,55,5,50,180,85,54,65,116,111,37,24,13,30
S01008744,802,119,15,104,163,114,68,46,141,117,23,6,17,11
S01008745,358,84,6,78,100,57,22,15,40,18,10,7,3,12
S01008746,894,63,9,54,157,114,61,68,145,159,78,54,24,49
S01008747,369,67,9,58,133,34,48,29,30,15,4,4,0,9
S01008748,456,106,7,99,139,60,54,28,32,32,1,1,0,4
S01008749,729,100,13,87,223,66,144,60,60,56,18,15,3,2
S01008750,481,100,20,80,124,58,85,27,48,23,12,0,12,4
S01008751,473,50,10,40,101,85,54,39,48,57,30,10,20,9
S01008752,619,17,5,12,103,108,29,52,130,99,64,39,25,17
S01008753,424,14,0,14,85,64,29,35,81,78,27,7,20,11
S01008754,500,41,2,39,107,82,43,46,71,82,13,9,4,15
S01008755,814,42,6,36,150,115,56,98,138,123,63,32,31,29
S01008756,567,30,2,28,92,72,36,61,130,84,30,11,19,32
S01008757,499,12,1,11,41,61,48,36,118,118,61,33,28,4
S01008758,633,23,5,18,83,81,72,61,120,130,43,29,14,20
S01008759,454,23,3,20,65,67,40,36,110,66,37,27,10,10
S01008760,808,40,12,28,99,85,54,75,183,179,77,48,29,16
S01008761,662,61,4,57,160,70,70,62,77,104,25,16,9,33
S01008762,469,68,10,58,142,63,44,39,42,53,11,10,1,7
S01008763,808,162,20,142,282,110,82,32,68,57,12,2,10,3
S01008764,614,145,28,117,221,61,60,29,44,37,7,4,3,10
S01008765,754,160,20,140,242,79,87,49,68,42,14,10,4,13
S01008766,824,155,40,115,230,115,147,52,66,35,14,14,0,10
S01008767,447,49,12,37,133,82,49,31,40,49,3,0,3,11
S01008768,430,48,8,40,127,54,48,36,53,46,8,5,3,10
S01008769,640,172,21,151,229,81,33,36,28,15,18,8,10,28
S01008770,835,213,42,171,196,82,88,46,60,57,28,17,11,65
S01008771,722,170,17,153,193,66,59,38,112,28,20,15,5,36
S01008772,606,158,16,142,209,69,50,33,25,43,2,1,1,17
S01008773,879,147,26,121,246,122,64,67,120,74,24,9,15,15
S01008774,820,74,8,66,183,107,67,76,88,126,63,29,34,36
S01008775,409,69,7,62,115,47,55,44,34,27,9,5,4,9
S01008776,741,76,5,71,173,101,39,52,121,91,55,39,16,33
S01008777,829,84,6,78,170,71,52,102,164,112,50,24,26,24
S01008778,1049,194,14,180,326,115,67,67,128,63,49,26,23,40
S01008779,692,168,29,139,244,72,53,46,43,24,8,0,8,34
S01008780,565,95,6,89,187,57,49,32,53,49,11,10,1,32
S01008781,862,131,16,115,211,83,44,94,120,96,42,21,21,41
S01008782,722,153,11,142,208,90,42,44,80,54,14,7,7,37
S01008783,409,80,7,73,135,43,19,26,45,31,20,15,5,10
S01008784,428,74,14,60,125,45,33,38,66,22,15,11,4,10
S01008785,727,60,7,53,122,69,51,72,120,102,79,62,17,52
S01008786,837,139,22,117,267,87,39,90,56,72,50,31,19,37
S01008787,336,11,0,11,23,28,16,25,72,81,58,40,18,22
S01008788,656,129,19,110,205,68,22,72,71,47,9,6,3,33
S01008789,469,53,5,48,95,76,45,52,53,74,8,6,2,13
S01008790,569,62,7,55,123,63,48,38,67,73,49,33,16,46
S01008791,828,119,9,110,153,93,77,96,87,108,41,24,17,54
S01008792,700,113,19,94,194,89,46,50,95,60,36,28,8,17
S01008793,360,24,1,23,77,45,29,39,52,44,24,16,8,26
S01008794,642,76,5,71,151,91,42,53,118,71,23,5,18,17
S01008795,1044,141,15,126,249,121,84,84,141,117,32,21,11,75
S01008796,1001,73,5,68,220,120,76,81,161,125,82,57,25,63
S01008797,823,90,5,85,238,95,45,54,134,67,25,17,8,75
S01008798,683,78,7,71,170,83,33,71,115,56,30,10,20,47
S01008799,638,54,0,54,123,66,48,75,98,64,51,32,19,59
S01008800,996,115,13,102,299,90,79,98,123,111,15,6,9,66
S01008801,891,116,9,107,218,107,47,121,100,85,27,13,14,70
S01008802,885,102,8,94,203,86,55,87,132,97,33,15,18,90
S01008803,861,102,16,86,184,118,54,75,138,93,46,27,19,51
S01008804,502,48,12,36,108,68,21,51,50,62,27,22,5,67
S01008805,583,100,3,97,116,79,25,42,65,23,14,4,10,119
S01008806,977,182,19,163,288,103,71,80,72,57,20,11,9,104
S01008807,727,110,14,96,211,95,44,72,70,61,11,5,6,53
S01008808,575,152,5,147,149,44,70,30,51,34,14,8,6,31
S01008809,557,144,34,110,138,29,76,16,40,14,23,8,15,77
S01008810,682,162,17,145,223,61,32,33,31,56,13,8,5,71
S01008811,771,155,25,130,212,58,47,52,46,61,16,7,9,124
S01008812,433,105,5,100,120,31,23,20,40,26,1,0,1,67
S01008813,868,92,9,83,220,98,79,82,138,63,56,38,18,40
S01008814,761,117,13,104,183,98,74,79,80,51,16,7,9,63
S01008815,853,98,12,86,253,104,39,62,83,108,44,25,19,62
S01008816,447,84,10,74,125,64,22,26,45,34,30,24,6,17
S01008817,719,110,12,98,154,88,40,82,99,80,46,28,18,20
S01008818,723,131,6,125,219,83,75,62,67,42,26,23,3,18
S01008819,624,151,14,137,239,58,44,23,38,39,7,4,3,25
S01008820,993,114,9,105,312,123,55,58,134,100,59,23,36,38
S01008821,647,209,31,178,219,40,60,31,41,27,17,8,9,3
S01008822,619,220,39,181,226,28,70,12,42,7,6,1,5,8
S01008823,507,193,42,151,168,28,70,10,15,11,6,3,3,6
S01008824,771,243,40,203,287,79,38,32,57,18,15,8,7,2
S01008825,495,183,34,149,151,53,48,19,20,18,1,1,0,2
S01008826,569,131,19,112,149,61,55,49,58,33,19,12,7,14
S01008827,584,293,37,256,186,21,50,21,6,1,4,1,3,2
S01008828,708,197,30,167,261,67,64,32,44,16,12,5,7,15
S01008829,564,146,24,122,147,39,60,35,41,47,16,16,0,33
S01008830,527,208,33,175,192,43,40,6,12,4,3,0,3,19
S01008831,553,189,22,167,153,62,95,14,15,6,4,0,4,15
S01008832,508,164,43,121,139,34,86,23,26,14,6,2,4,16
S01008833,754,316,40,276,226,46,32,27,33,22,9,9,0,43
S01008834,856,260,46,214,278,92,116,34,26,35,6,1,5,9
S01008835,628,161,46,115,204,86,38,54,41,28,4,4,0,12
S01008836,579,96,13,83,161,65,34,55,61,51,15,14,1,41
S01008837,948,271,36,235,275,122,59,43,58,59,25,15,10,36
S01008838,892,204,23,181,303,114,46,69,67,37,9,5,4,43
S01008839,911,252,25,227,273,122,69,40,50,49,5,4,1,51
S01008840,959,263,31,232,307,93,55,46,48,38,13,8,5,96
S01008841,516,102,7,95,142,67,63,24,57,23,7,7,0,31
S01008842,845,170,17,153,211,83,66,44,92,55,32,26,6,92
S01008843,805,228,20,208,230,73,67,45,68,23,8,5,3,63
S01008844,653,163,12,151,207,56,43,22,61,28,13,0,13,60
S01008845,797,211,21,190,211,40,37,19,41,23,8,3,5,207
S01008846,740,178,16,162,187,68,88,36,22,25,4,1,3,132
S01008847,527,162,25,137,127,31,40,18,24,10,0,0,0,115
S01008848,693,205,38,167,202,50,43,7,21,20,17,10,7,128
S01008849,636,192,22,170,191,31,49,15,36,18,2,2,0,102
S01008850,703,266,40,226,199,33,35,10,10,4,7,4,3,139
S01008851,839,257,37,220,274,57,60,31,44,36,13,2,11,67
S01008852,812,308,66,242,267,29,59,10,25,10,5,3,2,99
S01008853,647,224,24,200,160,51,38,34,23,9,15,6,9,93
S01008854,818,259,50,209,240,39,57,13,15,10,10,6,4,175
S01008855,973,329,44,285,351,62,60,26,40,6,13,7,6,86
S01008856,525,147,18,129,182,45,27,15,38,21,10,4,6,40
S01008857,688,236,25,211,215,52,44,30,50,17,9,2,7,35
S01008858,463,152,23,129,193,30,35,10,14,9,4,0,4,16
S01008859,910,281,39,242,312,82,81,45,40,17,9,3,6,43
S01008860,768,217,10,207,245,82,57,28,52,19,11,5,6,57
S01008861,625,247,31,216,237,15,75,5,12,3,6,0,6,25
S01008862,787,284,42,242,225,82,64,34,23,21,8,4,4,46
S01008863,629,218,39,179,240,62,34,12,28,18,1,1,0,16
S01008864,585,215,14,201,243,42,24,15,21,13,1,0,1,11
S01008865,718,263,19,244,212,78,24,22,74,15,2,1,1,28
S01008866,717,293,36,257,247,60,52,10,27,16,5,0,5,7
S01008867,655,285,51,234,247,37,54,10,9,2,2,0,2,9
S01008868,682,195,32,163,209,42,39,41,30,13,7,2,5,106
S01008869,808,280,21,259,259,71,58,28,24,16,9,0,9,63
S01008870,629,244,47,197,208,38,48,22,24,7,12,5,7,26
S01008871,922,295,55,240,297,48,53,18,41,19,10,5,5,141
S01008872,769,238,29,209,204,48,52,19,35,18,5,5,0,150
S01008873,589,214,52,162,207,48,59,2,15,19,5,1,4,20
S01008874,700,237,29,208,221,50,40,31,36,24,8,4,4,53
S01008875,680,151,25,126,201,77,43,75,59,23,4,1,3,47
S01008876,418,134,20,114,125,55,44,18,27,6,4,2,2,5
S01008877,450,154,27,127,142,50,45,17,22,12,3,0,3,5
S01008878,650,135,25,110,130,110,94,31,65,54,13,8,5,18
S01008879,637,139,17,122,159,89,60,24,61,67,29,11,18,9
S01008880,499,129,21,108,182,62,35,33,24,17,6,3,3,11
S01008881,343,136,36,100,106,23,38,6,6,6,15,9,6,7
S01008882,837,396,78,318,299,52,55,23,12,0,0,0,0,0
S01008883,659,328,79,249,193,37,66,8,8,4,6,4,2,9
S01008884,461,201,26,175,176,22,32,3,5,1,6,5,1,15
S01008885,722,351,59,292,205,41,84,7,22,5,6,4,2,1
S01008886,642,215,18,197,204,68,40,26,28,9,11,2,9,41
S01008887,592,176,20,156,215,41,49,29,35,29,3,3,0,15
S01008888,501,172,23,149,163,71,19,10,10,11,9,3,6,36
S01008889,436,98,20,78,135,43,69,26,24,23,11,6,5,7
S01008890,537,129,11,118,188,58,67,37,25,23,8,0,8,2
S01008891,565,172,40,132,190,66,78,21,20,13,1,0,1,4
S01008892,712,226,51,175,231,75,36,46,52,18,12,4,8,16
S01008893,700,271,30,241,263,43,72,6,16,11,7,4,3,11
S01008894,674,245,39,206,270,35,77,9,14,5,10,7,3,9
S01008895,555,216,36,180,190,31,71,21,13,7,0,0,0,6
S01008896,484,205,62,143,165,34,24,16,25,5,5,5,0,5
S01008897,516,214,19,195,116,59,59,15,31,4,11,10,1,7
S01008898,660,273,61,212,196,48,85,26,14,8,6,6,0,4
S01008899,666,30,3,27,75,68,61,73,143,146,45,23,22,25
S01008900,755,64,9,55,149,96,44,94,132,141,31,21,10,4
S01008901,674,52,12,40,126,73,68,62,101,129,38,16,22,25
S01008902,839,55,15,40,150,113,67,84,161,135,48,34,14,26
S01008903,707,31,9,22,150,83,58,107,145,103,27,23,4,3
S01008904,953,29,5,24,105,81,43,104,248,186,87,72,15,70
S01008905,998,22,1,21,118,87,47,70,249,251,100,61,39,54
S01008906,769,18,5,13,87,83,57,75,195,145,73,38,35,36
S01008907,625,10,0,10,43,37,47,59,160,149,85,74,11,35
S01008908,806,74,9,65,109,86,59,99,106,153,85,67,18,35
S01008909,681,49,13,36,107,80,70,89,120,135,28,6,22,3
S01008910,416,44,7,37,76,40,41,45,46,90,20,20,0,14
S01008911,828,185,17,168,203,107,92,43,63,60,26,9,17,49
S01008912,656,147,21,126,188,78,83,51,47,49,11,6,5,2
S01008913,633,131,12,119,154,60,66,50,53,71,19,13,6,29
S01008914,650,78,14,64,128,103,73,52,77,119,13,10,3,7
S01008915,456,99,19,80,154,41,80,21,26,21,7,0,7,7
S01008916,805,31,6,25,129,113,50,64,199,155,50,21,29,14
S01008917,596,19,3,16,72,87,47,68,126,118,46,28,18,13
S01008918,553,5,0,5,32,34,38,65,145,141,71,45,26,22
S01008919,512,21,0,21,47,49,25,66,69,122,89,57,32,24
S01008920,1035,205,21,184,307,139,73,56,90,61,31,21,10,73
S01008921,646,18,1,17,68,56,37,89,173,127,68,23,45,10
S01008922,641,30,10,20,110,79,58,71,137,93,49,27,22,14
S01008923,603,25,3,22,67,81,63,55,113,144,41,15,26,14
S01008924,911,31,15,16,78,104,57,116,236,185,74,38,36,30
S01008925,655,21,4,17,88,106,51,73,133,106,53,28,25,24
S01008926,555,41,4,37,106,98,53,47,73,107,24,15,9,6
S01008927,779,72,11,61,177,157,58,63,91,113,16,8,8,32
S01008928,439,57,11,46,90,43,45,47,56,61,13,1,12,27
S01008929,706,11,5,6,62,32,25,61,161,186,138,80,58,30
S01008930,793,11,0,11,79,72,42,80,153,243,97,48,49,16
S01008931,669,4,0,4,117,48,24,60,163,176,72,46,26,5
S01008932,814,75,5,70,171,101,88,85,128,95,34,19,15,37
S01008933,647,27,5,22,76,65,30,64,134,134,101,60,41,16
S01008934,714,84,16,68,120,58,62,56,122,129,63,46,17,20
S01008935,672,122,23,99,177,145,61,57,48,47,9,3,6,6
S01008936,320,113,25,88,114,8,38,24,11,8,0,0,0,4
S01008937,632,122,19,103,179,95,67,51,51,46,11,6,5,10
S01008938,575,146,11,135,175,45,102,37,26,28,12,3,9,4
S01008939,568,102,21,81,165,94,90,34,44,21,15,1,14,3
S01008940,440,145,16,129,187,32,45,8,4,16,1,0,1,2
S01008941,680,253,57,196,262,45,67,5,17,19,3,0,3,9
S01008942,585,186,31,155,182,76,57,36,25,12,10,5,5,1
S01008943,579,219,54,165,200,47,79,7,11,2,11,5,6,3
S01008944,745,267,57,210,238,53,103,20,27,20,2,0,2,15
S01008945,629,210,32,178,225,51,96,14,11,8,9,4,5,5
S01008946,652,240,45,195,208,43,85,16,32,15,13,0,13,0
S01008947,747,320,61,259,190,79,81,31,20,19,4,0,4,3
S01008948,594,180,31,149,177,63,65,42,28,31,3,0,3,5
S01008949,709,76,26,50,170,92,81,53,104,126,4,3,1,3
S01008950,710,94,16,78,155,95,90,58,100,86,18,13,5,14
S01008951,655,50,14,36,119,112,45,76,108,99,31,27,4,15
S01008952,688,38,9,29,78,92,56,58,164,136,50,31,19,16
S01008953,693,59,11,48,159,99,82,52,105,91,26,12,14,20
S01008954,600,69,15,54,132,68,74,45,97,65,38,21,17,12
S01008955,518,125,36,89,142,83,64,33,47,23,0,0,0,1
S01008956,789,141,35,106,199,152,70,65,85,61,3,1,2,13
S01008957,832,135,43,92,199,99,68,73,135,66,32,16,16,25
S01008958,576,68,8,60,176,83,46,43,57,57,32,30,2,14
S01008959,710,96,8,88,165,141,72,52,79,88,11,11,0,6
S01008960,885,303,73,230,322,57,97,29,53,9,9,8,1,6
S01008961,611,103,17,86,203,80,58,38,69,32,18,13,5,10
S01008962,509,97,15,82,170,84,52,18,38,35,6,2,4,9
S01008963,574,134,26,108,216,60,54,41,37,25,3,2,1,4
S01008964,373,137,34,103,101,36,33,29,27,6,4,2,2,0
S01008965,506,151,21,130,173,37,90,20,24,4,4,4,0,3
S01008966,446,97,22,75,100,85,60,33,25,23,10,10,0,13
S01008967,763,217,21,196,261,75,108,26,38,25,11,11,0,2
S01008968,749,245,50,195,255,74,94,29,31,15,2,0,2,4
S01008969,817,198,26,172,229,132,77,57,74,30,14,11,3,6
S01008970,806,228,23,205,343,73,68,17,46,21,8,7,1,2
S01008971,583,216,21,195,213,45,51,27,20,10,1,0,1,0
S01008972,611,278,49,229,187,51,51,19,17,3,2,0,2,3
S01008973,558,155,28,127,183,79,57,16,36,25,5,0,5,2
S01008974,612,125,31,94,192,80,25,36,69,45,25,19,6,15
S01008975,419,92,4,88,91,67,32,17,56,29,10,2,8,25
S01008976,407,147,19,128,107,49,56,7,14,8,1,0,1,18
S01008977,464,115,25,90,167,53,45,22,25,14,9,1,8,14
S01008978,494,47,8,39,141,76,49,28,83,60,4,0,4,6
S01008979,696,93,7,86,183,120,62,46,88,59,21,14,7,24
S01008980,750,76,6,70,179,128,65,89,90,61,43,19,24,19
S01008981,461,113,20,93,135,56,60,27,36,26,4,0,4,4
S01008982,691,59,12,47,114,171,69,80,87,38,41,26,15,32
S01008983,618,37,4,33,127,104,43,97,83,90,21,18,3,16
S01008984,458,55,8,47,90,96,23,42,64,61,26,20,6,1
S01008985,559,62,5,57,127,101,51,53,81,64,10,5,5,10
S01008986,595,68,9,59,168,88,79,63,76,42,8,0,8,3
S01008987,613,65,11,54,158,155,106,33,62,28,6,0,6,0
S01008988,713,117,10,107,163,150,67,63,74,48,12,8,4,19
S01008989,606,107,7,100,171,123,42,43,52,55,6,1,5,7
S01008990,690,111,5,106,198,149,60,59,34,67,4,0,4,8
S01008991,872,169,25,144,298,106,90,85,59,37,3,3,0,25
S01008992,445,70,10,60,115,59,26,42,68,37,15,9,6,13
S01008993,857,213,68,145,251,103,101,64,60,37,14,5,9,14
S01008994,618,51,1,50,125,60,58,63,75,144,34,28,6,8
S01008995,737,220,45,175,269,63,65,31,52,23,13,7,6,1
S01008996,422,33,11,22,71,56,43,52,78,67,18,5,13,4
S01008997,855,175,30,145,208,92,120,68,87,73,22,7,15,10
S01008998,577,30,0,30,97,57,36,78,119,108,36,20,16,16
S01008999,622,85,11,74,172,77,52,49,76,97,14,6,8,0
S01009000,711,176,33,143,190,95,82,58,65,29,13,8,5,3
S01009001,728,210,38,172,205,104,75,61,43,30,0,0,0,0
S01009002,669,184,70,114,212,52,68,43,58,44,8,5,3,0
S01009003,832,229,15,214,347,59,77,34,50,18,1,1,0,17
S01009004,583,77,20,57,148,103,74,60,62,56,0,0,0,3
S01009005,601,82,7,75,156,91,49,102,56,47,10,2,8,8
S01009006,611,107,8,99,141,87,34,61,70,85,19,14,5,7
S01009007,574,41,4,37,133,119,33,55,98,70,15,6,9,10
S01009008,688,191,47,144,200,75,56,33,59,47,21,5,16,6
S01009009,365,10,0,10,60,62,27,46,71,63,22,14,8,4
S01009010,930,187,48,139,322,123,54,76,87,67,10,3,7,4
S01009011,820,188,45,143,308,113,70,51,43,35,4,0,4,8
S01009012,659,123,6,117,236,102,70,42,41,33,0,0,0,12
S01009013,780,156,31,125,264,94,46,60,86,58,6,0,6,10
S01009014,486,29,24,5,78,50,130,65,78,49,6,0,6,1
S01009015,472,23,13,10,139,47,84,47,59,54,19,0,19,0
S01009016,378,21,8,13,109,38,62,54,35,50,9,3,6,0
S01009017,489,25,1,24,104,55,83,58,73,65,26,12,14,0
S01009018,601,47,7,40,150,59,76,85,57,97,6,1,5,24
S01009019,418,24,4,20,105,59,43,77,45,56,5,2,3,4
S01009020,704,55,9,46,186,82,75,78,98,98,31,12,19,1
S01009021,527,42,18,24,135,25,118,56,78,66,7,5,2,0
S01009022,604,44,10,34,161,42,93,65,84,91,19,3,16,5
S01009023,632,53,14,39,124,44,169,60,99,60,11,0,11,12
S01009024,650,41,10,31,163,51,102,85,87,115,4,0,4,2
S01009025,677,44,12,32,156,49,129,95,120,62,14,5,9,8
S01009026,617,63,14,49,153,36,78,62,67,118,20,7,13,20
S01009027,547,56,26,30,139,43,101,63,75,53,16,0,16,1
S01009028,353,23,0,23,74,28,73,72,38,43,2,0,2,0
S01009029,452,58,3,55,120,30,76,44,37,64,18,2,16,5
S01009030,558,25,5,20,114,48,95,63,75,123,9,1,8,6
S01009031,550,19,10,9,150,69,68,67,89,80,8,1,7,0
S01009032,429,37,7,30,91,40,57,54,70,64,9,3,6,7
S01009033,573,44,17,27,146,40,98,56,99,81,6,0,6,3
S01009034,502,65,29,36,123,49,50,68,42,99,5,0,5,1
S01009035,711,69,19,50,168,96,109,89,79,94,7,0,7,0
S01009036,916,73,17,56,230,86,127,95,101,184,11,0,11,9
S01009037,741,67,20,47,174,106,102,93,73,111,11,3,8,4
S01009038,910,75,19,56,231,81,111,117,97,173,22,4,18,3
S01009039,558,28,7,21,104,44,72,74,102,108,16,5,11,10
S01009040,453,31,3,28,101,54,48,45,71,78,17,10,7,8
S01009041,598,103,31,72,126,57,74,83,51,82,14,5,9,8
S01009042,647,61,11,50,139,67,48,69,100,127,25,5,20,11
S01009043,462,52,0,52,76,47,47,51,85,91,13,0,13,0
S01009044,556,54,16,38,123,60,65,63,98,82,9,0,9,2
S01009045,492,43,6,37,104,43,66,71,64,90,4,2,2,7
S01009046,680,44,3,41,204,45,84,79,87,128,6,0,6,3
S01009047,658,46,5,41,180,70,84,85,104,87,2,0,2,0
S01009048,661,74,34,40,184,71,51,66,103,99,3,0,3,10
S01009049,471,42,1,41,146,40,67,54,66,54,0,0,0,2
S01009050,597,57,8,49,151,85,47,82,63,93,15,13,2,4
S01009051,661,27,1,26,126,78,80,93,89,153,10,3,7,5
S01009052,430,20,15,5,111,76,67,49,44,55,4,0,4,4
S01009053,471,6,1,5,58,53,26,42,94,131,59,14,45,2
S01009054,485,20,5,15,103,47,49,60,65,126,12,5,7,3
S01009055,649,70,19,51,147,68,107,71,64,106,12,2,10,4
S01009056,481,20,8,12,52,46,65,53,84,130,18,3,15,13
S01009057,446,23,2,21,71,34,36,42,103,100,31,6,25,6
S01009058,588,35,2,33,130,80,26,74,95,119,17,5,12,12
S01009059,782,124,30,94,180,82,86,88,88,98,34,15,19,2
S01009060,522,82,16,66,167,45,97,52,23,53,0,0,0,3
S01009061,688,46,10,36,140,90,40,76,111,153,26,10,16,6
S01009062,496,12,3,9,57,100,33,76,92,96,19,9,10,11
S01009063,590,73,15,58,138,72,62,69,65,109,0,0,0,2
S01009064,459,33,0,33,84,61,21,45,75,103,26,6,20,11
S01009065,557,25,0,25,58,61,53,71,100,127,52,23,29,10
S01009066,526,24,6,18,93,55,46,64,84,135,24,8,16,1
S01009067,805,109,40,69,220,106,120,103,69,69,9,6,3,0
S01009068,754,48,9,39,129,152,64,109,85,131,29,11,18,7
S01009069,569,68,10,58,189,65,72,79,41,53,1,0,1,1
S01009070,537,55,13,42,121,93,62,65,58,63,11,7,4,9
S01009071,417,45,16,29,112,47,73,44,21,38,24,16,8,13
S01009072,455,48,11,37,124,36,78,45,50,64,0,0,0,10
S01009073,467,18,10,8,61,34,60,56,100,104,28,7,21,6
S01009074,596,23,5,18,71,55,58,83,87,149,51,27,24,19
S01009075,433,24,7,17,63,49,46,59,68,104,17,6,11,3
S01009076,833,85,24,61,198,169,100,83,66,118,6,2,4,8
S01009077,512,47,14,33,137,61,30,74,64,74,22,19,3,3
S01009078,794,173,25,148,293,101,63,53,52,47,7,5,2,5
S01009079,682,26,10,16,93,74,52,82,139,191,23,8,15,2
S01009080,733,31,5,26,117,75,93,120,126,132,28,14,14,11
S01009081,498,36,20,16,143,50,58,59,61,82,6,6,0,3
S01009082,808,53,20,33,130,119,113,94,117,135,32,10,22,15
S01009083,647,41,9,32,149,87,29,89,92,120,28,21,7,12
S01009084,455,44,17,27,138,29,90,36,51,53,12,12,0,2
S01009085,817,106,26,80,241,124,69,98,53,108,14,4,10,4
S01009086,597,21,5,16,139,92,57,87,72,104,17,6,11,8
S01009087,472,29,2,27,78,39,36,47,131,94,15,7,8,3
S01009088,828,128,28,100,258,88,106,76,78,79,15,10,5,0
S01009089,913,225,68,157,307,86,123,92,40,32,4,1,3,4
S01009090,734,183,27,156,262,102,74,28,47,26,0,0,0,12
S01009091,694,214,41,173,274,46,62,56,21,13,3,0,3,5
S01009092,818,120,45,75,224,89,70,105,89,103,12,0,12,6
S01009093,679,21,2,19,140,76,54,88,123,143,23,3,20,11
S01009094,453,82,12,70,195,40,22,60,22,29,3,2,1,0
S01009095,619,106,14,92,183,76,76,48,70,49,11,10,1,0
S01009096,850,183,43,140,290,110,87,53,74,39,10,10,0,4
S01009097,811,139,29,110,317,98,59,86,66,45,1,0,1,0
S01009098,413,74,19,55,174,46,34,36,14,19,16,0,16,0
S01009099,554,54,13,41,134,48,48,78,76,86,26,23,3,4
S01009100,554,30,14,16,112,61,59,73,86,100,20,14,6,13
S01009101,776,24,11,13,107,90,65,96,187,179,24,7,17,4
S01009102,757,18,6,12,83,91,43,110,168,177,52,22,30,15
S01009103,448,52,10,42,141,61,28,52,55,42,13,7,6,4
S01009104,628,25,9,16,149,84,37,78,126,103,12,4,8,14
S01009105,682,65,21,44,229,101,71,70,62,64,11,6,5,9
S01009106,430,25,4,21,81,70,34,45,69,89,14,1,13,3
S01009107,738,136,33,103,191,102,34,98,79,80,14,11,3,4
S01009108,563,65,21,44,164,76,61,87,60,47,0,0,0,3
S01009109,580,80,14,66,195,75,48,61,66,46,0,0,0,9
S01009110,461,34,0,34,101,60,51,62,60,81,8,5,3,4
S01009111,769,94,28,66,203,134,82,78,70,98,4,3,1,6
S01009112,421,69,21,48,145,44,42,54,39,28,0,0,0,0
S01009113,702,108,27,81,245,83,85,84,43,52,1,0,1,1
S01009114,719,88,31,57,188,66,66,93,93,116,9,2,7,0
S01009115,508,45,3,42,166,62,38,71,57,55,4,1,3,10
S01009116,377,52,15,37,119,47,23,66,45,22,3,0,3,0
S01009117,752,61,8,53,164,117,47,106,88,124,40,12,28,5
S01009118,597,81,15,66,165,83,44,110,42,60,8,4,4,4
S01009119,633,27,0,27,79,59,57,100,114,150,44,24,20,3
S01009120,431,26,4,22,80,31,28,51,96,89,19,6,13,11
S01009121,661,34,1,33,125,74,44,90,121,143,20,3,17,10
S01009122,746,84,15,69,196,68,101,84,79,96,25,2,23,13
S01009123,523,101,31,70,172,55,38,52,28,72,3,0,3,2
S01009124,531,52,10,42,153,65,60,55,58,88,0,0,0,0
S01009125,502,39,10,29,117,43,45,67,67,101,22,10,12,1
S01009126,503,5,1,4,67,32,26,53,114,136,62,35,27,8
S01009127,571,17,4,13,83,49,35,78,127,112,53,9,44,17
S01009128,623,20,4,16,78,52,33,76,117,153,89,52,37,5
S01009129,424,5,4,1,51,48,16,45,127,104,28,15,13,0
S01009130,586,52,16,36,140,61,50,55,81,108,35,19,16,4
S01009131,375,14,2,12,51,42,21,51,75,88,26,16,10,7
S01009132,762,135,39,96,236,97,45,84,76,59,18,6,12,12
S01009133,475,11,6,5,64,38,34,73,92,136,26,10,16,1
S01009134,732,95,48,47,175,92,52,98,98,99,13,1,12,10
S01009135,544,61,5,56,151,69,43,83,49,59,26,18,8,3
S01009136,624,76,11,65,211,87,73,47,53,58,11,6,5,8
S01009137,601,126,44,82,249,58,57,49,42,18,0,0,0,2
S01009138,764,123,34,89,252,80,92,71,58,59,9,4,5,20
S01009139,371,23,0,23,65,53,23,28,67,59,40,16,24,13
S01009140,587,54,11,43,109,68,34,95,79,106,20,13,7,22
S01009141,645,43,7,36,117,84,45,100,109,104,36,14,22,7
S01009142,482,22,3,19,110,55,39,50,71,99,27,6,21,9
S01009143,457,14,5,9,78,57,32,40,87,109,28,13,15,12
S01009144,641,101,15,86,163,91,61,69,58,72,2,0,2,24
S01009145,783,30,13,17,173,85,63,111,147,135,29,13,16,10
S01009146,771,23,1,22,166,77,56,73,141,156,53,20,33,26
S01009147,674,42,2,40,74,78,58,71,152,149,43,25,18,7
S01009148,575,20,18,2,72,39,26,97,120,149,41,11,30,11
S01009149,650,68,11,57,181,106,60,100,70,52,9,6,3,4
S01009150,163,7,1,6,20,15,14,11,42,46,8,5,3,0
S01009151,565,90,19,71,172,57,61,43,66,64,5,1,4,7
S01009152,418,44,6,38,82,69,31,44,43,77,15,4,11,13
S01009153,396,47,0,47,106,61,38,36,44,42,9,1,8,13
S01009154,664,140,30,110,195,66,114,39,57,37,8,3,5,8
S01009155,437,138,27,111,149,26,29,34,34,22,2,0,2,3
S01009156,417,110,11,99,130,48,62,26,15,20,6,3,3,0
S01009157,655,65,10,55,122,68,81,93,105,113,5,2,3,3
S01009158,428,14,0,14,127,65,18,48,79,55,17,7,10,5
S01009159,435,6,0,6,33,37,36,58,103,107,46,27,19,9
S01009160,513,29,7,22,67,66,47,78,100,94,24,5,19,8
S01009161,487,6,1,5,54,57,33,62,106,123,41,5,36,5
S01009162,572,24,5,19,115,73,30,70,88,126,38,19,19,8
S01009163,346,43,7,36,82,33,15,48,66,48,9,1,8,2
S01009164,608,26,10,16,75,75,43,111,114,143,15,1,14,6
S01009165,612,23,2,21,108,49,48,84,106,140,49,22,27,5
S01009166,716,26,8,18,92,74,37,65,160,197,52,24,28,13
S01009167,476,14,5,9,48,56,59,53,93,104,33,15,18,16
S01009168,465,75,23,52,146,60,38,53,46,42,4,1,3,1
S01009169,433,17,4,13,81,49,42,100,74,51,14,5,9,5
S01009170,595,26,0,26,90,90,46,62,110,110,50,13,37,11
S01009171,591,34,11,23,113,48,61,92,86,103,47,11,36,7
S01009172,535,187,40,147,196,36,43,30,18,21,2,1,1,2
S01009173,628,168,42,126,179,52,62,84,29,45,1,0,1,8
S01009174,480,110,35,75,167,58,51,41,24,28,0,0,0,1
S01009175,810,202,50,152,278,97,84,85,21,33,6,0,6,4
S01009176,735,208,46,162,250,69,70,65,48,14,11,1,10,0
S01009177,728,20,2,18,111,109,90,109,104,121,44,24,20,20
S01009178,682,25,10,15,101,78,57,85,114,154,48,20,28,20
S01009179,617,28,2,26,138,82,45,47,138,109,20,1,19,10
S01009180,808,30,8,22,124,94,66,140,179,147,24,13,11,4
S01009181,692,25,12,13,92,66,83,89,141,158,23,15,8,15
S01009182,859,84,12,72,241,99,121,91,100,103,18,2,16,2
S01009183,683,75,15,60,243,91,73,87,55,50,4,0,4,5
S01009184,668,66,26,40,90,54,111,83,101,111,44,11,33,8
S01009185,753,61,10,51,107,67,105,100,149,126,35,20,15,3
S01009186,668,61,11,50,127,60,104,73,117,93,26,7,19,7
S01009187,422,72,15,57,127,37,63,39,37,44,3,3,0,0
S01009188,752,69,9,60,140,44,101,102,129,123,37,20,17,7
S01009189,654,39,5,34,86,36,53,83,152,162,42,24,18,1
S01009190,708,131,24,107,199,93,94,88,59,39,4,1,3,1
S01009191,737,177,50,127,265,82,67,69,38,31,3,0,3,5
S01009192,510,47,15,32,143,81,58,48,48,72,13,0,13,0
S01009193,304,39,15,24,124,31,17,47,16,27,3,3,0,0
S01009194,630,118,31,87,223,81,69,62,41,31,5,0,5,0
S01009195,757,162,34,128,291,88,41,65,49,48,9,2,7,4
S01009196,534,57,3,54,114,70,80,61,58,70,9,6,3,15
S01009197,916,184,26,158,361,91,82,64,57,66,4,0,4,7
S01009198,597,82,13,69,201,71,61,71,45,50,12,3,9,4
S01009199,524,91,20,71,191,55,49,49,47,29,12,7,5,1
S01009200,956,224,48,176,292,76,64,111,75,100,8,4,4,6
S01009201,569,26,6,20,113,50,50,84,104,109,25,2,23,8
S01009202,464,73,16,57,194,42,45,42,42,24,0,0,0,2
S01009203,498,13,1,12,66,43,55,70,86,111,49,20,29,5
S01009204,823,76,16,60,199,91,85,74,129,137,19,11,8,13
S01009205,634,91,24,67,199,105,44,63,44,86,1,0,1,1
S01009206,715,122,35,87,236,111,42,75,75,42,10,4,6,2
S01009207,564,90,19,71,190,75,28,75,54,48,1,0,1,3
S01009208,460,72,19,53,144,66,40,46,44,32,8,3,5,8
S01009209,433,81,21,60,169,45,30,29,40,33,1,0,1,5
S01009210,454,92,13,79,160,63,42,36,32,22,7,0,7,0
S01009211,552,48,12,36,102,59,60,88,84,89,15,6,9,7
S01009212,640,39,16,23,91,72,53,91,130,137,19,9,10,8
S01009213,692,26,9,17,116,64,71,98,124,159,23,12,11,11
S01009214,826,120,22,98,255,110,55,84,100,84,12,4,8,6
S01009215,749,47,7,40,159,64,71,77,138,133,43,18,25,17
S01009216,722,31,9,22,131,89,62,97,117,155,30,27,3,10
S01009217,534,18,0,18,82,55,50,63,129,93,35,20,15,9
S01009218,587,57,22,35,140,85,64,71,64,94,7,3,4,5
S01009219,475,13,4,9,83,55,43,74,86,89,27,5,22,5
S01009220,412,14,2,12,56,56,33,49,70,95,29,11,18,10
S01009221,461,9,2,7,61,55,31,67,73,133,32,13,19,0
S01009222,450,14,2,12,32,34,28,59,103,143,26,4,22,11
S01009223,423,17,0,17,74,55,32,60,78,95,8,5,3,4
S01009224,510,17,4,13,58,65,37,80,87,135,28,7,21,3
S01009225,406,12,2,10,55,43,16,69,82,116,8,2,6,5
S01009226,683,23,8,15,155,72,38,71,126,159,33,13,20,6
S01009227,399,14,8,6,82,59,30,63,69,67,10,1,9,5
S01009228,457,24,2,22,66,29,28,40,85,133,46,6,40,6
S01009229,436,33,4,29,118,34,40,65,62,62,9,9,0,13
S01009230,483,29,7,22,99,99,47,52,58,87,8,5,3,4
S01009231,771,75,18,57,206,86,71,130,75,100,22,1,21,6
S01009232,516,14,3,11,65,68,8,59,94,116,71,31,40,21
S01009233,396,22,4,18,77,24,35,66,59,102,10,2,8,1
S01009234,911,26,5,21,74,89,29,134,216,232,79,41,38,32
S01009235,776,25,2,23,123,99,40,100,125,176,71,15,56,17
S01009236,330,33,8,25,80,52,32,56,29,42,6,0,6,0
S01009237,648,64,30,34,216,79,69,120,74,19,5,2,3,2
S01009238,517,18,0,18,96,75,20,80,79,124,25,3,22,0
S01009239,720,20,8,12,141,89,31,147,120,125,34,11,23,13
S01009240,580,11,7,4,53,56,24,75,134,140,62,24,38,25
S01009241,735,26,8,18,100,77,44,67,138,207,62,23,39,14
S01009242,544,58,22,36,133,49,49,112,80,55,8,2,6,0
S01009243,898,60,9,51,151,102,84,170,171,128,21,5,16,11
S01009244,634,89,22,67,188,65,66,87,76,56,0,0,0,7
S01009245,657,72,15,57,213,89,47,70,84,70,12,9,3,0
S01009246,628,25,7,18,94,64,54,110,131,121,25,10,15,4
S01009247,852,53,20,33,148,76,30,155,150,194,40,3,37,6
S01009248,533,40,15,25,140,62,73,70,83,56,4,1,3,5
S01009249,665,36,15,21,89,68,74,75,127,163,30,13,17,3
S01009250,504,40,9,31,72,47,42,62,98,127,16,6,10,0
S01009251,458,58,6,52,114,38,44,58,54,64,24,5,19,4
S01009252,457,82,19,63,172,46,37,62,27,28,3,0,3,0
S01009253,327,7,2,5,48,41,37,60,60,61,8,0,8,5
S01009254,654,21,0,21,64,47,48,77,146,168,68,29,39,15
S01009255,553,55,25,30,85,54,33,77,110,102,30,7,23,7
S01009256,347,43,21,22,110,53,7,41,39,45,5,4,1,4
S01009257,529,76,19,57,94,61,60,37,97,80,18,8,10,6
S01009258,494,106,18,88,135,37,69,38,48,54,7,2,5,0
S01009259,762,165,52,113,253,66,86,58,61,63,2,0,2,8
S01009260,961,81,23,58,222,135,98,77,167,133,36,21,15,12
S01009261,558,45,8,37,79,55,34,68,116,123,28,5,23,10
S01009262,495,17,4,13,62,51,30,61,119,115,29,5,24,11
S01009263,753,151,17,134,257,68,62,69,73,58,12,6,6,3
S01009264,380,39,8,31,119,39,48,53,44,32,3,3,0,3
S01009265,627,33,7,26,150,54,22,97,128,95,36,5,31,12
S01009266,647,47,16,31,115,73,56,108,121,102,25,19,6,0
S01009267,632,61,5,56,147,62,55,92,121,71,15,6,9,8
S01009268,846,56,17,39,209,72,61,104,124,167,33,3,30,20
S01009269,767,26,8,18,104,125,30,80,151,188,52,18,34,11
S01009270,443,15,8,7,43,44,36,49,117,99,34,14,20,6
S01009271,758,64,15,49,248,117,78,84,63,96,8,3,5,0
S01009272,620,10,0,10,85,54,40,85,133,167,32,18,14,14
S01009273,350,89,37,52,112,32,30,47,23,14,0,0,0,3
S01009274,495,56,9,47,125,61,55,54,66,66,6,1,5,6
S01009275,487,68,28,40,120,56,99,36,39,59,9,4,5,1
S01009276,683,124,36,88,177,67,65,94,81,60,14,4,10,1
S01009277,428,92,23,69,109,54,103,23,19,12,10,0,10,6
S01009278,471,109,15,94,182,59,25,29,28,37,1,1,0,1
S01009279,466,58,21,37,114,45,70,47,41,74,15,8,7,2
S01009280,724,10,0,10,77,69,33,85,167,182,90,50,40,11
S01009281,661,43,11,32,89,71,23,89,113,184,43,19,24,6
S01009282,609,113,22,91,184,48,80,60,61,39,20,12,8,4
S01009283,402,78,26,52,103,51,32,40,43,46,9,2,7,0
S01009284,730,156,46,110,229,106,91,49,57,35,0,0,0,7
S01009285,805,76,13,63,211,161,56,93,101,88,11,4,7,8
S01009286,561,87,25,62,200,72,61,54,52,30,0,0,0,5
S01009287,527,126,17,109,188,62,71,10,40,29,0,0,0,1
S01009288,574,150,42,108,197,31,71,34,31,37,9,7,2,14
S01009289,635,146,27,119,185,74,68,51,50,42,13,3,10,6
S01009290,479,133,37,96,150,65,43,33,29,18,1,1,0,7
S01009291,812,123,23,100,259,131,83,85,60,65,0,0,0,6
S01009292,426,17,0,17,84,43,37,64,60,97,10,2,8,14
S01009293,618,84,23,61,191,64,84,41,72,61,10,2,8,11
S01009294,426,85,15,70,163,43,40,42,26,23,4,0,4,0
S01009295,512,87,18,69,125,74,54,76,42,54,0,0,0,0
S01009296,433,57,19,38,131,43,47,75,28,45,5,3,2,2
S01009297,720,189,49,140,256,90,42,40,46,40,9,3,6,8
S01009298,729,59,4,55,165,68,51,80,144,98,57,30,27,7
S01009299,801,148,24,124,227,103,95,62,79,62,13,8,5,12
S01009300,438,65,6,59,114,62,27,48,46,33,33,17,16,10
S01009301,798,81,11,70,138,107,57,76,109,122,91,36,55,17
S01009302,753,30,2,28,115,79,34,41,205,179,56,29,27,14
S01009303,561,113,36,77,222,48,27,54,51,33,13,4,9,0
S01009304,785,92,26,66,190,120,91,85,96,80,21,7,14,10
S01009305,586,72,13,59,177,83,35,54,87,59,16,4,12,3
S01009306,962,124,23,101,237,131,58,91,144,98,60,33,27,19
S01009307,837,133,25,108,261,102,60,91,82,51,31,12,19,26
S01009308,437,88,17,71,113,56,41,29,37,42,18,7,11,13
S01009309,636,129,26,103,194,81,54,48,59,33,32,7,25,6
S01009310,727,158,32,126,206,97,64,69,65,52,11,5,6,5
S01009311,644,23,0,23,127,64,40,89,114,144,41,22,19,2
S01009312,562,79,18,61,195,87,33,34,54,44,27,8,19,9
S01009313,425,7,1,6,108,64,22,51,62,84,22,15,7,5
S01009314,532,94,15,79,123,85,36,58,60,65,8,7,1,3
S01009315,504,35,11,24,87,80,55,59,51,99,35,21,14,3
S01009316,638,199,33,166,193,74,44,49,39,29,11,1,10,0
S01009317,681,116,23,93,242,96,69,75,43,30,1,0,1,9
S01009318,527,146,29,117,212,64,33,23,39,6,0,0,0,4
S01009319,602,156,33,123,210,64,49,48,37,37,1,1,0,0
S01009320,513,86,3,83,155,58,37,47,60,56,6,5,1,8
S01009321,497,100,22,78,170,57,25,44,46,47,0,0,0,8
S01009322,604,65,14,51,156,116,64,48,42,90,13,5,8,10
S01009323,451,20,3,17,128,56,51,33,70,63,19,8,11,11
S01009324,423,28,3,25,89,56,35,34,71,83,21,8,13,6
S01009325,662,129,22,107,233,83,58,65,43,42,7,5,2,2
S01009326,577,100,21,79,209,58,16,46,54,63,21,11,10,10
S01009327,398,80,12,68,104,61,27,23,45,45,6,0,6,7
S01009328,673,167,17,150,258,81,49,57,28,29,0,0,0,4
S01009329,424,53,4,49,157,80,32,41,26,19,13,4,9,3
S01009330,486,43,11,32,158,71,20,38,82,52,19,12,7,3
S01009331,556,168,17,151,180,86,34,37,23,28,0,0,0,0
S01009332,738,156,31,125,268,116,61,48,39,40,3,0,3,7
S01009333,614,34,7,27,108,120,51,72,90,100,22,15,7,17
S01009334,507,24,8,16,84,76,16,46,92,109,46,11,35,14
S01009335,648,29,6,23,107,79,30,74,99,183,38,16,22,9
S01009336,546,10,0,10,86,64,29,86,92,78,77,27,50,24
S01009337,656,22,0,22,106,84,40,77,124,128,63,25,38,12
S01009338,568,30,9,21,84,57,26,46,133,132,53,20,33,7
S01009339,748,10,7,3,113,73,35,134,150,140,86,24,62,7
S01009340,478,5,0,5,59,54,31,43,115,141,24,12,12,6
S01009341,471,19,6,13,58,70,47,71,77,90,35,9,26,4
S01009342,597,39,7,32,111,103,25,82,73,125,38,5,33,1
S01009343,494,24,3,21,130,64,21,50,108,77,11,8,3,9
S01009344,485,13,0,13,75,75,33,45,118,102,21,12,9,3
S01009345,806,38,0,38,202,98,55,102,150,124,28,9,19,9
S01009346,701,168,32,136,292,54,97,31,29,23,7,3,4,0
S01009347,670,235,55,180,256,45,66,36,16,7,6,0,6,3
S01009348,502,130,23,107,174,57,41,34,34,27,0,0,0,5
S01009349,810,187,26,161,293,108,49,55,36,65,9,1,8,8
S01009350,591,80,8,72,201,89,44,53,43,54,20,8,12,7
S01009351,512,114,29,85,189,65,29,37,30,35,2,2,0,11
S01009352,780,170,28,142,367,75,35,48,42,30,11,0,11,2
S01009353,383,70,11,59,142,44,44,38,19,14,7,0,7,5
S01009354,897,191,40,151,354,105,85,62,44,52,0,0,0,4
S01009355,684,107,22,85,167,121,68,104,74,38,0,0,0,5
S01009356,757,109,21,88,251,121,56,89,46,73,8,4,4,4
S01009357,455,131,33,98,138,58,39,40,22,19,2,0,2,6
S01009358,642,263,60,203,221,52,42,37,13,14,0,0,0,0
S01009359,733,168,23,145,272,97,74,27,62,17,9,0,9,7
S01009360,666,131,39,92,195,92,43,70,64,58,4,3,1,9
S01009361,601,89,10,79,171,79,48,56,74,65,12,12,0,7
S01009362,805,119,26,93,260,137,63,93,77,56,0,0,0,0
S01009363,663,42,12,30,124,101,38,109,112,109,22,8,14,6
S01009364,771,62,8,54,187,127,58,112,115,93,11,1,10,6
S01009365,446,35,3,32,111,76,28,47,49,81,14,9,5,5
S01009366,569,27,7,20,95,67,68,55,99,113,36,14,22,9
S01009367,516,32,5,27,104,67,31,80,99,77,17,4,13,9
S01009368,512,23,0,23,68,85,37,44,105,102,25,6,19,23
S01009369,485,26,0,26,103,71,37,75,63,87,16,11,5,7
S01009370,633,50,8,42,141,97,29,68,113,107,19,13,6,9
S01009371,437,29,7,22,107,52,15,62,81,66,17,8,9,8
S01009372,432,23,3,20,73,61,42,59,99,61,13,8,5,1
S01009373,681,27,2,25,119,94,34,81,163,119,39,19,20,5
S01009374,638,68,18,50,89,95,24,104,102,118,24,11,13,14
S01009375,685,29,6,23,124,57,27,101,161,138,35,7,28,13
S01009376,456,24,7,17,64,82,17,57,74,119,15,7,8,4
S01009377,950,76,6,70,288,124,45,119,148,106,41,9,32,3
S01009378,914,35,4,31,175,135,96,80,181,149,29,8,21,34
S01009379,957,144,23,121,258,150,73,118,91,71,31,9,22,21
S01009380,531,47,37,10,140,69,28,62,67,91,6,0,6,21
S01009381,563,99,26,73,155,88,55,52,49,43,14,4,10,8
S01009382,597,50,16,34,118,78,56,62,91,119,14,5,9,9
S01009383,683,43,3,40,130,99,57,64,123,105,46,14,32,16
S01009384,443,116,27,89,171,41,46,25,21,11,12,6,6,0
S01009385,431,84,15,69,114,59,42,54,39,27,12,6,6,0
S01009386,519,24,10,14,105,69,30,80,91,87,24,7,17,9
S01009387,486,44,9,35,74,75,32,48,103,78,26,6,20,6
S01009388,842,33,8,25,127,105,35,94,166,168,89,33,56,25
S01009389,691,114,23,91,201,92,68,64,64,62,16,2,14,10
S01009390,734,222,54,168,295,55,47,41,29,41,0,0,0,4
S01009391,672,126,35,91,258,108,54,48,46,31,0,0,0,1
S01009392,554,140,22,118,192,79,49,38,28,25,0,0,0,3
S01009393,587,114,12,102,222,83,75,27,31,31,4,0,4,0
S01009394,731,190,19,171,231,73,55,60,54,42,12,1,11,14
S01009395,489,160,33,127,143,51,47,35,24,25,4,0,4,0
S01009396,548,162,43,119,219,60,49,26,10,18,2,0,2,2
S01009397,572,144,30,114,172,67,60,45,62,13,7,0,7,2
S01009398,589,76,14,62,170,95,65,66,71,38,4,1,3,4
S01009399,551,99,25,74,168,71,31,41,68,47,16,2,14,10
S01009400,394,33,17,16,88,76,44,45,52,47,6,0,6,3
S01009401,476,121,29,92,114,85,31,58,43,20,1,0,1,3
S01009402,705,117,21,96,292,54,76,73,57,30,6,4,2,0
S01009403,482,81,19,62,155,89,30,53,46,23,4,4,0,1
S01009404,458,31,10,21,77,43,44,73,58,87,31,18,13,14
S01009405,318,34,13,21,109,36,55,44,23,15,2,0,2,0
S01009406,734,52,12,40,154,97,81,74,117,122,22,12,10,15
S01009407,406,35,7,28,118,35,62,41,47,66,2,0,2,0
S01009408,655,88,18,70,188,96,63,84,53,69,7,0,7,7
S01009409,491,21,7,14,71,50,40,76,90,104,33,12,21,6
S01009410,778,23,15,8,123,80,56,93,197,158,43,32,11,5
S01009411,742,20,6,14,110,66,85,101,147,168,41,12,29,4
S01009412,673,21,12,9,85,67,42,106,146,169,37,22,15,0
S01009413,782,43,12,31,143,83,85,120,100,176,23,7,16,9
S01009414,522,18,8,10,98,67,35,57,93,121,19,6,13,14
S01009415,648,46,22,24,92,93,73,82,88,112,59,37,22,3
S01009416,450,48,13,35,119,74,61,59,49,36,4,0,4,0
S01009417,277,23,4,19,75,30,62,25,29,25,2,1,1,6
S01009418,830,44,8,36,135,67,53,122,140,222,36,15,21,11
S01009419,486,20,10,10,74,65,27,55,97,130,14,10,4,4
S01009420,563,7,1,6,74,30,16,49,145,197,33,14,19,12
S01009421,613,18,6,12,73,57,42,92,108,167,48,19,29,8
S01009422,622,39,10,29,101,85,37,98,98,122,30,15,15,12
S01009423,877,130,18,112,287,112,78,104,52,95,9,0,9,10
S01009424,441,65,18,47,98,50,35,38,62,72,13,8,5,8
S01009425,542,33,11,22,117,65,42,62,90,87,35,10,25,11
S01009426,590,20,5,15,85,77,43,73,114,113,55,27,28,10
S01009427,443,21,5,16,48,69,39,45,83,86,47,25,22,5
S01009428,503,21,0,21,84,54,54,58,67,109,46,23,23,10
S01009429,512,18,3,15,81,50,19,69,90,138,39,29,10,8
S01009430,609,36,17,19,98,69,44,55,166,104,28,20,8,9
S01009431,515,13,0,13,110,37,58,81,55,110,40,27,13,11
S01009432,700,0,0,0,67,52,30,90,220,169,54,32,22,18
S01009433,693,29,3,26,54,83,45,64,169,159,79,36,43,11
S01009434,425,4,4,0,54,50,38,56,68,103,37,21,16,15
S01009435,659,15,2,13,73,47,47,94,143,165,64,35,29,11
S01009436,606,34,14,20,114,46,38,82,150,98,39,15,24,5
S01009437,528,33,13,20,82,53,80,63,93,106,13,5,8,5
S01009438,689,37,6,31,80,55,83,82,134,161,41,24,17,16
S01009439,748,13,3,10,123,48,45,97,149,205,49,26,23,19
S01009440,468,30,8,22,49,49,43,58,106,102,27,17,10,4
S01009441,718,20,4,16,91,74,44,87,172,162,53,23,30,15
S01009442,509,38,3,35,138,63,82,69,47,49,15,13,2,8
S01009443,543,45,11,34,137,45,86,76,64,68,14,2,12,8
S01009444,750,120,23,97,182,98,79,90,93,80,8,6,2,0
S01009445,631,18,7,11,98,56,68,93,122,154,14,8,6,8
S01009446,696,15,2,13,89,80,55,55,171,149,66,29,37,16
S01009447,388,25,7,18,69,53,23,43,72,73,25,12,13,5
S01009448,680,63,21,42,142,78,69,79,106,109,27,9,18,7
S01009449,420,19,10,9,74,62,38,31,86,86,17,15,2,7
S01009450,488,0,0,0,63,61,28,51,97,142,46,20,26,0
S01009451,854,13,3,10,109,85,100,101,164,192,83,46,37,7
S01009452,395,16,2,14,48,48,27,39,99,79,31,10,21,8
S01009453,783,21,10,11,117,90,45,128,119,211,44,17,27,8
S01009454,710,214,35,179,230,57,56,40,65,28,17,10,7,3
S01009455,644,168,32,136,238,60,87,24,25,37,0,0,0,5
S01009456,514,28,11,17,115,53,53,66,88,83,20,12,8,8
S01009457,452,57,12,45,129,38,90,41,48,40,5,0,5,4
S01009458,510,52,12,40,148,70,45,60,44,68,17,6,11,6
S01009459,683,42,11,31,189,63,71,73,99,79,44,11,33,23
S01009460,745,25,6,19,96,70,29,77,150,195,86,26,60,17
S01009461,542,146,33,113,195,62,42,21,27,46,1,1,0,2
S01009462,548,89,17,72,123,52,36,64,63,111,9,3,6,1
S01009463,483,45,10,35,112,53,64,57,57,78,9,1,8,8
S01009464,684,51,12,39,190,125,60,92,79,68,15,3,12,4
S01009465,472,37,13,24,150,46,42,62,70,45,17,8,9,3
S01009466,411,111,27,84,121,42,47,38,37,10,2,0,2,3
S01009467,593,109,22,87,226,60,54,30,34,62,11,3,8,7
S01009468,557,50,14,36,120,54,45,58,112,92,24,5,19,2
S01009469,602,96,20,76,186,75,37,66,75,48,11,1,10,8
S01009470,339,33,7,26,87,39,33,31,63,42,11,2,9,0
S01009471,437,37,6,31,79,34,18,41,68,100,42,17,25,18
S01009472,784,59,16,43,205,43,58,59,142,123,92,28,64,3
S01009473,764,32,3,29,111,63,46,128,140,129,84,24,60,31
S01009474,804,70,13,57,145,83,74,92,122,103,98,31,67,17
S01009475,514,108,35,73,155,59,89,30,32,31,3,3,0,7
S01009476,444,127,37,90,159,19,45,32,17,36,5,5,0,4
S01009477,561,101,7,94,198,51,54,42,55,42,9,3,6,9
S01009478,730,46,14,32,210,90,52,56,131,82,34,22,12,29
S01009479,608,92,22,70,143,44,55,78,72,68,35,11,24,21
S01009480,584,102,22,80,210,57,79,48,30,32,8,3,5,18
S01009481,731,67,16,51,182,99,56,62,134,99,17,11,6,15
S01009482,503,55,4,51,100,49,33,65,107,62,17,11,6,15
S01009483,647,73,1,72,219,63,65,62,76,54,21,5,16,14
S01009484,517,53,12,41,110,69,31,57,93,62,33,7,26,9
S01009485,569,35,2,33,83,40,61,68,109,116,36,9,27,21
S01009486,429,80,30,50,114,49,46,47,54,28,7,5,2,4
S01009487,576,21,9,12,113,76,41,80,104,100,26,18,8,15
S01009488,596,42,11,31,110,72,44,83,125,95,23,6,17,2
S01009489,610,51,12,39,63,53,48,86,113,136,49,27,22,11
S01009490,740,28,0,28,65,88,26,95,150,169,90,35,55,29
S01009491,473,31,1,30,76,63,50,47,77,96,25,12,13,8
S01009492,597,14,4,10,118,71,46,61,100,171,11,5,6,5
S01009493,566,170,19,151,206,44,57,36,19,32,2,0,2,0
S01009494,843,150,39,111,267,105,102,101,77,34,4,1,3,3
S01009495,738,116,27,89,203,111,83,85,70,62,8,1,7,0
S01009496,607,21,3,18,90,96,60,81,100,133,20,20,0,6
S01009497,750,47,6,41,183,100,53,109,138,104,11,5,6,5
S01009498,471,57,12,45,133,61,62,57,45,46,6,0,6,4
S01009499,624,78,23,55,109,75,53,72,96,106,30,14,16,5
S01009500,615,8,1,7,112,77,46,46,141,104,69,34,35,12
S01009501,495,15,3,12,68,47,41,69,110,96,46,12,34,3
S01009502,697,11,3,8,106,87,46,75,150,174,30,11,19,18
S01009503,598,17,4,13,118,89,57,66,115,109,20,11,9,7
S01009504,613,9,0,9,66,51,31,99,147,141,60,29,31,9
S01009505,714,22,2,20,71,83,20,73,162,156,116,56,60,11
S01009506,632,11,2,9,79,59,52,73,170,110,57,16,41,21
S01009507,773,48,25,23,167,108,61,108,119,121,32,15,17,9
S01009508,749,19,4,15,83,63,66,93,167,167,75,25,50,16
S01009509,844,33,7,26,133,81,79,106,190,158,45,26,19,19
S01009510,528,39,6,33,120,113,55,73,65,52,6,1,5,5
S01009511,407,59,18,41,124,42,61,50,41,20,10,0,10,0
S01009512,617,79,13,66,162,100,64,86,52,64,4,0,4,6
S01009513,445,62,18,44,167,56,31,35,42,39,4,1,3,9
S01009514,580,72,7,65,204,79,46,71,49,49,10,4,6,0
S01009515,535,31,5,26,56,71,40,91,90,113,35,17,18,8
S01009516,584,26,4,22,112,79,45,93,112,99,15,11,4,3
S01009517,942,157,24,133,300,134,71,108,100,61,10,0,10,1
S01009518,918,138,37,101,333,122,109,81,83,49,3,0,3,0
S01009519,425,26,7,19,85,48,60,51,56,77,22,12,10,0
S01009520,739,133,44,89,191,80,80,55,81,86,19,16,3,14
S01009521,649,18,3,15,92,60,70,74,115,167,39,22,17,14
S01009522,904,47,7,40,110,91,88,92,200,189,72,33,39,15
S01009523,475,27,0,27,83,45,24,34,116,105,32,13,19,9
S01009524,575,20,1,19,133,49,30,60,120,90,55,30,25,18
S01009525,409,22,4,18,83,33,32,45,59,87,38,25,13,10
S01009526,557,71,6,65,182,61,43,63,64,42,12,2,10,19
S01009527,498,53,6,47,100,71,31,51,74,71,27,9,18,20
S01009528,282,41,10,31,63,29,23,25,55,38,7,3,4,1
S01009529,409,65,25,40,120,36,64,31,50,32,4,0,4,7
S01009530,420,85,23,62,146,60,37,37,37,10,2,2,0,6
S01009531,586,14,0,14,74,60,33,85,136,125,44,19,25,15
S01009532,485,11,6,5,83,53,29,70,82,114,38,16,22,5
S01009533,637,19,10,9,96,88,43,63,138,132,34,14,20,24
S01009534,717,17,5,12,72,38,32,76,153,152,147,82,65,30
S01009535,566,6,0,6,67,33,59,79,109,125,76,45,31,12
S01009536,466,36,22,14,81,39,46,52,76,98,28,10,18,10
S01009537,410,38,0,38,77,45,38,47,62,66,27,4,23,10
S01009538,612,44,7,37,107,55,42,85,129,84,46,21,25,20
S01009539,674,28,12,16,132,101,65,109,95,125,8,2,6,11
S01009540,653,20,9,11,115,44,44,82,151,138,53,22,31,6
S01009541,601,45,21,24,138,61,82,75,83,103,9,0,9,5
S01009542,659,17,0,17,67,70,65,70,143,155,63,17,46,9
S01009543,354,25,8,17,64,34,45,44,50,77,9,1,8,6
S01009544,664,39,1,38,158,75,72,71,113,100,24,11,13,12
S01009545,614,16,12,4,121,74,69,67,112,103,48,24,24,4
S01009546,858,43,13,30,172,82,71,133,157,154,44,13,31,2
S01009547,622,54,14,40,109,41,62,75,120,105,34,23,11,22
S01009548,555,45,20,25,98,58,48,83,100,97,18,0,18,8
S01009549,637,49,19,30,137,63,70,82,111,98,20,4,16,7
S01009550,416,58,26,32,88,69,29,50,71,36,13,11,2,2
S01009551,438,22,9,13,79,51,46,52,108,54,25,12,13,1
S01009552,653,54,12,42,116,57,88,79,126,118,12,2,10,3
S01009553,700,30,9,21,82,39,37,135,149,145,72,22,50,11
S01009554,535,37,22,15,90,31,64,57,125,90,38,7,31,3
S01009555,569,33,11,22,118,64,79,58,80,86,44,17,27,7
S01009556,657,19,4,15,94,64,40,81,169,126,48,10,38,16
S01009557,571,20,6,14,67,41,34,61,159,118,69,17,52,2
S01009558,583,13,4,9,59,58,35,58,158,122,59,17,42,21
S01009559,735,13,0,13,80,67,45,101,193,165,66,34,32,5
S01009560,615,19,7,12,130,55,26,45,146,122,61,31,30,11
S01009561,429,19,0,19,91,37,31,52,94,64,32,12,20,9
S01009562,574,31,3,28,120,60,34,83,122,87,21,9,12,16
S01009563,583,29,11,18,98,67,43,82,99,125,32,18,14,8
S01009564,469,42,15,27,114,62,46,57,69,66,9,6,3,4
S01009565,495,23,4,19,92,61,24,54,92,119,23,12,11,7
S01009566,933,48,9,39,209,84,82,115,207,137,28,10,18,23
S01009567,716,35,4,31,108,105,52,105,137,118,39,10,29,17
S01009568,578,18,2,16,124,62,51,80,112,87,27,10,17,17
S01009569,605,26,2,24,125,80,24,61,136,120,26,13,13,7
S01009570,440,6,1,5,107,46,28,57,86,81,21,15,6,8
S01009571,609,3,0,3,99,51,35,85,143,88,85,45,40,20
S01009572,846,28,12,16,133,94,40,82,202,164,83,35,48,20
S01009573,623,19,1,18,56,63,21,91,144,142,69,26,43,18
S01009574,756,27,5,22,133,53,53,103,147,196,31,11,20,13
S01009575,417,18,6,12,88,73,25,74,63,53,19,7,12,4
S01009576,412,68,19,49,100,66,53,40,57,10,10,10,0,8
S01009577,587,76,21,55,188,43,74,72,67,55,12,12,0,0
S01009578,672,39,13,26,146,85,53,64,117,128,37,24,13,3
S01009579,899,110,45,65,241,88,73,131,109,96,46,23,23,5
S01009580,870,112,34,78,242,123,79,116,102,74,13,3,10,9
S01009581,445,21,4,17,90,66,35,45,76,75,23,3,20,14
S01009582,435,28,3,25,80,68,44,71,87,38,15,0,15,4
S01009583,679,29,1,28,124,92,49,72,157,96,45,21,24,15
S01009584,398,45,15,30,114,33,77,45,43,31,8,1,7,2
S01009585,844,27,11,16,144,111,63,117,204,141,25,5,20,12
S01009586,456,21,16,5,105,59,41,87,65,62,16,11,5,0
S01009587,484,37,12,25,82,50,27,80,104,67,31,15,16,6
S01009588,749,49,8,41,158,75,38,112,164,122,16,3,13,15
S01009589,779,26,14,12,144,88,48,151,143,127,34,16,18,18
S01009590,601,83,18,65,226,77,57,52,65,38,0,0,0,3
S01009591,525,70,11,59,156,60,53,53,88,35,2,0,2,8
S01009592,387,79,16,63,116,20,62,39,40,26,2,0,2,3
S01009593,495,122,37,85,132,58,54,67,39,17,6,4,2,0
S01009594,603,112,29,83,184,77,46,91,56,36,1,0,1,0
S01009595,479,96,44,52,166,62,49,49,38,13,6,0,6,0
S01009596,678,37,15,22,111,66,57,85,172,106,26,13,13,18
S01009597,813,17,1,16,100,84,67,114,193,139,67,24,43,32
S01009598,586,13,3,10,74,55,59,59,156,104,48,14,34,18
S01009599,744,38,13,25,123,118,48,96,164,112,28,10,18,17
S01009600,509,13,3,10,82,47,28,51,128,109,43,19,24,8
S01009601,608,14,6,8,99,72,36,122,126,94,41,16,25,4
S01009602,694,125,40,85,272,59,45,58,82,46,7,0,7,0
S01009603,479,71,27,44,139,54,65,37,65,28,16,13,3,4
S01009604,699,58,22,36,234,87,37,96,94,60,19,14,5,14
S01009605,608,48,12,36,108,80,47,95,100,79,43,29,14,8
S01009606,498,98,19,79,200,48,27,51,48,18,8,4,4,0
S01009607,408,76,36,40,156,31,48,31,22,34,5,0,5,5
S01009608,484,39,11,28,96,67,45,61,88,66,18,7,11,4
S01009609,650,73,19,54,169,69,65,73,94,81,11,1,10,15
S01009610,739,51,8,43,200,89,55,89,115,107,25,9,16,8
S01009611,396,79,24,55,77,57,70,40,49,19,1,1,0,4
S01009612,484,46,15,31,96,46,50,57,90,76,17,13,4,6
S01009613,392,36,8,28,154,30,86,37,38,11,0,0,0,0
S01009614,390,41,14,27,96,22,69,61,55,44,2,0,2,0
S01009615,262,23,6,17,72,40,26,34,31,26,3,1,2,7
S01009616,608,43,8,35,91,48,63,105,125,101,26,5,21,6
S01009617,618,64,11,53,143,65,55,115,84,81,9,2,7,2
S01009618,567,10,4,6,102,61,51,77,119,96,44,22,22,7
S01009619,483,21,1,20,74,44,41,84,107,64,33,19,14,15
S01009620,605,12,1,11,67,31,35,113,158,138,41,22,19,10
S01009621,600,22,8,14,89,63,58,88,115,99,66,27,39,0
S01009622,620,10,0,10,67,74,51,55,135,122,93,47,46,13
S01009623,375,9,0,9,25,42,29,63,87,77,27,16,11,16
S01009624,685,15,3,12,91,55,50,112,165,160,37,15,22,0
S01009625,716,14,6,8,64,60,39,102,186,158,70,30,40,23
S01009626,489,11,3,8,44,29,35,29,158,118,60,16,44,5
S01009627,669,19,2,17,95,50,56,85,148,175,37,16,21,4
S01009628,265,13,6,7,19,26,12,23,71,78,20,5,15,3
S01009629,909,23,5,18,100,89,72,138,195,174,104,64,40,14
S01009630,694,26,13,13,86,76,27,56,156,164,87,41,46,16
S01009631,557,6,0,6,48,29,32,63,155,150,66,40,26,8
S01009632,445,11,7,4,34,37,26,49,132,99,57,28,29,0
S01009633,647,6,0,6,33,49,51,68,144,185,89,38,51,22
S01009634,330,7,0,7,34,32,9,47,90,73,27,11,16,11
S01009635,696,36,4,32,106,68,42,90,142,163,45,19,26,4
S01009636,759,11,3,8,53,49,59,110,176,155,135,73,62,11
S01009637,588,37,2,35,86,49,35,96,140,103,29,20,9,13
S01009638,658,22,3,19,82,26,40,57,169,147,108,47,61,7
S01009639,566,69,13,56,181,75,55,70,61,33,22,16,6,0
S01009640,417,12,0,12,70,45,24,63,95,68,31,16,15,9
S01009641,548,25,2,23,101,69,48,58,100,82,59,33,26,6
S01009642,732,51,9,42,166,88,61,91,130,113,25,18,7,7
S01009643,541,51,19,32,171,71,37,76,77,48,0,0,0,10
S01009644,651,48,7,41,84,72,49,108,102,137,47,23,24,4
S01009645,500,19,4,15,80,65,49,96,84,71,27,18,9,9
S01009646,468,9,0,9,87,28,34,42,131,93,35,19,16,9
S01009647,437,11,0,11,45,36,43,48,95,89,57,24,33,13
S01009648,663,22,3,19,125,56,50,105,143,113,41,15,26,8
S01009649,853,43,18,25,214,79,49,110,175,121,58,30,28,4
S01009650,497,61,12,49,186,47,52,63,39,42,7,2,5,0
S01009651,666,98,4,94,194,43,121,65,59,66,19,7,12,1
S01009652,482,139,23,116,148,41,71,23,32,24,2,1,1,2
S01009653,417,82,31,51,148,31,47,40,40,25,0,0,0,4
S01009654,429,34,3,31,133,64,57,21,55,47,4,0,4,14
S01009655,694,14,2,12,93,35,36,85,184,199,42,22,20,6
S01009656,515,18,7,11,68,22,42,59,102,135,61,29,32,8
S01009657,636,52,4,48,133,43,85,102,101,77,32,10,22,11
S01009658,655,22,5,17,88,49,33,101,170,151,41,28,13,0
S01009659,393,21,3,18,85,33,36,40,65,76,36,12,24,1
S01009660,941,28,5,23,203,97,62,110,220,158,39,26,13,24
S01009661,623,101,24,77,180,35,163,41,37,34,14,5,9,18
S01009662,564,71,14,57,155,69,88,80,38,46,7,3,4,10
S01009663,532,87,21,66,195,55,41,58,42,35,11,0,11,8
S01009664,700,160,38,122,181,77,93,52,43,76,11,7,4,7
S01009665,509,79,31,48,108,44,45,34,64,102,19,8,11,14
S01009666,580,73,10,63,148,62,93,61,46,63,26,7,19,8
S01009667,388,62,19,43,137,36,56,34,42,20,1,1,0,0
S01009668,492,83,11,72,154,52,45,52,35,60,11,4,7,0
S01009669,347,55,8,47,90,36,55,44,38,29,0,0,0,0
S01009670,632,127,21,106,180,48,68,49,63,58,23,6,17,16
S01009671,506,63,16,47,171,68,62,46,56,27,11,3,8,2
S01009672,660,47,23,24,118,61,70,106,126,120,9,3,6,3
S01009673,617,70,19,51,176,57,85,43,60,99,11,10,1,16
S01009674,669,119,32,87,195,63,103,55,56,59,12,5,7,7
S01009675,686,118,35,83,207,70,89,61,57,74,7,1,6,3
S01009676,668,78,31,47,196,51,99,90,89,59,6,6,0,0
S01009677,475,102,14,88,100,29,130,37,42,26,4,0,4,5
S01009678,437,47,3,44,69,49,67,76,73,44,2,2,0,10
S01009679,708,55,9,46,176,74,70,65,94,137,27,16,11,10
S01009680,645,63,19,44,156,59,78,89,110,65,18,6,12,7
S01009681,493,39,10,29,123,44,44,79,65,86,7,3,4,6
S01009682,486,78,9,69,178,49,51,33,49,41,3,0,3,4
S01009683,551,125,28,97,173,58,45,48,55,27,8,4,4,12
S01009684,943,219,48,171,302,88,138,63,66,47,16,6,10,4
S01009685,498,39,11,28,108,32,61,84,81,80,10,0,10,3
S01009686,899,116,15,101,203,52,67,101,157,112,39,25,14,52
S01009687,585,55,7,48,172,72,71,65,45,87,13,3,10,5
S01009688,748,28,5,23,88,56,43,113,169,165,66,41,25,20
S01009689,500,70,14,56,123,34,38,53,72,60,24,8,16,26
S01009690,577,83,12,71,158,59,50,69,69,63,25,10,15,1
S01009691,459,89,24,65,161,51,50,31,38,23,6,0,6,10
S01009692,698,120,25,95,219,60,72,62,81,72,5,2,3,7
S01009693,482,83,22,61,156,77,42,62,42,12,4,0,4,4
S01009694,650,151,34,117,210,73,52,54,55,51,0,0,0,4
S01009695,453,90,36,54,151,38,73,30,20,38,9,5,4,4
S01009696,703,163,30,133,210,38,119,56,63,38,14,6,8,2
S01009697,515,128,14,114,129,29,93,53,34,27,5,0,5,17
S01009698,466,98,37,61,123,22,105,45,42,16,0,0,0,15
S01009699,282,46,12,34,60,25,41,45,35,24,4,4,0,2
S01009700,470,48,4,44,94,38,88,55,66,69,4,4,0,8
S01009701,230,43,7,36,64,6,41,32,16,21,3,0,3,4
S01009702,486,78,9,69,114,24,121,45,36,52,11,1,10,5
S01009703,415,47,13,34,99,48,61,53,51,51,2,2,0,3
S01009704,671,79,16,63,150,48,147,85,76,70,8,4,4,8
S01009705,572,26,2,24,99,31,99,99,103,88,13,3,10,14
S01009706,470,46,23,23,81,42,102,50,64,54,18,10,8,13
S01009707,388,68,18,50,112,38,55,42,38,24,1,1,0,10
S01009708,434,67,16,51,90,34,88,50,57,36,3,1,2,9
S01009709,567,78,13,65,126,34,73,83,61,79,22,4,18,11
S01009710,482,50,3,47,119,28,101,84,35,49,12,3,9,4
S01009711,590,49,11,38,85,49,155,59,101,61,20,11,9,11
S01009712,442,61,4,57,108,24,78,57,60,36,13,6,7,5
S01009713,572,98,20,78,104,31,120,71,63,58,12,1,11,15
S01009714,596,117,21,96,155,50,89,64,62,39,13,4,9,7
S01009715,477,101,19,82,101,18,103,38,67,27,12,0,12,10
S01009716,484,119,14,105,75,36,55,43,50,33,0,0,0,73
S01009717,571,32,2,30,72,21,43,48,87,62,21,6,15,185
S01009718,595,50,0,50,95,23,32,81,71,111,13,2,11,119
S01009719,558,50,11,39,82,42,53,68,77,102,13,6,7,71
S01009720,584,74,6,68,78,27,28,98,73,105,8,1,7,93
S01009721,557,21,0,21,22,9,9,15,11,8,5,2,3,457
S01009722,706,56,6,50,45,9,27,19,16,14,1,1,0,519
S01009723,534,41,2,39,33,13,7,16,7,17,2,1,1,398
S01009724,795,71,2,69,79,29,51,60,85,90,14,8,6,316
S01009725,592,44,4,40,26,10,10,24,20,10,12,4,8,436
S01009726,500,35,5,30,26,7,30,3,9,0,2,0,2,388
S01009727,727,172,41,131,156,28,84,51,77,55,15,2,13,89
S01009728,543,152,31,121,187,41,70,33,7,21,2,2,0,30
S01009729,398,123,14,109,120,32,38,30,14,11,1,1,0,29
S01009730,435,59,4,55,67,55,40,45,37,51,6,2,4,75
S01009731,351,99,11,88,84,33,39,9,11,7,0,0,0,69
S01009732,635,82,9,73,78,13,62,19,26,17,10,5,5,328
S01009733,372,107,19,88,86,21,59,22,25,46,2,0,2,4
S01009734,686,187,36,151,178,54,85,69,34,29,4,2,2,46
S01009735,494,191,32,159,139,28,71,8,1,4,1,1,0,51
S01009736,557,50,5,45,42,17,29,5,13,3,2,2,0,396
S01009737,662,22,8,14,266,124,36,55,65,81,2,0,2,11
S01009738,349,34,8,26,71,32,54,52,50,39,7,3,4,10
S01009739,733,159,108,51,326,62,34,49,33,54,4,0,4,12
S01009740,422,31,17,14,107,38,45,77,38,52,20,7,13,14
S01009741,560,10,8,2,381,86,6,18,27,25,3,0,3,4
S01009742,396,111,24,87,135,37,44,20,27,20,1,1,0,1
S01009743,702,141,27,114,190,56,103,85,51,56,9,0,9,11
S01009744,537,111,25,86,158,79,63,46,35,39,2,1,1,4
S01009745,852,161,38,123,275,106,87,87,92,32,1,0,1,11
S01009746,465,107,16,91,127,23,109,17,51,28,0,0,0,3
S01009747,541,68,14,54,143,65,50,50,62,66,26,3,23,11
S01009748,559,146,24,122,182,60,38,41,44,38,1,0,1,9
S01009749,744,180,33,147,219,59,64,72,57,75,10,4,6,8
S01009750,540,57,6,51,161,49,49,58,72,75,16,1,15,3
S01009751,648,64,12,52,124,89,49,65,113,111,19,7,12,14
S01009752,453,187,9,178,158,37,36,10,14,6,3,2,1,2
S01009753,482,122,11,111,153,44,66,12,47,28,6,3,3,4
S01009754,631,160,20,140,177,61,62,42,61,44,16,6,10,8
S01009755,556,174,32,142,168,57,34,42,28,36,14,12,2,3
S01009756,575,182,44,138,163,41,55,38,32,56,4,4,0,4
S01009757,522,192,15,177,168,34,50,30,29,6,6,1,5,7
S01009758,484,53,10,43,108,100,40,46,66,48,11,6,5,12
S01009759,864,11,2,9,52,53,50,71,247,225,113,63,50,42
S01009760,753,22,0,22,72,101,65,68,181,168,65,36,29,11
S01009761,766,64,10,54,152,100,85,103,127,104,28,17,11,3
S01009762,835,9,3,6,85,53,28,91,208,205,105,62,43,51
S01009763,720,178,40,138,195,68,153,21,43,36,16,9,7,10
S01009764,624,31,4,27,103,49,30,63,169,96,69,32,37,14
S01009765,862,38,0,38,166,128,110,121,142,88,51,29,22,18
S01009766,518,37,2,35,130,69,41,92,84,47,6,0,6,12
S01009767,436,8,3,5,60,47,32,39,90,95,57,39,18,8
S01009768,583,49,4,45,95,72,79,44,103,74,53,24,29,14
S01009769,593,48,7,41,159,56,65,63,116,58,16,6,10,12
S01009770,638,52,12,40,163,83,83,86,118,34,10,8,2,9
S01009771,827,73,20,53,198,104,159,95,92,74,24,15,9,8
S01009772,573,54,11,43,130,104,52,55,73,85,11,0,11,9
S01009773,613,95,9,86,159,31,143,60,59,21,12,11,1,33
S01009774,558,96,5,91,177,24,105,59,31,41,19,13,6,6
S01009775,643,28,10,18,60,48,20,93,174,111,63,42,21,46
S01009776,607,10,0,10,51,48,10,64,168,133,113,59,54,10
S01009777,423,13,0,13,48,55,30,48,103,76,27,13,14,23
S01009778,545,5,3,2,50,32,32,46,177,149,33,29,4,21
S01009779,418,3,2,1,29,42,24,43,105,105,39,12,27,28
S01009780,567,9,3,6,31,16,23,38,175,143,111,61,50,21
S01009781,436,1,0,1,48,52,14,32,136,107,39,17,22,7
S01009782,545,48,0,48,79,62,81,57,83,56,68,29,39,11
S01009783,667,13,0,13,96,59,28,64,183,131,85,54,31,8
S01009784,627,18,4,14,60,72,17,57,177,153,55,16,39,18
S01009785,632,10,5,5,41,71,30,46,156,174,90,74,16,14
S01009786,795,18,5,13,82,96,39,53,216,188,90,34,56,13
S01009787,680,17,10,7,73,78,36,58,160,150,104,54,50,4
S01009788,576,23,0,23,80,83,52,61,115,123,29,9,20,10
S01009789,672,28,8,20,73,81,59,83,167,124,44,21,23,13
S01009790,492,21,11,10,61,67,15,59,107,112,43,23,20,7
S01009791,532,16,2,14,66,43,46,41,111,103,93,48,45,13
S01009792,907,154,30,124,269,93,127,75,99,44,25,20,5,21
S01009793,697,61,15,46,161,126,81,92,78,65,11,3,8,22
S01009794,487,74,11,63,155,88,26,45,45,38,9,7,2,7
S01009795,797,145,42,103,271,117,98,51,60,38,13,3,10,4
S01009796,629,69,21,48,186,65,132,63,71,26,17,13,4,0
S01009797,666,77,10,67,208,89,74,79,59,51,23,16,7,6
S01009798,669,90,19,71,222,78,98,67,41,52,10,5,5,11
S01009799,682,10,0,10,37,83,44,54,190,161,89,46,43,14
S01009800,955,21,4,17,125,134,87,74,239,151,89,60,29,35
S01009801,741,11,1,10,96,117,24,77,157,171,72,45,27,16
S01009802,909,41,5,36,161,123,52,116,187,137,78,52,26,14
S01009803,654,7,4,3,86,75,48,44,149,132,69,38,31,44
S01009804,357,77,9,68,122,42,17,37,35,16,4,3,1,7
S01009805,809,73,7,66,89,108,24,38,190,155,95,55,40,37
S01009806,613,29,7,22,113,89,56,58,148,86,27,18,9,7
S01009807,858,28,5,23,108,128,40,126,187,106,106,74,32,29
S01009808,805,9,4,5,89,81,64,62,187,140,122,87,35,51
S01009809,583,42,4,38,112,64,30,61,135,97,29,20,9,13
S01009810,696,21,4,17,102,98,25,82,156,109,79,39,40,24
S01009811,786,24,8,16,129,107,62,62,176,133,82,63,19,11
S01009812,547,19,5,14,95,71,65,44,112,90,46,30,16,5
S01009813,655,7,0,7,61,67,52,55,134,86,163,117,46,30
S01009814,648,80,13,67,159,68,49,84,67,92,33,27,6,16
S01009815,606,39,11,28,155,102,24,55,76,97,42,33,9,16
S01009816,612,37,4,33,127,108,50,83,114,73,10,5,5,10
S01009817,499,34,9,25,109,68,26,57,88,75,35,20,15,7
S01009818,603,75,10,65,206,97,77,32,57,47,9,7,2,3
S01009819,434,55,7,48,97,76,66,27,46,49,6,0,6,12
S01009820,732,78,26,52,177,126,62,55,115,86,22,13,9,11
S01009821,529,82,16,66,157,64,45,28,59,71,17,10,7,6
S01009822,403,32,4,28,83,68,9,45,78,62,22,12,10,4
S01009823,543,20,8,12,56,58,31,63,135,99,54,40,14,27
S01009824,739,40,0,40,124,75,55,131,155,129,25,19,6,5
S01009825,838,46,17,29,143,117,43,83,152,187,49,28,21,18
S01009826,477,10,2,8,70,50,26,50,135,88,45,20,25,3
S01009827,684,13,3,10,90,61,44,71,176,178,34,19,15,17
S01009828,544,17,1,16,81,67,28,59,110,99,74,47,27,9
S01009829,812,55,11,44,142,144,50,78,136,138,56,30,26,13
S01009830,636,15,6,9,111,131,26,48,143,111,40,24,16,11
S01009831,690,30,3,27,131,134,28,77,124,122,25,15,10,19
S01009832,781,76,11,65,171,135,45,75,118,107,33,18,15,21
S01009833,468,21,2,19,155,57,38,40,58,73,14,3,11,12
S01009834,783,37,8,29,134,127,37,66,160,130,66,27,39,26
S01009835,432,11,5,6,48,55,25,24,116,100,36,23,13,17
S01009836,757,51,24,27,166,87,42,111,130,125,38,25,13,7
S01009837,481,9,5,4,70,63,19,53,120,87,45,32,13,15
S01009838,590,20,1,19,105,63,25,48,98,123,79,30,49,29
S01009839,897,34,5,29,111,135,22,77,204,165,116,63,53,33
S01009840,683,38,2,36,103,94,38,70,130,140,65,31,34,5
S01009841,682,21,7,14,101,84,35,69,129,119,97,68,29,27
S01009842,633,27,2,25,79,49,33,55,111,131,105,72,33,43
S01009843,540,12,0,12,52,53,3,81,79,131,121,81,40,8
S01009844,487,7,0,7,44,54,26,50,80,112,101,66,35,13
S01009845,721,30,8,22,59,68,33,72,148,133,143,90,53,35
S01009846,772,24,1,23,111,86,48,64,155,179,79,53,26,26
S01009847,542,11,2,9,64,67,16,51,122,135,51,34,17,25
S01009848,701,23,6,17,82,81,36,92,164,132,71,59,12,20
S01009849,489,37,2,35,112,55,14,44,104,81,25,12,13,17
S01009850,647,48,8,40,127,101,38,60,127,104,31,22,9,11
S01009851,552,27,1,26,99,64,40,64,119,84,43,18,25,12
S01009852,431,40,17,23,117,71,31,41,62,28,34,33,1,7
S01009853,675,44,9,35,120,132,65,43,113,106,41,17,24,11
S01009854,781,41,13,28,156,93,41,68,152,146,61,29,32,23
S01009855,457,55,5,50,120,81,35,55,50,33,6,2,4,22
S01009856,466,41,7,34,117,56,38,27,85,57,21,10,11,24
S01009857,694,80,4,76,189,84,58,51,111,89,24,18,6,8
S01009858,575,31,3,28,131,74,46,72,107,67,31,17,14,16
S01009859,815,31,2,29,105,84,27,52,171,184,138,98,40,23
S01009860,690,15,0,15,67,92,9,62,141,164,107,82,25,33
S01009861,902,25,0,25,124,70,47,73,166,213,151,100,51,33
S01009862,922,37,7,30,120,127,69,94,150,175,98,50,48,52
S01009863,731,49,9,40,103,104,54,60,160,82,76,56,20,43
S01009864,538,62,0,62,84,44,32,30,76,88,76,61,15,46
S01009865,398,27,1,26,66,52,49,45,62,47,35,18,17,15
S01009866,737,46,5,41,152,88,63,90,141,81,46,32,14,30
S01009867,860,142,13,129,211,161,70,49,74,67,27,14,13,59
S01009868,603,74,3,71,140,59,32,45,66,106,31,19,12,50
S01009869,496,45,4,41,96,67,34,63,59,39,22,13,9,71
S01009870,549,25,0,25,90,65,63,50,81,75,60,53,7,40
S01009871,725,89,9,80,102,77,122,40,112,72,54,35,19,57
S01009872,657,44,5,39,135,80,87,58,86,74,27,15,12,66
S01009873,687,170,18,152,158,57,115,31,65,41,37,18,19,13
S01009874,854,132,22,110,166,106,110,38,144,86,49,26,23,23
S01009875,675,51,7,44,97,73,77,41,87,68,123,97,26,58
S01009876,679,9,0,9,92,63,33,42,174,95,127,91,36,44
S01009877,707,216,28,188,211,30,119,17,46,31,28,15,13,9
S01009878,611,45,8,37,85,45,127,95,75,54,42,32,10,43
S01009879,733,296,63,233,181,30,116,32,25,26,11,4,7,16
S01009880,682,162,30,132,130,49,161,32,75,26,24,15,9,23
S01009881,496,22,1,21,80,43,88,56,62,54,48,39,9,43
S01009882,1059,183,12,171,267,92,102,62,127,40,76,50,26,110
S01009883,758,55,12,43,124,59,112,71,122,55,100,82,18,60
S01009884,768,72,4,68,170,66,123,86,93,65,64,46,18,29
S01009885,789,112,11,101,149,47,174,62,103,35,69,64,5,38
S01009886,695,106,0,106,122,56,104,45,105,53,63,54,9,41
S01009887,910,37,3,34,156,80,110,63,142,96,103,73,30,123
S01009888,669,61,7,54,104,39,109,58,97,81,65,46,19,55
S01009889,720,40,1,39,158,48,107,67,100,69,88,83,5,43
S01009890,498,23,1,22,55,41,40,51,97,93,70,37,33,28
S01009891,613,36,4,32,139,73,63,55,57,86,66,39,27,38
S01009892,677,32,10,22,109,58,24,83,134,135,75,55,20,27
S01009893,757,49,3,46,132,72,89,88,106,102,67,48,19,52
S01009894,681,25,4,21,93,81,57,65,130,122,53,32,21,55
S01009895,639,48,6,42,91,68,42,47,138,101,61,36,25,43
S01009896,850,23,1,22,103,79,113,70,185,133,107,83,24,37
S01009897,737,40,3,37,181,89,69,67,128,82,46,24,22,35
S01009898,481,13,1,12,49,56,100,43,106,44,60,33,27,10
S01009899,669,83,4,79,210,106,46,47,59,65,24,11,13,29
S01009900,780,132,11,121,312,103,38,28,99,36,17,5,12,15
S01009901,801,157,10,147,306,119,59,46,49,21,35,19,16,9
S01009902,642,54,0,54,140,66,72,52,104,75,58,32,26,21
S01009903,766,147,20,127,238,52,123,61,59,39,36,35,1,11
S01009904,669,120,16,104,238,83,61,28,50,35,25,23,2,29
S01009905,712,70,2,68,177,69,52,51,106,49,57,38,19,81
S01009906,623,99,9,90,130,77,43,61,85,61,25,19,6,42
S01009907,732,39,1,38,152,90,45,49,84,71,61,37,24,141
S01009908,964,196,16,180,341,61,99,69,102,29,33,27,6,34
S01009909,762,133,12,121,218,99,71,27,92,40,42,23,19,40
S01009910,509,75,16,59,163,77,35,20,58,42,20,14,6,19
S01009911,828,208,28,180,303,67,67,37,53,47,25,16,9,21
S01009912,721,237,28,209,175,38,144,52,36,20,8,7,1,11
S01009913,638,146,6,140,151,55,169,22,46,41,5,5,0,3
S01009914,774,228,36,192,234,36,186,20,24,13,26,24,2,7
S01009915,708,192,26,166,213,53,116,23,58,31,5,3,2,17
S01009916,797,125,14,111,192,31,255,60,84,15,35,28,7,0
S01009917,605,183,30,153,198,55,66,18,56,18,8,7,1,3
S01009918,604,169,20,149,196,33,90,21,58,19,9,1,8,9
S01009919,883,108,8,100,227,120,73,36,136,80,46,29,17,57
S01009920,737,181,15,166,235,96,40,58,52,44,14,7,7,17
S01009921,578,114,9,105,205,89,31,35,52,13,16,8,8,23
S01009922,914,211,19,192,310,111,58,53,79,25,25,19,6,42
S01009923,716,89,3,86,224,105,61,51,66,66,26,16,10,28
S01009924,905,161,20,141,249,154,66,55,91,62,26,21,5,41
S01009925,627,129,11,118,206,103,24,25,52,29,36,17,19,23
S01009926,673,118,12,106,210,72,66,27,83,39,33,28,5,25
S01009927,414,90,14,76,107,41,34,33,52,25,18,8,10,14
S01009928,727,262,32,230,239,71,79,25,21,14,8,1,7,8
S01009929,405,121,19,102,134,39,48,23,11,16,8,8,0,5
S01009930,767,138,13,125,255,96,73,48,79,33,27,0,27,18
S01009931,701,174,23,151,253,111,43,25,31,29,10,5,5,25
S01009932,541,104,13,91,186,75,41,35,37,27,12,8,4,24
S01009933,804,58,4,54,148,81,32,58,110,158,112,74,38,47
S01009934,806,179,32,147,249,71,65,61,84,38,31,23,8,28
S01009935,348,24,1,23,41,54,20,32,74,53,42,28,14,8
S01009936,534,55,5,50,142,63,32,40,58,93,24,10,14,27
S01009937,427,9,2,7,39,41,18,35,76,72,116,82,34,21
S01009938,652,55,3,52,92,67,57,62,107,130,60,42,18,22
S01009939,847,11,0,11,49,51,39,63,146,169,292,209,83,27
S01009940,680,8,2,6,68,81,30,58,199,148,77,48,29,11
S01009941,984,62,4,58,229,104,179,102,128,109,44,26,18,27
S01009942,838,4,0,4,119,70,45,44,181,249,103,78,25,23
S01009943,676,21,9,12,57,70,42,44,160,153,104,57,47,25
S01009944,624,46,3,43,133,91,49,50,137,75,23,13,10,20
S01009945,757,39,8,31,132,106,47,52,158,122,66,25,41,35
S01009946,663,40,18,22,129,109,53,61,124,93,40,30,10,14
S01009947,437,34,2,32,78,37,34,62,71,80,40,17,23,1
S01009948,622,21,2,19,104,63,39,40,124,129,58,34,24,44
S01009949,650,69,0,69,146,82,32,76,107,73,55,28,27,10
S01009950,605,203,36,167,205,39,71,20,33,19,10,5,5,5
S01009951,650,272,24,248,179,19,117,8,40,11,3,3,0,1
S01009952,577,177,36,141,180,50,56,21,50,27,16,13,3,0
S01009953,726,189,39,150,201,71,89,41,57,63,9,9,0,6
S01009954,544,106,29,77,120,59,148,21,35,25,17,10,7,13
S01009955,753,177,17,160,197,77,91,40,81,53,29,21,8,8
S01009956,615,65,12,53,139,94,69,69,93,51,27,14,13,8
S01009957,620,262,32,230,149,32,92,31,37,10,2,0,2,5
S01009958,770,191,16,175,265,73,97,36,68,27,7,1,6,6
S01009959,492,170,20,150,120,38,80,20,10,27,16,15,1,11
S01009960,654,177,31,146,215,69,93,23,31,29,11,11,0,6
S01009961,504,46,13,33,145,81,64,38,50,49,21,14,7,10
S01009962,819,116,12,104,200,156,51,84,103,54,35,23,12,20
S01009963,664,100,21,79,240,94,103,50,46,25,1,0,1,5
S01009964,792,180,32,148,232,78,113,43,75,42,21,15,6,8
S01009965,556,67,14,53,174,75,80,64,55,37,2,0,2,2
S01009966,653,94,31,63,181,87,60,69,75,58,21,6,15,8
S01009967,620,151,35,116,283,67,52,23,21,12,1,0,1,10
S01009968,492,24,12,12,124,106,71,47,53,57,8,8,0,2
S01009969,663,196,46,150,207,49,70,42,41,31,16,5,11,11
S01009970,777,10,1,9,63,112,33,58,179,191,106,53,53,25
S01009971,962,39,9,30,144,90,97,64,203,211,99,45,54,15
S01009972,663,52,7,45,158,76,82,71,87,78,44,35,9,15
S01009973,665,37,4,33,134,53,45,85,102,160,43,33,10,6
S01009974,535,7,0,7,26,82,34,43,129,128,78,41,37,8
S01009975,658,8,0,8,36,64,41,38,174,151,132,92,40,14
S01009976,434,3,0,3,38,29,14,49,97,144,55,41,14,5
S01009977,699,25,3,22,62,43,9,56,155,191,140,75,65,18
S01009978,941,26,11,15,104,88,41,89,232,216,112,69,43,33
S01009979,370,4,0,4,36,26,16,28,86,121,48,32,16,5
S01009980,481,5,0,5,57,25,18,28,116,133,88,56,32,11
S01009981,602,28,2,26,66,47,32,67,119,171,66,34,32,6
S01009982,954,32,2,30,144,105,85,73,187,207,90,60,30,31
S01009983,542,17,0,17,39,56,12,18,143,117,122,73,49,18
S01009984,687,27,4,23,76,69,62,93,115,164,67,32,35,14
S01009985,558,7,3,4,34,46,27,61,156,111,104,56,48,12
S01009986,442,11,0,11,40,55,10,21,103,104,98,57,41,0
S01009987,637,15,2,13,57,113,37,50,170,141,42,22,20,12
S01009988,356,4,0,4,37,36,11,22,88,97,54,29,25,7
S01009989,671,24,6,18,111,130,79,41,145,112,24,9,15,5
S01009990,589,29,6,23,117,104,25,61,107,111,22,9,13,13
S01009991,729,45,21,24,126,158,48,87,119,96,37,27,10,13
S01009992,524,4,0,4,61,61,26,67,157,56,78,44,34,14
S01009993,730,56,11,45,144,93,78,72,133,125,8,0,8,21
S01009994,662,34,8,26,142,96,73,70,119,100,25,17,8,3
S01009995,593,43,4,39,117,135,42,80,93,74,5,4,1,4
S01009996,676,57,17,40,132,94,47,74,98,128,36,19,17,10
S01009997,513,23,2,21,132,80,34,43,102,57,23,10,13,19
S01009998,483,71,28,43,132,43,114,45,25,37,11,10,1,5
S01009999,587,74,16,58,143,99,43,70,74,64,10,7,3,10
S01010000,563,19,0,19,147,77,48,48,117,85,15,2,13,7
S01010001,697,68,10,58,137,98,56,71,105,110,39,19,20,13
S01010002,687,40,3,37,136,143,61,86,120,71,23,12,11,7
S01010003,606,85,21,64,156,80,42,108,65,58,11,7,4,1
S01010004,588,81,20,61,222,39,93,36,66,31,13,7,6,7
S01010005,634,60,9,51,146,129,43,56,79,58,40,19,21,23
S01010006,721,89,11,78,211,113,20,50,94,88,37,12,25,19
S01010007,809,157,27,130,293,128,68,48,37,56,11,1,10,11
S01010008,555,85,14,71,184,82,39,26,65,42,16,7,9,16
S01010009,513,57,7,50,136,79,26,49,74,47,26,15,11,19
S01010010,856,180,43,137,264,82,107,42,93,66,14,9,5,8
S01010011,526,73,14,59,157,81,25,45,57,49,30,13,17,9
S01010012,672,67,5,62,154,91,99,59,74,77,25,21,4,26
S01010013,673,102,26,76,206,95,41,59,77,41,34,10,24,18
S01010014,879,146,29,117,313,115,78,65,75,44,25,16,9,18
S01010015,748,126,17,109,227,99,80,66,73,35,25,11,14,17
S01010016,534,13,4,9,102,70,38,67,130,79,24,11,13,11
S01010017,595,22,8,14,63,54,39,57,150,125,78,33,45,7
S01010018,722,38,6,32,140,118,43,68,123,132,46,28,18,14
S01010019,574,2,1,1,73,71,20,59,135,102,102,63,39,10
S01010020,549,21,8,13,82,89,48,53,121,111,19,14,5,5
S01010021,728,26,0,26,52,49,61,53,148,139,153,97,56,47
S01010022,822,47,4,43,123,102,47,65,158,154,95,47,48,31
S01010023,441,10,4,6,37,38,15,46,113,98,83,54,29,1
S01010024,633,38,2,36,103,62,17,49,169,100,61,39,22,34
S01010025,461,18,0,18,73,38,44,37,67,91,70,42,28,23
S01010026,801,64,11,53,164,67,40,50,138,140,86,57,29,52
S01010027,799,72,9,63,188,84,47,44,107,91,78,54,24,88
S01010028,486,40,0,40,83,46,23,43,86,79,52,26,26,34
S01010029,441,17,5,12,60,48,15,52,87,95,47,35,12,20
S01010030,733,162,16,146,174,78,21,69,75,80,20,9,11,54
S01010031,667,133,10,123,183,81,23,30,28,27,16,14,2,146
S01010032,513,86,4,82,130,68,14,29,48,13,34,27,7,91
S01010033,807,72,6,66,158,77,61,46,139,107,74,40,34,73
S01010034,622,54,11,43,104,60,16,53,107,113,83,58,25,32
S01010035,609,20,2,18,45,36,18,87,111,111,106,79,27,75
S01010036,796,82,5,77,126,78,30,35,76,32,22,14,8,315
S01010037,435,18,0,18,37,47,32,54,91,95,49,29,20,12
S01010038,812,42,1,41,111,61,40,53,204,142,75,48,27,84
S01010039,916,159,13,146,218,67,38,46,51,38,21,18,3,278
S01010040,676,91,9,82,178,82,49,48,85,63,25,17,8,55
S01010041,596,89,6,83,124,50,21,41,49,50,43,34,9,129
S01010042,1041,92,7,85,215,162,61,63,120,126,62,33,29,140
S01010043,675,44,3,41,96,76,26,65,123,118,93,50,43,34
S01010044,909,63,10,53,158,128,49,92,127,167,78,54,24,47
S01010045,446,8,2,6,33,31,12,26,118,123,82,57,25,13
S01010046,616,16,1,15,91,85,34,49,119,132,74,46,28,16
S01010047,635,9,4,5,47,57,44,46,149,177,91,59,32,15
S01010048,739,20,1,19,69,68,18,52,182,225,71,42,29,34
S01010049,709,12,4,8,32,38,36,49,199,223,100,61,39,20
S01010050,810,26,3,23,54,95,27,68,199,171,128,85,43,42
S01010051,526,6,2,4,42,53,27,36,97,132,101,67,34,32
S01010052,549,22,2,20,67,70,14,42,111,108,92,62,30,23
S01010053,744,28,5,23,61,75,39,76,184,147,82,66,16,52
S01010054,524,8,0,8,38,20,12,19,142,137,131,96,35,17
S01010055,822,32,6,26,131,94,31,62,176,164,84,39,45,48
S01010056,409,6,0,6,32,45,12,40,99,94,69,49,20,12
S01010057,336,15,4,11,50,37,15,38,64,62,39,32,7,16
S01010058,691,28,20,8,67,67,34,66,154,167,89,60,29,19
S01010059,536,33,2,31,97,69,32,44,103,99,29,11,18,30
S01010060,771,31,7,24,101,74,57,53,166,179,85,58,27,25
S01010061,460,12,0,12,105,72,40,39,87,60,21,6,15,24
S01010062,602,9,0,9,93,54,36,53,157,120,68,40,28,12
S01010063,795,29,8,21,88,83,40,83,172,173,98,54,44,29
S01010064,471,9,3,6,69,43,44,46,106,90,46,25,21,18
S01010065,668,8,2,6,80,51,38,59,148,196,76,55,21,12
S01010066,627,4,0,4,45,60,30,43,151,185,79,62,17,30
S01010067,534,4,1,3,34,38,22,35,146,143,101,58,43,11
S01010068,546,31,4,27,84,67,41,71,112,83,23,11,12,34
S01010069,734,34,12,22,170,135,106,52,123,99,6,3,3,9
S01010070,612,60,19,41,127,77,98,62,103,66,9,7,2,10
S01010071,622,28,11,17,144,84,91,63,81,101,21,9,12,9
S01010072,608,54,15,39,113,66,51,67,139,93,17,5,12,8
S01010073,553,37,11,26,132,56,60,82,84,75,11,7,4,16
S01010074,515,38,7,31,188,64,55,48,63,35,16,7,9,8
S01010075,408,15,8,7,54,54,31,30,92,105,20,10,10,7
S01010076,565,23,4,19,82,64,57,53,143,107,26,16,10,10
S01010077,489,8,2,6,87,54,42,44,124,79,38,31,7,13
S01010078,554,51,16,35,164,100,50,56,66,47,16,6,10,4
S01010079,718,157,45,112,225,54,131,57,27,36,9,3,6,22
S01010080,447,67,18,49,129,50,56,49,49,39,4,0,4,4
S01010081,502,75,10,65,128,64,119,33,20,40,9,8,1,14
S01010082,693,104,27,77,204,91,102,47,58,55,8,4,4,24
S01010083,535,19,0,19,82,70,33,51,113,112,41,24,17,14
S01010084,657,8,4,4,90,108,37,95,117,141,57,33,24,4
S01010085,578,53,18,35,154,84,70,89,59,58,11,3,8,0
S01010086,699,14,2,12,114,57,49,66,194,158,36,25,11,11
S01010087,396,68,23,45,106,41,68,26,47,36,4,1,3,0
S01010088,800,158,29,129,295,60,127,52,56,33,9,6,3,10
S01010089,514,28,4,24,82,70,59,59,74,73,33,8,25,36
S01010090,946,72,35,37,249,152,88,103,106,125,20,11,9,31
S01010091,809,63,11,52,247,99,85,86,106,85,19,8,11,19
S01010092,699,43,15,28,93,86,49,69,144,116,70,48,22,29
S01010093,732,69,31,38,167,112,79,102,83,72,25,13,12,23
S01010094,530,35,7,28,157,95,46,52,46,73,23,8,15,3
S01010095,553,58,6,52,133,90,65,52,57,81,14,4,10,3
S01010096,640,42,10,32,228,99,67,63,65,68,6,5,1,2
S01010097,591,57,13,44,113,86,67,54,100,83,27,20,7,4
S01010098,579,71,4,67,185,79,66,51,56,61,7,4,3,3
S01010099,521,54,6,48,151,86,59,62,63,39,5,3,2,2
S01010100,662,67,12,55,185,63,74,71,113,75,11,10,1,3
S01010101,581,44,13,31,152,66,91,52,87,75,8,1,7,6
S01010102,884,113,23,90,331,101,71,108,38,89,11,7,4,22
S01010103,915,59,3,56,251,103,161,143,86,92,6,6,0,14
S01010104,735,68,9,59,218,105,83,103,59,81,9,4,5,9
S01010105,382,10,4,6,38,31,10,25,108,95,56,30,26,9
S01010106,352,3,0,3,53,25,20,35,64,101,46,28,18,5
S01010107,705,11,0,11,72,61,52,74,165,148,63,30,33,59
S01010108,620,20,0,20,67,64,73,88,124,139,39,24,15,6
S01010109,694,46,4,42,101,71,51,66,109,147,63,48,15,40
S01010110,616,10,5,5,53,65,24,43,161,174,71,43,28,15
S01010111,859,11,1,10,103,61,24,76,192,230,134,87,47,28
S01010112,859,13,4,9,85,62,34,64,231,193,157,92,65,20
S01010113,497,14,7,7,33,45,24,24,119,116,102,68,34,20
S01010114,660,11,4,7,43,61,16,50,186,187,93,59,34,13
S01010115,584,15,0,15,109,65,45,83,120,87,47,24,23,13
S01010116,970,68,6,62,208,128,67,121,166,137,39,11,28,36
S01010117,612,81,13,68,155,70,71,62,71,76,13,5,8,13
S01010118,620,2,0,2,53,56,15,54,171,130,132,91,41,7
S01010119,513,9,0,9,57,31,22,47,138,141,54,30,24,14
S01010120,964,10,8,2,83,75,32,69,226,241,189,119,70,39
S01010121,591,4,0,4,50,56,34,47,192,105,87,56,31,16
S01010122,362,6,3,3,13,13,22,25,81,120,71,46,25,11
S01010123,640,21,5,16,50,70,25,21,179,178,84,70,14,12
S01010124,601,16,4,12,106,76,47,87,112,92,42,17,25,23
S01010125,521,16,5,11,57,48,42,53,115,112,69,43,26,9
S01010126,651,42,15,27,96,51,76,72,126,150,37,25,12,1
S01010127,469,22,4,18,50,66,24,40,110,102,43,26,17,12
S01010128,451,5,5,0,29,56,17,23,136,90,83,51,32,12
S01010129,640,5,0,5,71,50,19,44,148,162,114,56,58,27
S01010130,313,3,0,3,36,33,15,37,89,71,25,13,12,4
S01010131,741,64,15,49,186,98,114,96,63,93,19,2,17,8
S01010132,724,19,7,12,49,79,48,50,174,176,98,55,43,31
S01010133,501,4,0,4,61,51,39,65,140,92,39,21,18,10
S01010134,733,23,2,21,104,97,53,74,134,180,56,22,34,12
S01010135,544,11,4,7,81,46,28,49,126,155,44,29,15,4
S01010136,631,32,10,22,132,72,62,74,112,95,35,12,23,17
S01010137,616,27,6,21,121,80,35,70,139,91,36,24,12,17
S01010138,742,31,21,10,67,75,43,65,157,152,133,74,59,19
S01010139,758,20,1,19,93,109,54,102,134,163,64,33,31,19
S01010140,718,44,10,34,130,128,38,67,103,133,55,32,23,20
S01010141,649,19,4,15,60,57,40,46,160,153,95,68,27,19
S01010142,505,10,4,6,65,48,60,49,101,102,55,39,16,15
S01010143,506,8,2,6,73,56,46,37,134,108,32,21,11,12
S01010144,644,13,2,11,100,70,38,63,135,144,55,35,20,26
S01010145,643,25,2,23,97,75,55,60,139,127,55,29,26,10
S01010146,701,15,1,14,83,58,45,63,155,159,97,53,44,26
S01010147,863,11,8,3,67,103,38,65,214,177,172,100,72,16
S01010148,668,11,0,11,54,63,25,71,165,135,120,61,59,24
S01010149,459,22,0,22,103,68,60,46,64,72,18,10,8,6
S01010150,404,11,2,9,46,39,26,34,101,90,46,35,11,11
S01010151,367,13,0,13,44,48,21,13,83,82,48,25,23,15
S01010152,598,18,7,11,61,100,29,72,116,145,29,16,13,28
S01010153,606,39,20,19,115,56,47,66,127,106,29,14,15,21
S01010154,507,24,3,21,79,64,27,23,119,104,50,34,16,17
S01010155,469,16,4,12,72,70,25,70,99,80,34,19,15,3
S01010156,388,23,3,20,18,32,61,12,99,87,50,22,28,6
S01010157,427,11,2,9,54,47,20,29,103,89,74,38,36,0
S01010158,647,26,3,23,78,118,35,58,132,148,34,25,9,18
S01010159,474,14,0,14,79,40,42,57,120,94,22,16,6,6
S01010160,571,5,0,5,25,37,54,72,98,157,93,53,40,30
S01010161,585,26,9,17,80,43,60,60,154,121,39,32,7,2
S01010162,699,10,2,8,36,69,31,46,171,151,165,106,59,20
S01010163,506,11,5,6,47,64,19,29,110,140,65,44,21,21
S01010164,629,11,5,6,63,63,54,82,144,121,80,51,29,11
S01010165,524,0,0,0,53,40,11,28,154,105,118,98,20,15
S01010166,550,6,4,2,64,58,38,61,157,116,39,27,12,11
S01010167,556,8,2,6,33,81,37,41,119,150,71,38,33,16
S01010168,438,8,4,4,65,66,37,41,96,75,50,25,25,0
S01010169,765,11,0,11,140,50,48,59,196,140,105,69,36,16
S01010170,463,3,0,3,58,35,27,32,109,128,60,36,24,11
S01010171,888,11,3,8,63,69,53,96,197,189,198,136,62,12
S01010172,449,15,0,15,81,72,28,45,65,85,54,31,23,4
S01010173,556,22,4,18,80,68,59,71,118,90,44,33,11,4
S01010174,455,25,5,20,77,73,53,71,44,82,23,15,8,7
S01010175,392,16,5,11,61,69,30,27,58,105,26,16,10,0
S01010176,509,25,6,19,66,69,47,42,101,93,48,30,18,18
S01010177,683,16,7,9,58,82,33,53,142,152,121,83,38,26
S01010178,925,16,5,11,84,97,31,74,219,213,180,127,53,11
S01010179,692,7,0,7,52,85,22,49,149,214,88,70,18,26
S01010180,537,28,1,27,97,75,46,47,109,75,43,36,7,17
S01010181,497,7,0,7,63,46,22,29,113,96,116,66,50,5
S01010182,549,64,24,40,124,62,73,55,82,68,13,7,6,8
S01010183,330,12,0,12,38,42,10,45,90,54,30,20,10,9
S01010184,494,10,3,7,49,52,13,56,140,111,57,21,36,6
S01010185,523,4,0,4,63,30,28,63,151,112,55,21,34,17
S01010186,585,30,12,18,150,76,84,63,73,91,16,8,8,2
S01010187,577,32,9,23,134,90,49,77,81,85,12,5,7,17
S01010188,604,85,26,59,152,74,85,58,58,54,28,25,3,10
S01010189,946,115,14,101,277,140,111,120,59,105,10,9,1,9
S01010190,711,180,45,135,181,42,145,57,59,12,13,4,9,22
S01010191,704,102,5,97,215,81,84,71,67,72,8,4,4,4
S01010192,851,148,23,125,212,102,89,112,82,78,21,16,5,7
S01010193,628,85,19,66,173,77,104,75,76,23,7,5,2,8
S01010194,434,16,0,16,84,66,26,57,78,85,18,13,5,4
S01010195,438,20,5,15,44,74,35,35,76,119,33,25,8,2
S01010196,536,13,5,8,66,73,18,42,124,151,42,34,8,7
S01010197,544,4,0,4,75,56,18,41,144,161,38,24,14,7
S01010198,721,17,3,14,97,85,62,69,169,155,50,37,13,17
S01010199,422,19,0,19,46,42,18,28,85,104,75,51,24,5
S01010200,460,3,1,2,86,69,41,45,101,86,25,18,7,4
S01010201,513,22,18,4,61,64,36,64,97,131,32,12,20,6
S01010202,737,16,0,16,65,75,32,45,197,143,133,95,38,31
S01010203,617,64,19,45,123,81,50,82,92,84,26,22,4,15
S01010204,682,2,0,2,50,72,28,64,192,164,99,78,21,11
S01010205,542,23,2,21,86,48,29,51,100,123,59,38,21,23
S01010206,492,18,2,16,11,18,18,23,53,46,259,240,19,46
S01010207,705,17,5,12,75,11,50,39,105,92,261,234,27,55
S01010208,786,34,4,30,176,136,53,69,106,120,57,30,27,35
S01010209,709,52,5,47,102,91,26,91,133,115,88,40,48,11
S01010210,639,38,0,38,146,76,47,39,139,104,34,18,16,16
S01010211,647,11,4,7,78,91,24,68,154,130,81,50,31,10
S01010212,879,26,0,26,69,80,19,79,200,194,161,105,56,51
S01010213,644,21,8,13,79,96,14,85,173,134,36,25,11,6
S01010214,758,50,1,49,143,95,84,113,117,121,32,14,18,3
S01010215,609,7,2,5,45,83,23,69,146,129,84,43,41,23
S01010216,496,14,2,12,55,45,41,27,119,98,80,50,30,17
S01010217,766,22,8,14,69,56,9,65,159,169,176,112,64,41
S01010218,890,32,3,29,143,113,48,77,215,123,114,69,45,25
S01010219,452,13,6,7,42,43,12,35,113,65,76,55,21,53
S01010220,469,97,2,95,105,53,32,20,43,29,9,6,3,81
S01010221,372,9,3,6,31,30,10,38,106,66,68,52,16,14
S01010222,415,23,9,14,43,58,25,53,79,60,42,24,18,32
S01010223,453,25,6,19,56,41,27,52,87,88,50,42,8,27
S01010224,897,39,6,33,104,65,23,56,180,207,180,126,54,43
S01010225,716,27,1,26,133,73,14,45,137,114,121,103,18,52
S01010226,764,34,0,34,64,43,73,77,163,109,140,104,36,61
S01010227,662,37,4,33,46,17,30,48,117,118,200,172,28,49
S01010228,463,8,3,5,32,46,19,31,133,116,70,60,10,8
S01010229,875,39,5,34,142,74,47,98,182,189,73,58,15,31
S01010230,856,38,6,32,71,53,37,56,178,135,157,118,39,131
S01010231,849,48,0,48,90,113,38,46,243,134,95,54,41,42
S01010232,1006,46,10,36,78,102,48,54,207,220,172,118,54,79
S01010233,871,22,0,22,92,54,40,65,181,138,224,160,64,55
S01010234,779,103,7,96,189,89,47,39,104,74,37,24,13,97
S01010235,774,155,10,145,199,64,14,50,54,25,18,9,9,195
S01010236,645,74,13,61,167,74,44,70,80,43,29,24,5,64
S01010237,569,74,10,64,151,69,37,50,75,43,16,4,12,54
S01010238,724,66,5,61,154,95,54,55,85,58,45,23,22,112
S01010239,632,30,3,27,70,88,10,36,150,128,70,26,44,50
S01010240,604,51,5,46,137,90,8,42,104,90,34,25,9,48
S01010241,819,70,19,51,172,107,44,46,135,126,51,24,27,68
S01010242,731,41,0,41,101,92,43,39,129,135,87,56,31,64
S01010243,961,26,5,21,122,138,34,63,169,175,169,98,71,65
S01010244,620,23,2,21,68,61,22,45,112,112,116,78,38,61
S01010245,810,8,5,3,43,47,26,33,176,260,184,139,45,33
S01010246,743,11,0,11,84,55,30,84,175,166,91,59,32,47
S01010247,563,17,3,14,111,95,56,82,73,101,19,13,6,9
S01010248,733,128,6,122,236,59,49,48,67,38,11,4,7,97
S01010249,590,63,12,51,153,59,10,50,71,45,24,15,9,115
S01010250,706,111,13,98,192,62,32,41,57,40,17,16,1,154
S01010251,649,109,1,108,162,72,40,40,48,40,18,12,6,120
S01010252,548,81,0,81,176,66,41,23,52,50,22,19,3,37
S01010253,523,12,2,10,63,54,18,54,103,84,78,53,25,57
S01010254,849,52,7,45,151,126,32,47,173,132,63,53,10,73
S01010255,633,15,1,14,70,68,26,55,116,156,88,55,33,39
S01010256,735,20,0,20,99,86,42,42,189,123,90,47,43,44
S01010257,726,68,7,61,109,31,18,21,52,56,38,28,10,333
S01010258,721,105,12,93,115,40,9,17,23,20,11,6,5,381
S01010259,620,30,3,27,43,47,38,42,113,92,92,60,32,123
S01010260,913,139,7,132,159,89,45,63,67,52,44,33,11,255
S01010261,695,23,2,21,53,59,9,47,78,83,80,61,19,263
S01010262,526,19,2,17,48,34,23,43,80,89,52,34,18,138
S01010263,625,126,11,115,155,41,19,24,33,26,16,6,10,185
S01010264,707,137,9,128,145,62,25,30,57,40,24,14,10,187
S01010265,853,198,23,175,191,61,28,39,30,11,6,2,4,289
S01010266,492,80,9,71,95,29,37,25,31,28,21,15,6,146
S01010267,604,72,2,70,82,23,29,39,35,31,9,3,6,284
S01010268,661,79,5,74,135,56,46,30,64,41,28,23,5,182
S01010269,503,67,7,60,63,43,28,34,41,16,23,14,9,188
S01010270,797,71,9,62,147,64,37,67,83,98,44,24,20,186
S01010271,652,64,6,58,103,48,25,22,41,14,22,15,7,313
S01010272,913,99,5,94,153,86,40,51,127,74,128,86,42,155
S01010273,642,118,10,108,137,74,24,25,17,13,19,13,6,215
S01010274,516,121,9,112,90,40,25,19,29,13,4,3,1,175
S01010275,584,107,10,97,105,35,31,40,23,15,10,8,2,218
S01010276,972,272,30,242,268,80,52,47,34,23,26,14,12,170
S01010277,471,21,3,18,70,55,12,39,70,130,26,21,5,48
S01010278,578,29,3,26,95,52,38,68,125,84,52,34,18,35
S01010279,568,64,12,52,97,65,23,48,75,40,26,11,15,130
S01010280,757,127,13,114,166,101,30,40,61,58,14,10,4,160
S01010281,759,126,6,120,172,57,44,31,63,38,8,4,4,220
S01010282,873,126,8,118,193,64,30,66,79,109,44,30,14,162
S01010283,522,112,7,105,114,52,16,24,53,25,35,23,12,91
S01010284,965,183,3,180,263,107,36,42,41,41,34,21,13,218
S01010285,798,87,5,82,179,60,48,43,56,56,49,25,24,220
S01010286,718,126,9,117,127,58,41,45,57,55,18,17,1,191
S01010287,831,113,13,100,166,52,40,56,30,20,15,13,2,339
S01010288,783,157,18,139,173,51,82,18,39,9,7,3,4,247
S01010289,695,257,29,228,200,35,63,35,20,10,4,3,1,71
S01010290,525,70,8,62,126,50,24,35,25,25,21,19,2,149
S01010291,918,86,4,82,171,89,21,42,89,37,31,17,14,352
S01010292,832,137,8,129,186,61,34,42,48,28,20,10,10,276
S01010293,777,85,4,81,129,52,53,56,73,22,43,21,22,264
S01010294,650,55,1,54,113,39,18,44,32,32,12,12,0,305
S01010295,927,101,8,93,132,59,67,60,81,37,34,25,9,356
S01010296,613,72,2,70,93,42,33,52,68,63,29,23,6,161
S01010297,838,72,7,65,123,85,47,73,108,100,82,60,22,148
S01010298,641,88,9,79,120,77,31,43,79,50,31,20,11,122
S01010299,430,26,2,24,59,39,42,62,69,53,50,34,16,30
S01010300,779,77,15,62,142,87,28,30,104,78,46,42,4,187
S01010301,489,61,9,52,86,39,25,29,31,33,36,21,15,149
S01010302,517,21,1,20,44,45,29,71,64,54,136,96,40,53
S01010303,548,9,0,9,53,22,41,57,94,70,163,141,22,39
S01010304,472,37,1,36,74,38,16,45,79,43,63,35,28,77
S01010305,622,66,9,57,114,71,47,54,71,66,37,24,13,96
S01010306,714,117,10,107,181,59,24,39,74,29,37,16,21,154
S01010307,749,174,6,168,221,62,36,18,56,25,19,5,14,138
S01010308,898,211,17,194,229,51,39,31,75,36,28,18,10,198
S01010309,326,6,2,4,36,32,7,32,77,73,46,30,16,17
S01010310,662,17,4,13,56,52,22,84,136,121,111,76,35,63
S01010311,612,8,0,8,48,48,21,67,115,134,125,90,35,46
S01010312,761,2,1,1,66,61,25,64,190,171,152,98,54,30
S01010313,525,24,7,17,36,27,20,31,144,114,98,65,33,31
S01010314,813,34,3,31,147,89,33,37,149,114,101,64,37,109
S01010315,824,69,6,63,135,83,53,76,142,139,91,72,19,36
S01010316,485,40,3,37,63,46,13,26,124,76,60,54,6,37
S01010317,651,112,4,108,186,64,34,26,30,24,8,3,5,167
S01010318,464,23,1,22,71,55,28,28,108,54,44,10,34,53
S01010319,648,134,14,120,120,90,44,42,78,41,16,8,8,83
S01010320,591,86,4,82,124,55,18,23,71,55,53,36,17,106
S01010321,633,61,1,60,134,78,29,42,101,59,54,23,31,75
S01010322,915,265,11,254,259,62,58,34,50,26,9,5,4,152
S01010323,475,15,4,11,24,38,2,38,133,98,103,81,22,24
S01010324,501,3,0,3,65,55,34,34,116,130,51,31,20,13
S01010325,585,6,6,0,60,75,26,56,157,141,61,30,31,3
S01010326,881,14,0,14,61,68,44,74,234,159,199,128,71,28
S01010327,805,62,10,52,85,65,76,93,156,152,84,44,40,32
S01010328,747,38,6,32,140,89,76,81,120,122,42,19,23,39
S01010329,424,14,0,14,69,57,38,46,92,73,26,21,5,9
S01010330,538,11,0,11,44,50,34,53,132,119,89,49,40,6
S01010331,658,18,10,8,73,84,30,69,162,129,82,47,35,11
S01010332,584,0,0,0,79,53,23,71,164,97,81,57,24,16
S01010333,751,21,4,17,93,92,59,80,169,134,66,42,24,37
S01010334,754,28,3,25,130,114,41,66,184,137,44,31,13,10
S01010335,596,9,2,7,62,74,36,46,139,157,54,21,33,19
S01010336,577,14,0,14,35,59,25,38,147,119,104,59,45,36
S01010337,490,6,0,6,46,74,24,37,134,119,46,28,18,4
S01010338,642,4,0,4,60,69,36,60,131,161,103,74,29,18
S01010339,522,27,4,23,68,51,24,64,127,82,76,59,17,3
S01010340,621,29,7,22,75,82,44,64,160,75,76,30,46,16
S01010341,497,11,0,11,114,62,39,47,104,89,25,9,16,6
S01010342,560,35,8,27,125,54,49,89,97,89,8,2,6,14
S01010343,886,44,7,37,234,147,92,146,136,71,4,1,3,12
S01010344,564,9,1,8,49,57,26,59,136,133,84,34,50,11
S01010345,468,84,27,57,143,27,73,28,59,35,2,0,2,17
S01010346,827,125,26,99,194,118,81,84,130,70,14,11,3,11
S01010347,762,45,6,39,115,87,39,99,139,113,103,47,56,22
S01010348,737,34,2,32,122,110,39,98,171,107,42,20,22,14
S01010349,678,18,1,17,121,78,39,81,178,126,29,12,17,8
S01010350,770,18,9,9,98,92,27,71,201,135,107,57,50,21
S01010351,766,42,8,34,130,96,54,104,126,117,46,29,17,51
S01010352,367,18,1,17,50,46,15,28,81,70,44,23,21,15
S01010353,822,39,1,38,74,62,46,88,184,140,171,120,51,18
S01010354,617,35,10,25,85,63,34,62,156,86,63,32,31,33
S01010355,621,44,2,42,75,70,40,62,116,102,92,63,29,20
S01010356,640,56,4,52,138,67,45,82,94,79,55,21,34,24
S01010357,472,28,5,23,79,42,15,37,96,88,65,27,38,22
S01010358,657,21,8,13,61,61,28,55,163,148,92,41,51,28
S01010359,651,22,7,15,53,55,37,46,172,145,104,69,35,17
S01010360,523,21,0,21,90,51,21,61,90,98,66,35,31,25
S01010361,525,23,0,23,56,47,15,54,104,94,94,46,48,38
S01010362,646,33,5,28,52,73,7,57,115,132,123,74,49,54
S01010363,663,153,12,141,215,62,42,33,53,36,24,8,16,45
S01010364,756,191,35,156,270,85,88,57,34,23,1,1,0,7
S01010365,815,278,38,240,276,60,76,32,38,7,20,15,5,28
S01010366,870,260,20,240,266,56,62,32,60,42,17,2,15,75
S01010367,840,286,40,246,278,67,65,16,38,20,9,3,6,61
S01010368,565,246,40,206,159,40,39,18,25,5,1,0,1,32
S01010369,723,161,18,143,189,72,54,29,55,58,31,21,10,74
S01010370,679,214,29,185,193,39,76,39,7,26,2,1,1,83
S01010371,902,246,35,211,265,63,70,27,28,23,5,3,2,175
S01010372,461,133,28,105,144,50,38,23,21,19,0,0,0,33
S01010373,677,159,16,143,220,47,47,16,39,35,10,6,4,104
S01010374,838,251,22,229,238,44,65,29,24,16,7,3,4,164
S01010375,503,77,5,72,72,9,25,8,26,16,4,1,3,266
S01010376,679,86,5,81,161,26,35,21,23,17,20,17,3,290
S01010377,827,127,5,122,129,49,44,19,58,31,34,30,4,336
S01010378,708,133,11,122,82,30,37,9,17,1,25,7,18,374
S01010379,934,124,10,114,172,48,40,28,61,18,16,10,6,427
S01010380,845,197,30,167,261,60,48,16,45,35,14,3,11,169
S01010381,589,118,7,111,87,43,17,19,37,22,20,13,7,226
S01010382,782,137,8,129,178,69,41,46,63,31,23,12,11,194
S01010383,576,33,5,28,99,78,44,20,69,54,48,24,24,131
S01010384,740,175,21,154,188,49,37,31,26,44,16,9,7,174
S01010385,740,115,3,112,180,71,38,51,71,42,29,19,10,143
S01010386,766,66,7,59,158,69,49,45,113,77,55,34,21,134
S01010387,948,184,8,176,246,75,27,39,78,66,38,18,20,195
S01010388,839,74,1,73,187,118,56,67,108,90,45,12,33,94
S01010389,999,274,35,239,279,70,42,35,45,40,17,8,9,197
S01010390,1025,182,14,168,287,128,51,57,92,80,39,11,28,109
S01010391,713,81,8,73,208,98,42,53,85,40,25,15,10,81
S01010392,669,214,21,193,215,56,42,13,16,19,9,3,6,85
S01010393,853,149,12,137,268,103,44,53,68,37,25,15,10,106
S01010394,628,84,5,79,124,58,46,29,99,83,69,40,29,36
S01010395,858,142,13,129,232,99,41,64,81,45,36,17,19,118
S01010396,853,184,7,177,196,82,42,42,95,64,34,16,18,114
S01010397,480,152,18,134,106,33,22,5,34,13,16,9,7,99
S01010398,924,264,40,224,289,76,54,44,39,24,13,7,6,121
S01010399,946,353,29,324,315,55,34,20,28,14,12,2,10,115
S01010400,946,330,25,305,305,49,54,27,44,19,17,14,3,101
S01010401,565,172,17,155,149,50,31,17,19,18,5,1,4,104
S01010402,895,380,35,345,260,56,62,19,25,18,8,1,7,67
S01010403,856,375,30,345,242,49,58,24,22,1,3,3,0,82
S01010404,631,214,24,190,208,32,79,24,21,22,4,3,1,27
S01010405,717,293,29,264,237,42,53,16,18,13,11,5,6,34
S01010406,766,212,21,191,188,47,71,23,40,26,11,4,7,148
S01010407,844,138,29,109,184,35,25,16,35,23,16,7,9,372
S01010408,423,118,20,98,93,60,48,14,27,37,14,12,2,12
S01010409,576,185,22,163,186,50,80,34,8,24,8,6,2,1
S01010410,509,201,32,169,145,48,55,16,9,15,9,4,5,11
S01010411,953,416,50,366,300,45,91,37,12,18,18,14,4,16
S01010412,673,214,37,177,229,46,44,22,35,29,4,3,1,50
S01010413,482,172,22,150,164,43,36,23,17,7,6,4,2,14
S01010414,847,263,24,239,302,97,48,34,39,30,4,2,2,30
S01010415,766,120,14,106,160,88,84,52,74,100,38,13,25,50
S01010416,539,177,27,150,175,52,38,22,32,26,2,0,2,15
S01010417,480,170,18,152,160,42,40,11,31,7,3,2,1,16
S01010418,956,361,25,336,327,55,77,30,48,16,14,9,5,28
S01010419,849,357,47,310,270,67,54,26,36,24,4,0,4,11
S01010420,540,185,21,164,178,17,53,33,30,32,10,7,3,2
S01010421,731,323,29,294,257,41,45,28,16,6,11,3,8,4
S01010422,873,239,40,199,330,49,73,31,74,44,17,7,10,16
S01010423,734,60,8,52,133,88,30,41,133,113,78,44,34,58
S01010424,680,51,3,48,120,96,30,59,119,107,65,33,32,33
S01010425,920,39,6,33,176,107,42,75,193,138,101,60,41,49
S01010426,639,51,9,42,157,68,38,65,101,72,62,35,27,25
S01010427,869,49,3,46,117,58,77,83,153,107,197,138,59,28
S01010428,573,185,29,156,211,54,31,28,24,16,10,8,2,14
S01010429,847,244,36,208,349,62,42,39,61,10,16,3,13,24
S01010430,733,19,5,14,76,84,54,40,148,154,97,61,36,61
S01010431,606,193,33,160,238,38,51,30,21,19,7,7,0,9
S01010432,796,28,10,18,113,111,28,73,179,120,87,65,22,57
S01010433,778,19,0,19,45,30,68,63,164,117,214,167,47,58
S01010434,557,21,3,18,68,50,21,61,107,102,80,50,30,47
S01010435,471,23,0,23,92,60,28,66,86,90,16,11,5,10
S01010436,691,38,1,37,105,100,47,55,107,106,93,51,42,40
S01010437,437,14,8,6,94,50,19,25,96,90,30,16,14,19
S01010438,816,26,2,24,146,69,49,93,191,123,87,63,24,32
S01010439,923,37,6,31,186,130,35,83,128,198,58,37,21,68
S01010440,542,36,10,26,85,71,25,54,90,79,90,68,22,12
S01010441,748,83,11,72,194,143,31,81,84,67,35,8,27,30
S01010442,712,22,2,20,137,98,34,83,142,114,61,34,27,21
S01010443,434,22,2,20,87,87,42,56,78,38,18,2,16,6
S01010444,528,29,3,26,62,82,46,44,110,102,49,25,24,4
S01010445,642,26,1,25,92,55,52,63,127,147,66,55,11,14
S01010446,673,53,9,44,179,73,109,82,81,74,13,8,5,9
S01010447,845,33,1,32,118,117,60,96,158,137,91,48,43,35
S01010448,689,86,29,57,167,96,72,73,101,72,21,13,8,1
S01010449,560,31,1,30,109,93,29,46,95,126,23,19,4,8
S01010450,556,40,8,32,141,71,31,54,102,66,39,24,15,12
S01010451,693,58,9,49,93,68,46,46,151,121,92,49,43,18
S01010452,556,29,4,25,147,93,35,76,80,65,23,10,13,8
S01010453,596,35,0,35,77,53,40,59,94,84,129,78,51,25
S01010454,581,36,4,32,102,79,46,76,91,110,23,17,6,18
S01010455,690,32,1,31,104,97,41,45,131,134,86,55,31,20
S01010456,388,28,3,25,86,55,25,51,58,57,21,13,8,7
S01010457,493,44,7,37,73,46,40,46,98,78,57,41,16,11
S01010458,565,19,6,13,110,83,33,63,124,56,49,36,13,28
S01010459,374,35,0,35,68,51,46,23,70,38,29,25,4,14
S01010460,637,214,33,181,180,36,80,34,27,41,10,9,1,15
S01010461,533,24,1,23,123,50,45,20,105,86,63,38,25,17
S01010462,866,8,2,6,53,22,42,48,133,176,309,223,86,75
S01010463,609,100,18,82,145,86,66,42,78,48,40,10,30,4
S01010464,392,37,10,27,113,65,31,42,60,25,15,7,8,4
S01010465,844,105,12,93,328,127,30,63,94,57,20,11,9,20
S01010466,802,178,32,146,260,81,64,40,54,26,27,14,13,72
S01010467,579,128,18,110,176,48,62,26,57,26,16,12,4,40
S01010468,827,193,14,179,239,109,92,10,79,52,11,7,4,42
S01010469,462,63,6,57,125,60,20,49,37,36,33,14,19,39
S01010470,528,32,9,23,160,85,58,52,66,45,21,10,11,9
S01010471,529,46,3,43,95,36,13,62,78,121,70,51,19,8
S01010472,482,118,13,105,119,55,19,38,43,32,18,6,12,40
S01010473,643,85,6,79,182,85,39,44,85,63,23,11,12,37
S01010474,718,88,8,80,167,72,42,58,91,65,45,32,13,90
S01010475,611,120,8,112,206,88,32,36,46,40,4,3,1,39
S01010476,745,136,6,130,197,87,61,53,73,60,27,16,11,51
S01010477,553,44,4,40,132,81,30,60,97,87,13,10,3,9
S01010478,808,30,6,24,152,113,52,68,160,157,60,44,16,16
S01010479,792,36,8,28,165,122,60,75,154,129,34,11,23,17
S01010480,448,62,23,39,78,75,50,38,69,39,28,24,4,9
S01010481,597,4,1,3,69,62,48,68,109,134,97,66,31,6
S01010482,569,49,20,29,123,103,41,46,106,70,26,18,8,5
S01010483,787,68,12,56,146,96,83,61,164,127,33,24,9,9
S01010484,438,25,4,21,78,60,39,56,89,56,28,18,10,7
S01010485,805,70,29,41,237,119,54,63,94,93,62,37,25,13
S01010486,764,70,16,54,202,121,137,67,86,64,16,11,5,1
S01010487,765,52,12,40,173,122,68,87,106,121,30,9,21,6
S01010488,767,29,5,24,51,88,27,52,217,161,133,78,55,9
S01010489,772,26,6,20,109,114,34,90,167,143,75,45,30,14
S01010490,683,22,0,22,43,91,35,63,158,133,109,62,47,29
S01010491,817,11,8,3,68,95,37,43,239,155,152,102,50,17
S01010492,479,11,5,6,30,48,12,43,114,112,93,71,22,16
S01010493,679,12,0,12,19,65,36,49,161,169,136,62,74,32
S01010494,590,23,9,14,67,56,39,72,122,119,70,43,27,22
S01010495,791,15,8,7,83,105,32,69,166,180,129,81,48,12
S01010496,721,10,0,10,64,73,29,63,138,161,165,128,37,18
S01010497,715,10,1,9,82,67,51,66,164,147,121,89,32,7
S01010498,742,11,2,9,44,75,26,60,163,211,128,81,47,24
S01010499,668,8,0,8,33,35,29,43,161,144,186,136,50,29
S01010500,990,58,14,44,119,76,43,57,237,202,179,96,83,19
S01010501,801,22,5,17,102,105,47,98,168,166,87,56,31,6
S01010502,749,14,1,13,97,121,59,90,175,131,40,33,7,22
S01010503,515,3,0,3,61,69,20,47,135,114,56,41,15,10
S01010504,402,28,0,28,81,30,184,19,32,26,2,1,1,0
S01010505,436,27,2,25,96,7,140,32,79,40,10,3,7,5
S01010506,635,32,4,28,188,35,174,64,63,63,7,5,2,9
S01010507,652,41,12,29,151,37,117,93,119,68,22,7,15,4
S01010508,723,72,22,50,173,53,108,84,146,73,7,3,4,7
S01010509,777,53,8,45,213,53,166,116,121,43,12,1,11,0
S01010510,553,49,11,38,135,71,73,98,77,48,2,0,2,0
S01010511,749,28,7,21,140,45,53,151,149,168,12,6,6,3
S01010512,452,19,5,14,97,30,63,82,67,86,8,0,8,0
S01010513,612,72,29,43,134,39,110,122,75,51,6,3,3,3
S01010514,586,30,13,17,109,58,57,97,101,124,9,3,6,1
S01010515,643,22,8,14,102,40,40,123,123,176,15,4,11,2
S01010516,454,46,11,35,125,25,98,37,57,47,14,1,13,5
S01010517,730,68,22,46,163,59,57,90,121,114,45,16,29,13
S01010518,561,39,24,15,113,43,70,82,84,106,9,2,7,15
S01010519,643,36,8,28,136,45,44,68,127,133,51,16,35,3
S01010520,739,56,21,35,162,70,85,143,97,111,4,1,3,11
S01010521,613,31,6,25,175,28,76,99,102,93,4,1,3,5
S01010522,480,28,15,13,81,48,53,53,97,86,26,22,4,8
S01010523,582,15,0,15,86,45,42,61,157,153,23,7,16,0
S01010524,385,43,10,33,83,18,101,56,44,34,3,3,0,3
S01010525,466,56,19,37,104,50,110,47,66,28,5,1,4,0
S01010526,626,68,13,55,107,58,143,92,92,58,3,1,2,5
S01010527,683,24,10,14,165,61,53,124,115,109,15,8,7,17
S01010528,499,60,2,58,115,21,114,64,70,33,6,5,1,16
S01010529,557,72,10,62,155,24,100,70,51,80,4,0,4,1
S01010530,504,49,22,27,110,34,135,57,59,57,3,0,3,0
S01010531,797,87,30,57,165,73,183,111,89,83,2,2,0,4
S01010532,409,53,18,35,62,19,90,89,38,53,2,1,1,3
S01010533,391,51,20,31,94,11,77,44,64,44,6,1,5,0
S01010534,721,74,21,53,149,70,110,93,129,85,11,6,5,0
S01010535,541,54,17,37,150,42,115,79,42,46,0,0,0,13
S01010536,658,43,23,20,142,68,72,125,89,102,17,6,11,0
S01010537,542,41,10,31,102,48,81,104,79,73,11,3,8,3
S01010538,802,63,13,50,164,92,96,138,124,112,6,3,3,7
S01010539,847,70,22,48,247,90,116,134,102,70,12,0,12,6
S01010540,454,64,24,40,88,42,74,57,64,55,5,1,4,5
S01010541,647,54,13,41,183,67,107,84,68,77,3,1,2,4
S01010542,661,70,21,49,177,38,122,107,72,62,9,2,7,4
S01010543,471,41,15,26,120,37,147,25,56,45,0,0,0,0
S01010544,689,39,4,35,137,30,110,96,114,127,35,5,30,1
S01010545,561,74,20,54,137,40,98,42,58,93,15,3,12,4
S01010546,539,63,18,45,87,37,82,77,82,98,13,2,11,0
S01010547,577,62,27,35,110,45,134,111,56,41,10,4,6,8
S01010548,447,47,15,32,109,51,81,64,56,34,2,0,2,3
S01010549,807,89,19,70,292,63,44,130,97,73,4,2,2,15
S01010550,428,49,9,40,102,43,50,59,56,58,5,3,2,6
S01010551,603,115,23,92,140,35,145,52,39,66,8,0,8,3
S01010552,627,104,20,84,119,46,130,73,59,83,10,6,4,3
S01010553,501,76,26,50,112,61,112,56,59,17,0,0,0,8
S01010554,614,34,10,24,169,65,87,58,92,81,25,11,14,3
S01010555,780,85,22,63,181,70,74,80,123,123,31,9,22,13
S01010556,741,40,14,26,111,60,62,125,160,152,25,3,22,6
S01010557,484,53,15,38,97,29,30,68,94,88,21,10,11,4
S01010558,549,37,10,27,125,39,61,91,80,94,22,10,12,0
S01010559,494,113,17,96,185,33,57,38,37,22,5,0,5,4
S01010560,477,101,7,94,133,36,41,84,39,32,8,0,8,3
S01010561,523,105,17,88,147,59,69,36,48,50,5,0,5,4
S01010562,560,30,4,26,158,80,54,110,66,53,9,3,6,0
S01010563,440,44,15,29,97,30,52,55,51,86,20,0,20,5
S01010564,368,9,1,8,65,19,43,59,70,73,26,10,16,4
S01010565,505,47,16,31,123,36,35,92,90,61,14,5,9,7
S01010566,909,138,61,77,215,58,174,146,92,62,5,1,4,19
S01010567,840,156,44,112,293,57,148,80,41,61,4,0,4,0
S01010568,832,140,26,114,192,74,130,102,111,73,8,4,4,2
S01010569,591,99,20,79,120,44,136,66,69,50,7,6,1,0
S01010570,901,64,7,57,157,82,82,124,177,175,31,13,18,9
S01010571,681,69,14,55,166,111,54,103,79,91,5,2,3,3
S01010572,688,46,4,42,121,91,56,95,115,135,24,2,22,5
S01010573,464,37,21,16,89,26,35,83,95,91,3,1,2,5
S01010574,505,93,23,70,191,43,59,43,28,43,1,0,1,4
S01010575,531,82,30,52,176,88,42,40,57,37,7,0,7,2
S01010576,647,122,11,111,210,70,74,69,68,27,2,0,2,5
S01010577,778,24,7,17,125,65,71,115,175,166,25,22,3,12
S01010578,522,24,10,14,115,65,66,78,84,80,7,7,0,3
S01010579,611,55,12,43,178,66,65,115,75,54,1,0,1,2
S01010580,449,38,0,38,96,66,30,54,73,67,17,16,1,8
S01010581,486,43,12,31,154,47,39,73,48,64,11,7,4,7
S01010582,394,78,16,62,96,43,49,69,31,27,0,0,0,1
S01010583,822,71,15,56,298,135,56,103,76,76,2,0,2,5
S01010584,767,95,28,67,220,88,98,97,83,64,16,11,5,6
S01010585,824,116,38,78,236,121,84,129,84,44,9,0,9,1
S01010586,654,136,46,90,212,57,71,95,41,35,4,0,4,3
S01010587,532,60,9,51,181,58,66,66,58,32,4,4,0,7
S01010588,545,94,30,64,168,67,47,46,67,43,10,9,1,3
S01010589,552,32,3,29,92,81,32,64,122,94,25,21,4,10
S01010590,817,238,70,168,287,70,80,60,42,33,7,3,4,0
S01010591,747,65,12,53,241,84,59,115,67,66,34,10,24,16
S01010592,441,40,4,36,121,62,22,45,84,51,14,6,8,2
S01010593,534,106,29,77,195,47,77,48,35,26,0,0,0,0
S01010594,606,57,11,46,178,70,55,113,70,51,9,5,4,3
S01010595,807,132,21,111,259,68,64,103,74,80,13,0,13,14
S01010596,765,149,35,114,222,76,119,71,57,60,4,0,4,7
S01010597,623,65,19,46,224,60,72,79,60,40,16,13,3,7
S01010598,1011,178,35,143,342,109,79,101,101,70,16,14,2,15
S01010599,526,104,30,74,152,80,29,62,45,46,3,1,2,5
S01010600,662,108,28,80,245,60,83,53,64,40,7,6,1,2
S01010601,440,67,0,67,133,52,37,49,38,54,10,3,7,0
S01010602,453,61,16,45,121,32,55,69,65,46,3,3,0,1
S01010603,621,73,28,45,219,80,50,81,40,69,8,2,6,1
S01010604,395,86,12,74,144,34,49,46,16,9,8,5,3,3
S01010605,649,103,27,76,183,72,99,83,57,41,8,8,0,3
S01010606,632,32,12,20,103,51,85,108,84,137,13,3,10,19
S01010607,674,132,53,79,214,61,101,47,62,54,1,0,1,2
S01010608,583,42,7,35,65,57,30,70,147,97,59,9,50,16
S01010609,484,19,1,18,85,40,32,56,97,135,11,3,8,9
S01010610,439,97,17,80,133,45,51,38,32,32,1,0,1,10
S01010611,756,21,0,21,177,85,50,139,156,107,16,6,10,5
S01010612,633,28,2,26,141,78,48,108,99,125,6,2,4,0
S01010613,507,72,10,62,158,70,33,48,48,64,2,1,1,12
S01010614,444,1,1,0,70,53,18,67,106,103,18,7,11,8
S01010615,760,76,11,65,222,99,63,108,77,100,7,0,7,8
S01010616,657,80,14,66,197,82,54,93,74,65,3,3,0,9
S01010617,753,74,24,50,273,102,50,82,116,53,0,0,0,3
S01010618,655,58,12,46,175,100,82,71,77,81,3,0,3,8
S01010619,586,30,3,27,103,48,47,74,104,147,13,10,3,20
S01010620,581,46,5,41,86,58,21,67,132,104,47,27,20,20
S01010621,755,174,20,154,163,45,67,72,109,82,22,12,10,21
S01010622,541,13,0,13,111,41,29,68,127,116,29,3,26,7
S01010623,848,67,40,27,360,176,53,54,77,42,9,5,4,10
S01010624,460,41,2,39,119,40,24,55,61,96,20,1,19,4
S01010625,526,144,29,115,157,53,91,29,28,18,6,0,6,0
S01010626,552,147,28,119,186,38,67,29,34,47,4,0,4,0
S01010627,631,100,9,91,153,36,79,57,103,72,18,13,5,13
S01010628,713,118,17,101,198,68,64,69,88,89,5,1,4,14
S01010629,695,152,23,129,205,50,89,45,84,51,11,0,11,8
S01010630,483,32,5,27,91,58,62,48,92,71,27,15,12,2
S01010631,470,56,4,52,90,74,35,64,79,58,10,8,2,4
S01010632,683,37,6,31,119,61,82,96,138,117,23,7,16,10
S01010633,817,24,0,24,120,69,65,136,162,185,32,12,20,24
S01010634,516,25,6,19,68,43,62,79,103,127,5,0,5,4
S01010635,621,24,9,15,122,68,45,76,112,126,30,12,18,18
S01010636,638,79,20,59,157,57,84,52,102,93,9,6,3,5
S01010637,390,40,9,31,72,39,30,51,68,60,21,13,8,9
S01010638,523,50,8,42,110,34,78,62,77,102,6,1,5,4
S01010639,957,52,2,50,125,80,64,163,230,185,37,18,19,21
S01010640,692,73,11,62,138,38,86,93,140,83,25,10,15,16
S01010641,887,54,7,47,108,82,63,55,266,186,64,27,37,9
S01010642,843,18,8,10,87,51,53,129,191,222,79,37,42,13
S01010643,697,0,0,0,95,59,40,101,160,167,72,36,36,3
S01010644,591,11,0,11,59,29,18,49,169,175,66,31,35,15
S01010645,463,52,11,41,93,55,48,65,59,77,8,5,3,6
S01010646,555,80,24,56,168,79,48,59,55,58,4,2,2,4
S01010647,517,57,15,42,151,55,44,86,43,69,8,2,6,4
S01010648,538,54,11,43,125,83,55,52,74,75,16,5,11,4
S01010649,402,44,17,27,121,41,35,38,54,56,4,0,4,9
S01010650,407,29,2,27,111,42,62,16,76,50,15,7,8,6
S01010651,575,13,6,7,83,91,69,78,116,116,5,3,2,4
S01010652,619,66,16,50,197,68,54,68,76,61,25,9,16,4
S01010653,453,31,5,26,109,75,41,65,53,76,3,2,1,0
S01010654,647,11,3,8,138,89,62,68,158,98,13,6,7,10
S01010655,745,103,27,76,206,56,203,48,77,45,7,0,7,0
S01010656,383,40,10,30,77,25,73,44,67,50,5,1,4,2
S01010657,515,100,28,72,115,43,120,69,25,34,5,0,5,4
S01010658,587,115,22,93,156,45,88,66,57,57,3,0,3,0
S01010659,494,94,23,71,138,38,81,31,60,41,11,10,1,0
S01010660,453,31,3,28,126,36,84,56,46,68,4,4,0,2
S01010661,432,22,6,16,113,45,63,73,53,46,10,7,3,7
S01010662,621,90,16,74,140,60,137,68,58,60,4,3,1,4
S01010663,751,104,17,87,217,67,155,61,78,61,2,0,2,6
S01010664,652,122,25,97,172,58,163,51,38,38,7,1,6,3
S01010665,740,94,33,61,167,76,146,92,80,75,5,2,3,5
S01010666,728,86,28,58,173,44,127,122,109,57,5,1,4,5
S01010667,554,81,10,71,131,39,149,46,32,59,13,7,6,4
S01010668,822,58,23,35,188,52,188,157,79,85,8,3,5,7
S01010669,459,79,20,59,116,25,93,57,51,33,4,4,0,1
S01010670,556,53,18,35,123,47,120,59,79,65,10,0,10,0
S01010671,567,62,5,57,119,35,138,47,100,50,14,6,8,2
S01010672,520,21,9,12,78,62,99,69,96,78,12,0,12,5
S01010673,699,69,7,62,168,50,153,61,86,88,21,3,18,3
S01010674,794,76,6,70,187,48,197,70,115,75,9,0,9,17
S01010675,461,34,11,23,84,21,157,41,74,41,9,0,9,0
S01010676,651,81,18,63,162,69,139,67,62,63,3,2,1,5
S01010677,368,52,13,39,98,7,95,47,36,31,1,0,1,1
S01010678,458,24,5,19,111,25,115,62,40,75,6,3,3,0
S01010679,424,35,7,28,119,52,79,49,45,32,11,4,7,2
S01010680,494,34,1,33,121,47,74,41,66,86,23,4,19,2
S01010681,973,39,12,27,226,73,183,111,165,124,50,19,31,2
S01010682,786,79,8,71,193,87,192,57,57,107,13,8,5,1
S01010683,737,50,8,42,179,51,159,97,97,86,11,1,10,7
S01010684,535,41,11,30,136,47,148,51,70,42,0,0,0,0
S01010685,447,40,6,34,103,29,127,43,39,57,9,3,6,0
S01010686,518,35,6,29,112,20,138,78,61,66,6,0,6,2
S01010687,596,61,11,50,145,66,109,65,75,69,2,0,2,4
S01010688,490,53,9,44,147,38,135,31,40,41,2,0,2,3
S01010689,482,73,10,63,109,30,124,34,70,38,1,0,1,3
S01010690,492,23,5,18,109,54,126,61,49,49,19,2,17,2
S01010691,571,64,17,47,134,39,206,53,49,22,4,1,3,0
S01010692,614,53,2,51,123,46,118,105,117,49,0,0,0,3
S01010693,354,49,21,28,91,19,115,33,24,23,0,0,0,0
S01010694,378,47,4,43,73,22,81,57,37,54,5,0,5,2
S01010695,546,82,10,72,125,57,139,60,51,29,2,0,2,1
S01010696,763,110,15,95,152,74,107,85,96,118,12,8,4,9
S01010697,817,128,15,113,171,57,155,112,74,109,4,0,4,7
S01010698,594,57,9,48,103,41,122,65,97,93,12,7,5,4
S01010699,521,69,29,40,102,27,106,96,62,49,5,0,5,5
S01010700,487,76,10,66,142,30,93,51,49,41,2,0,2,3
S01010701,893,108,9,99,199,92,136,120,105,122,9,4,5,2
S01010702,734,95,20,75,168,52,145,103,81,81,6,1,5,3
S01010703,621,75,9,66,146,46,140,73,52,76,5,2,3,8
S01010704,486,50,8,42,89,67,56,61,64,91,5,5,0,3
S01010705,911,108,24,84,207,81,126,130,102,127,22,3,19,8
S01010706,577,26,8,18,102,51,71,92,115,97,18,10,8,5
S01010707,519,61,10,51,128,45,106,66,58,51,1,1,0,3
S01010708,425,29,0,29,88,47,72,59,59,55,16,5,11,0
S01010709,617,92,30,62,160,53,80,64,70,88,9,0,9,1
S01010710,623,24,0,24,107,72,66,78,88,145,32,21,11,11
S01010711,623,142,33,109,195,62,68,32,64,49,3,2,1,8
S01010712,623,35,14,21,112,58,66,92,84,152,12,5,7,12
S01010713,694,41,20,21,101,60,74,130,111,167,7,4,3,3
S01010714,560,27,7,20,91,67,24,79,123,122,19,7,12,8
S01010715,514,37,8,29,81,55,56,71,130,64,17,1,16,3
S01010716,660,76,15,61,131,61,51,71,103,140,19,7,12,8
S01010717,443,78,23,55,123,61,45,34,69,33,0,0,0,0
S01010718,811,74,7,67,228,76,101,94,111,93,29,17,12,5
S01010719,495,86,17,69,127,43,60,72,42,47,10,3,7,8
S01010720,491,130,31,99,131,20,70,68,38,34,0,0,0,0
S01010721,450,60,3,57,150,45,75,38,38,40,2,1,1,2
S01010722,657,88,29,59,203,47,84,62,77,81,8,2,6,7
S01010723,777,150,40,110,221,48,195,71,44,46,2,1,1,0
S01010724,712,107,38,69,201,52,149,63,68,61,11,0,11,0
S01010725,514,123,27,96,145,33,118,31,30,30,4,0,4,0
S01010726,650,98,36,62,183,71,118,75,50,46,9,0,9,0
S01010727,506,89,15,74,119,49,134,35,38,42,0,0,0,0
S01010728,399,78,30,48,135,56,58,44,14,9,4,0,4,1
S01010729,576,92,21,71,126,78,114,68,38,58,0,0,0,2
S01010730,693,94,17,77,204,51,169,71,44,53,3,1,2,4
S01010731,732,89,19,70,201,73,112,74,95,71,12,1,11,5
S01010732,727,44,2,42,74,47,62,108,153,172,53,35,18,14
S01010733,504,10,0,10,69,69,49,72,103,92,29,24,5,11
S01010734,800,44,13,31,120,61,78,55,166,215,56,45,11,5
S01010735,596,28,12,16,87,42,32,64,119,151,66,41,25,7
S01010736,381,50,12,38,106,26,40,59,62,38,0,0,0,0
S01010737,757,65,8,57,171,52,85,111,117,135,20,7,13,1
S01010738,390,11,1,10,67,40,33,66,80,80,11,11,0,2
S01010739,724,41,2,39,147,51,80,105,108,151,37,13,24,4
S01010740,419,8,2,6,55,46,17,53,95,97,47,21,26,1
S01010741,433,45,10,35,77,19,75,62,59,87,9,4,5,0
S01010742,590,52,14,38,78,37,24,109,132,115,40,27,13,3
S01010743,656,20,4,16,85,41,48,110,163,126,61,27,34,2
S01010744,847,52,12,40,209,46,68,144,162,140,19,5,14,7
S01010745,466,32,3,29,86,39,38,78,79,88,22,6,16,4
S01010746,826,87,27,60,167,80,154,132,100,88,17,12,5,1
S01010747,684,44,11,33,114,48,81,110,136,119,24,19,5,8
S01010748,489,57,12,45,85,33,99,51,60,89,10,5,5,5
S01010749,487,46,17,29,97,52,87,67,40,84,6,0,6,8
S01010750,433,45,8,37,95,27,76,43,64,60,23,13,10,0
S01010751,609,30,5,25,75,52,67,65,92,162,62,33,29,4
S01010752,649,27,0,27,123,45,77,109,97,148,19,7,12,4
S01010753,926,57,6,51,179,40,132,138,189,134,51,30,21,6
S01010754,522,39,14,25,128,39,55,60,87,91,21,19,2,2
S01010755,459,33,4,29,80,31,59,70,82,93,7,5,2,4
S01010756,500,49,6,43,128,62,92,46,67,44,12,7,5,0
S01010757,519,56,20,36,86,57,105,75,71,61,5,4,1,3
S01010758,484,46,20,26,92,36,115,57,66,49,6,1,5,17
S01010759,471,40,6,34,95,39,72,55,75,72,6,1,5,17
S01010760,352,67,28,39,81,29,45,46,29,41,7,2,5,7
S01010761,396,62,21,41,81,7,94,49,52,29,22,0,22,0
S01010762,430,45,18,27,116,37,106,38,56,24,8,4,4,0
S01010763,509,43,7,36,120,36,107,41,62,75,19,6,13,6
S01010764,398,26,7,19,90,18,121,53,50,35,1,0,1,4
S01010765,713,64,23,41,149,42,129,111,118,81,14,11,3,5
S01010766,567,24,10,14,136,53,103,57,86,91,15,2,13,2
S01010767,514,17,0,17,76,39,56,90,97,107,32,8,24,0
S01010768,394,17,0,17,79,52,44,70,58,52,20,13,7,2
S01010769,345,41,13,28,103,16,92,36,27,27,3,0,3,0
S01010770,696,50,19,31,140,69,136,113,67,93,28,13,15,0
S01010771,576,23,6,17,98,40,152,84,78,77,23,8,15,1
S01010772,482,30,6,24,100,33,101,57,69,72,12,4,8,8
S01010773,597,68,17,51,142,41,116,82,61,68,15,6,9,4
S01010774,558,45,15,30,112,32,130,58,80,46,50,21,29,5
S01010775,538,37,17,20,115,53,112,75,48,97,1,0,1,0
S01010776,412,20,5,15,100,40,51,54,60,66,18,5,13,3
S01010777,385,20,9,11,49,33,37,67,72,69,32,14,18,6
S01010778,439,17,3,14,53,26,24,43,103,92,68,47,21,13
S01010779,620,30,7,23,73,48,70,88,115,85,94,68,26,17
S01010780,415,24,2,22,87,37,17,54,97,77,22,7,15,0
S01010781,634,89,19,70,149,55,79,100,55,89,8,3,5,10
S01010782,476,37,2,35,99,27,71,76,63,62,41,13,28,0
S01010783,430,17,2,15,54,31,42,73,98,74,22,11,11,19
S01010784,621,10,2,8,76,58,42,80,142,146,58,18,40,9
S01010785,543,71,12,59,135,72,50,59,54,83,19,8,11,0
S01010786,582,40,6,34,152,78,63,85,65,85,5,3,2,9
S01010787,701,62,3,59,129,72,156,95,71,96,14,6,8,6
S01010788,512,58,7,51,104,40,98,72,75,60,5,1,4,0
S01010789,584,53,19,34,112,18,149,95,82,58,15,0,15,2
S01010790,496,54,9,45,95,29,123,72,53,63,7,3,4,0
S01010791,604,97,8,89,135,43,126,72,58,52,12,7,5,9
S01010792,508,50,3,47,78,47,24,99,106,77,19,7,12,8
S01010793,502,58,14,44,140,35,72,65,63,61,5,2,3,3
S01010794,461,61,10,51,111,39,62,87,44,46,10,1,9,1
S01010795,740,121,29,92,162,90,86,85,66,87,40,3,37,3
S01010796,652,107,20,87,158,48,123,96,55,51,7,6,1,7
S01010797,620,97,13,84,158,60,86,117,45,46,9,6,3,2
S01010798,514,72,14,58,136,31,77,68,54,70,3,1,2,3
S01010799,617,80,8,72,164,53,71,77,71,69,19,8,11,13
S01010800,577,22,9,13,95,61,35,94,139,106,21,11,10,4
S01010801,509,37,2,35,125,37,47,59,99,85,17,3,14,3
S01010802,455,56,15,41,116,45,42,70,58,50,16,1,15,2
S01010803,468,35,6,29,110,40,43,73,97,38,23,10,13,9
S01010804,444,77,10,67,107,49,39,75,32,52,11,5,6,2
S01010805,664,62,21,41,200,62,61,121,66,60,21,2,19,11
S01010806,744,49,8,41,149,65,37,98,135,139,55,36,19,17
S01010807,442,33,10,23,102,44,44,84,56,56,19,5,14,4
S01010808,463,82,14,68,124,44,21,57,75,53,6,1,5,1
S01010809,588,110,33,77,157,68,55,81,56,50,11,2,9,0
S01010810,325,37,7,30,87,15,66,60,25,25,8,3,5,2
S01010811,636,78,17,61,145,51,119,77,78,67,18,2,16,3
S01010812,399,16,14,2,71,31,125,31,76,43,6,2,4,0
S01010813,436,8,3,5,86,23,122,59,59,66,9,0,9,4
S01010814,479,39,6,33,114,32,140,44,49,50,11,2,9,0
S01010815,345,20,6,14,92,30,51,57,43,50,2,1,1,0
S01010816,429,165,62,103,114,22,70,17,18,2,8,3,5,13
S01010817,732,259,37,222,205,87,94,16,35,16,14,6,8,6
S01010818,773,264,50,214,210,55,78,35,58,32,21,10,11,20
S01010819,572,118,29,89,140,48,73,47,84,48,7,1,6,7
S01010820,412,134,34,100,103,46,51,25,33,17,2,1,1,1
S01010821,414,127,20,107,138,12,56,32,14,32,0,0,0,3
S01010822,580,211,36,175,164,30,89,17,27,18,12,8,4,12
S01010823,425,35,8,27,115,64,58,35,55,52,5,5,0,6
S01010824,710,141,28,113,247,100,66,53,57,38,4,2,2,4
S01010825,317,66,5,61,113,44,19,31,29,12,3,3,0,0
S01010826,621,127,19,108,185,82,76,40,74,26,3,2,1,8
S01010827,530,79,27,52,152,104,46,77,35,36,1,1,0,0
S01010828,1147,227,52,175,408,134,109,104,92,54,8,1,7,11
S01010829,695,155,40,115,195,86,75,41,91,42,6,6,0,4
S01010830,451,44,7,37,137,70,37,56,43,53,11,2,9,0
S01010831,575,111,38,73,196,56,53,63,47,21,17,9,8,11
S01010832,662,33,4,29,191,98,50,66,107,97,14,9,5,6
S01010833,782,223,19,204,248,60,93,78,36,38,2,2,0,4
S01010834,666,133,25,108,264,83,52,41,42,35,9,8,1,7
S01010835,451,100,23,77,167,62,39,33,22,20,3,0,3,5
S01010836,619,113,19,94,212,72,65,44,48,47,9,5,4,9
S01010837,468,29,10,19,117,102,43,53,74,35,4,4,0,11
S01010838,704,60,10,50,179,108,56,75,108,110,4,2,2,4
S01010839,562,80,28,52,157,75,49,56,64,63,6,1,5,12
S01010840,354,38,6,32,111,46,22,23,60,32,15,11,4,7
S01010841,588,77,16,61,203,94,22,54,71,43,20,15,5,4
S01010842,601,48,3,45,92,87,45,60,102,76,46,31,15,45
S01010843,446,28,8,20,106,75,29,45,88,58,11,7,4,6
S01010844,514,100,16,84,161,79,28,56,27,50,4,0,4,9
S01010845,456,38,4,34,136,50,30,72,64,50,6,3,3,10
S01010846,682,31,8,23,136,94,51,63,133,133,34,19,15,7
S01010847,586,75,24,51,182,72,29,99,56,55,10,8,2,8
S01010848,586,20,0,20,78,57,32,64,152,140,31,10,21,12
S01010849,809,22,4,18,106,70,63,94,160,197,67,53,14,30
S01010850,691,11,2,9,77,60,33,85,153,172,70,37,33,30
S01010851,716,18,2,16,97,91,22,45,196,170,59,23,36,18
S01010852,582,43,11,32,72,92,54,60,103,125,24,20,4,9
S01010853,710,50,16,34,110,112,51,78,134,151,16,11,5,8
S01010854,815,30,3,27,128,86,46,63,194,188,74,36,38,6
S01010855,441,1,0,1,34,58,44,42,128,96,21,18,3,17
S01010856,684,28,10,18,91,112,48,79,131,131,45,33,12,19
S01010857,780,70,18,52,177,132,45,94,122,94,31,20,11,15
S01010858,562,23,0,23,101,53,34,48,110,136,40,21,19,17
S01010859,585,26,4,22,72,74,30,54,141,130,51,34,17,7
S01010860,521,19,2,17,94,72,28,51,130,99,27,18,9,1
S01010861,508,26,6,20,93,74,25,37,94,111,39,21,18,9
S01010862,470,17,11,6,47,42,16,43,146,92,55,42,13,12
S01010863,566,108,36,72,189,85,36,24,56,43,8,4,4,17
S01010864,420,77,11,66,158,49,28,41,27,27,3,0,3,10
S01010865,437,120,25,95,160,44,36,12,18,22,7,6,1,18
S01010866,424,104,4,100,141,47,41,25,27,25,3,1,2,11
S01010867,442,79,17,62,133,48,63,21,54,35,2,2,0,7
S01010868,529,113,9,104,158,77,51,27,58,26,7,7,0,12
S01010869,607,117,29,88,210,78,67,44,39,36,13,8,5,3
S01010870,573,81,15,66,200,99,34,33,72,36,10,1,9,8
S01010871,674,114,13,101,187,79,84,61,68,44,15,3,12,22
S01010872,574,40,2,38,109,115,40,62,94,77,10,8,2,27
S01010873,347,13,1,12,63,51,10,40,65,60,35,16,19,10
S01010874,662,92,11,81,196,82,80,59,64,47,16,5,11,26
S01010875,448,53,9,44,128,62,36,25,53,59,17,11,6,15
S01010876,626,33,7,26,146,117,9,64,92,83,40,30,10,42
S01010877,800,84,16,68,182,156,52,60,114,90,39,23,16,23
S01010878,680,23,8,15,133,139,37,72,135,108,22,9,13,11
S01010879,687,44,19,25,146,103,60,81,97,129,20,10,10,7
S01010880,451,12,1,11,69,50,11,68,92,91,43,20,23,15
S01010881,410,19,4,15,127,61,38,45,46,62,6,3,3,6
S01010882,484,18,10,8,126,85,12,70,91,65,14,4,10,3
S01010883,742,85,33,52,211,101,44,97,97,72,28,13,15,7
S01010884,574,20,4,16,59,69,26,62,137,115,70,48,22,16
S01010885,801,33,12,21,131,101,24,71,149,132,118,60,58,42
S01010886,393,22,4,18,72,46,25,30,81,53,43,28,15,21
S01010887,597,9,0,9,93,69,41,53,112,128,73,38,35,19
S01010888,596,37,1,36,90,77,32,49,130,125,37,17,20,19
S01010889,421,22,0,22,56,47,20,28,96,100,44,32,12,8
S01010890,420,5,1,4,60,60,16,48,106,94,25,14,11,6
S01010891,262,6,0,6,18,23,16,15,58,66,35,33,2,25
S01010892,574,34,2,32,105,85,22,50,113,114,41,25,16,10
S01010893,365,17,4,13,45,42,13,32,90,77,31,23,8,18
S01010894,508,39,0,39,113,71,19,50,72,92,31,15,16,21
S01010895,325,7,2,5,45,48,13,14,69,83,42,32,10,4
S01010896,530,13,2,11,82,71,24,54,99,127,47,34,13,13
S01010897,712,23,7,16,84,78,33,79,124,205,82,36,46,4
S01010898,492,4,2,2,54,41,39,62,81,147,59,30,29,5
S01010899,519,35,15,20,102,64,30,60,108,93,16,5,11,11
S01010900,618,30,4,26,84,50,23,65,147,154,56,32,24,9
S01010901,404,4,4,0,41,25,18,48,116,110,35,27,8,7
S01010902,737,59,20,39,91,111,35,101,127,157,46,28,18,10
S01010903,621,7,3,4,66,53,35,53,139,161,84,50,34,23
S01010904,474,26,2,24,50,52,17,54,97,110,54,38,16,14
S01010905,584,46,10,36,117,86,22,57,112,86,45,38,7,13
S01010906,897,50,7,43,128,70,34,69,184,272,69,31,38,21
S01010907,500,66,20,46,141,86,47,47,39,70,3,1,2,1
S01010908,485,51,14,37,103,65,23,45,64,107,23,12,11,4
S01010909,551,69,33,36,159,66,47,49,62,79,8,5,3,12
S01010910,445,9,2,7,64,61,20,30,97,96,58,29,29,10
S01010911,348,9,4,5,60,48,11,24,79,88,20,10,10,9
S01010912,464,21,0,21,53,51,38,43,87,107,30,20,10,34
S01010913,548,34,8,26,147,79,56,49,62,86,17,13,4,18
S01010914,586,21,9,12,128,89,52,66,85,111,12,4,8,22
S01010915,665,63,24,39,135,54,46,89,129,118,15,9,6,16
S01010916,476,11,3,8,41,52,29,41,83,128,52,39,13,39
S01010917,540,32,7,25,94,76,21,78,96,97,39,27,12,7
S01010918,525,18,8,10,95,52,39,55,110,103,42,26,16,11
S01010919,609,28,5,23,87,61,27,84,123,161,38,23,15,0
S01010920,525,27,10,17,45,53,30,42,115,144,48,15,33,21
S01010921,507,10,0,10,60,53,28,60,129,130,31,24,7,6
S01010922,657,28,0,28,113,60,30,85,128,169,33,19,14,11
S01010923,698,21,2,19,106,100,39,66,151,168,45,21,24,2
S01010924,471,6,5,1,70,39,27,64,105,129,31,15,16,0
S01010925,662,12,0,12,102,82,45,50,131,181,46,14,32,13
S01010926,629,4,0,4,69,91,36,85,127,180,24,15,9,13
S01010927,470,11,5,6,91,39,32,40,109,107,35,23,12,6
S01010928,631,9,4,5,73,39,59,64,188,155,41,24,17,3
S01010929,566,6,2,4,42,53,20,76,142,180,35,18,17,12
S01010930,759,182,37,145,223,73,157,35,34,38,14,2,12,3
S01010931,320,66,25,41,70,21,71,26,32,26,4,0,4,4
S01010932,442,22,6,16,100,46,59,39,77,80,10,8,2,9
S01010933,677,187,33,154,212,56,92,33,45,46,4,0,4,2
S01010934,862,189,41,148,303,93,99,45,78,35,14,6,8,6
S01010935,409,85,7,78,100,55,54,31,44,36,2,2,0,2
S01010936,490,59,6,53,122,105,52,38,59,38,11,4,7,6
S01010937,618,66,24,42,169,112,66,74,55,68,6,0,6,2
S01010938,665,24,8,16,96,69,54,95,135,157,31,3,28,4
S01010939,441,43,2,41,105,68,37,73,55,47,8,4,4,5
S01010940,519,115,37,78,150,85,49,43,53,22,0,0,0,2
S01010941,691,144,34,110,204,108,70,85,38,30,5,0,5,7
S01010942,481,110,24,86,170,73,44,33,40,11,0,0,0,0
S01010943,546,35,6,29,141,64,53,61,77,68,39,14,25,8
S01010944,458,23,0,23,71,70,25,47,98,87,29,5,24,8
S01010945,442,24,1,23,104,53,29,47,67,104,10,1,9,4
S01010946,637,23,1,22,140,80,87,84,82,108,26,16,10,7
S01010947,426,15,3,12,82,68,32,57,105,50,12,3,9,5
S01010948,543,36,5,31,121,75,51,42,82,112,15,7,8,9
S01010949,763,150,28,122,239,112,93,56,73,37,0,0,0,3
S01010950,629,61,8,53,174,83,58,50,92,97,11,3,8,3
S01010951,499,28,4,24,118,83,30,66,63,95,5,2,3,11
S01010952,482,72,12,60,101,77,41,71,65,38,14,14,0,3
S01010953,477,43,16,27,96,76,39,54,92,74,1,0,1,2
S01010954,459,68,15,53,86,91,60,58,35,53,2,1,1,6
S01010955,931,169,52,117,355,137,80,55,64,42,16,0,16,13
S01010956,589,126,9,117,160,32,114,34,55,45,14,13,1,9
S01010957,450,98,20,78,117,55,69,57,41,8,4,4,0,1
S01010958,316,52,6,46,99,36,34,23,38,30,3,0,3,1
S01010959,468,72,12,60,145,64,43,29,62,35,16,5,11,2
S01010960,944,103,21,82,202,84,131,84,132,139,44,10,34,25
S01010961,425,41,2,39,95,68,31,41,60,69,18,6,12,2
S01010962,353,32,3,29,79,30,37,27,54,89,4,0,4,1
S01010963,789,142,35,107,169,109,114,71,81,86,15,4,11,2
S01010964,383,53,3,50,64,54,64,32,39,70,7,0,7,0
S01010965,449,20,12,8,63,46,29,56,60,126,35,19,16,14
S01010966,545,32,8,24,109,59,59,85,75,104,17,6,11,5
S01010967,577,26,4,22,82,71,55,79,104,136,20,13,7,4
S01010968,529,33,11,22,129,80,56,48,63,95,19,13,6,6
S01010969,399,51,9,42,102,63,61,32,42,36,5,1,4,7
S01010970,773,94,17,77,194,81,88,95,75,121,14,5,9,11
S01010971,895,107,28,79,222,139,98,97,111,88,29,12,17,4
S01010972,731,36,12,24,108,89,72,64,165,142,41,14,27,14
S01010973,367,19,2,17,63,56,45,42,57,73,9,1,8,3
S01010974,528,15,3,12,76,71,48,64,102,133,14,7,7,5
S01010975,395,11,2,9,54,49,49,66,65,69,27,12,15,5
S01010976,406,37,14,23,95,60,32,45,55,71,7,4,3,4
S01010977,571,61,11,50,115,82,58,66,93,81,8,5,3,7
S01010978,598,39,16,23,100,87,64,69,120,83,33,18,15,3
S01010979,684,45,6,39,119,79,64,76,130,133,27,6,21,11
S01010980,575,61,7,54,112,87,74,32,119,78,10,8,2,2
S01010981,551,44,11,33,82,77,57,68,87,96,27,21,6,13
S01010982,848,205,34,171,239,60,125,89,59,56,14,0,14,1
S01010983,580,88,12,76,131,70,77,60,61,77,14,10,4,2
S01010984,440,56,11,45,123,61,48,52,32,64,4,2,2,0
S01010985,508,33,3,30,102,70,44,87,76,86,10,6,4,0
S01010986,493,91,15,76,148,100,74,42,15,23,0,0,0,0
S01010987,612,132,37,95,234,92,87,37,19,11,0,0,0,0
S01010988,596,146,45,101,210,75,68,23,43,26,1,1,0,4
S01010989,905,139,13,126,340,136,107,91,59,27,4,2,2,2
S01010990,642,59,6,53,117,95,81,58,116,108,4,3,1,4
S01010991,441,69,11,58,122,51,59,32,52,44,6,0,6,6
S01010992,571,159,28,131,175,40,80,62,33,20,0,0,0,2
S01010993,526,67,12,55,177,85,56,37,39,53,9,1,8,3
S01010994,840,252,43,209,308,77,67,48,54,26,6,1,5,2
S01010995,608,67,13,54,197,88,75,69,69,39,4,4,0,0
S01010996,462,99,20,79,167,53,62,31,29,17,1,0,1,3
S01010997,439,140,29,111,144,41,65,23,5,17,0,0,0,4
S01010998,474,148,22,126,157,35,90,16,12,6,8,0,8,2
S01010999,613,170,46,124,194,60,59,53,41,27,4,4,0,5
S01011000,687,104,23,81,189,60,137,58,61,56,9,0,9,13
S01011001,493,18,0,18,126,62,66,50,67,89,11,9,2,4
S01011002,536,14,0,14,83,81,38,90,114,110,2,2,0,4
S01011003,564,17,8,9,84,84,65,110,94,88,6,1,5,16
S01011004,530,103,21,82,149,64,60,41,50,45,12,0,12,6
S01011005,511,17,0,17,101,67,39,81,91,95,16,12,4,4
S01011006,848,87,28,59,219,105,78,91,86,119,45,33,12,18
S01011007,539,12,2,10,64,54,46,91,79,170,15,10,5,8
S01011008,600,38,8,30,109,58,60,98,115,102,13,4,9,7
S01011009,445,17,12,5,81,58,27,78,87,81,14,6,8,2
S01011010,442,36,1,35,78,55,21,25,97,79,41,24,17,10
S01011011,604,27,7,20,87,109,29,60,140,91,50,30,20,11
S01011012,625,32,0,32,61,59,30,91,137,154,54,17,37,7
S01011013,599,24,4,20,92,67,52,84,111,158,9,5,4,2
S01011014,701,64,14,50,155,137,45,83,121,78,12,3,9,6
S01011015,369,15,3,12,93,40,54,32,66,54,15,2,13,0
S01011016,819,108,21,87,249,97,144,83,67,61,5,2,3,5
S01011017,642,145,25,120,147,59,146,63,37,29,7,0,7,9
S01011018,686,47,2,45,168,75,85,83,106,106,11,1,10,5
S01011019,884,130,30,100,228,74,126,78,106,110,27,8,19,5
S01011020,390,90,7,83,108,27,48,39,32,35,11,0,11,0
S01011021,693,26,8,18,124,63,70,115,138,114,43,27,16,0
S01011022,492,18,0,18,33,51,48,83,96,123,29,15,14,11
S01011023,686,52,12,40,107,82,96,86,111,106,41,28,13,5
S01011024,688,16,5,11,92,88,60,73,136,156,59,29,30,8
S01011025,609,18,2,16,83,86,36,86,107,151,29,9,20,13
S01011026,474,7,0,7,53,73,55,59,117,82,22,5,17,6
S01011027,779,22,5,17,63,99,59,72,182,198,76,38,38,8
S01011028,806,21,5,16,106,78,50,82,175,207,77,38,39,10
S01011029,510,28,5,23,81,56,51,54,91,115,29,21,8,5
S01011030,853,69,17,52,225,154,82,94,100,121,2,0,2,6
S01011031,566,30,5,25,64,58,38,73,125,132,27,11,16,19
S01011032,628,28,6,22,142,79,76,41,114,113,29,13,16,6
S01011033,537,61,7,54,124,77,59,59,68,82,2,1,1,5
S01011034,482,37,11,26,99,63,60,67,87,59,10,7,3,0
S01011035,601,38,18,20,94,61,68,63,118,114,42,22,20,3
S01011036,545,58,3,55,137,70,64,43,82,74,12,1,11,5
S01011037,840,33,10,23,149,89,94,117,145,148,63,44,19,2
S01011038,771,15,0,15,100,63,65,123,160,166,62,24,38,17
S01011039,631,39,1,38,131,95,75,73,74,114,27,18,9,3
S01011040,653,36,12,24,98,73,50,80,124,153,39,17,22,0
S01011041,673,37,1,36,100,62,66,55,155,119,67,25,42,12
S01011042,721,85,24,61,193,83,78,89,87,74,19,6,13,13
S01011043,575,53,12,41,105,62,35,75,69,143,26,10,16,7
S01011044,578,50,13,37,99,78,55,54,129,93,13,8,5,7
S01011045,623,55,12,43,90,78,125,91,105,57,16,5,11,6
S01011046,690,67,38,29,94,66,172,121,90,69,7,3,4,4
S01011047,759,82,39,43,171,28,123,163,100,90,2,2,0,0
S01011048,728,25,15,10,106,50,84,140,139,161,19,3,16,4
S01011049,498,29,7,22,63,23,42,83,149,99,4,0,4,6
S01011050,632,59,18,41,162,28,83,97,128,60,12,7,5,3
S01011051,713,65,19,46,154,42,127,105,110,105,5,2,3,0
S01011052,582,63,25,38,109,46,76,87,118,74,6,0,6,3
S01011053,524,15,2,13,87,45,34,92,110,112,23,5,18,6
S01011054,417,62,24,38,80,36,47,59,93,36,2,2,0,2
S01011055,475,41,11,30,78,36,81,76,94,64,5,0,5,0
S01011056,571,74,20,54,80,16,207,55,61,71,7,3,4,0
S01011057,455,15,8,7,74,35,117,66,49,99,0,0,0,0
S01011058,539,41,16,25,143,28,155,42,62,65,2,0,2,1
S01011059,531,50,22,28,112,41,120,63,76,56,13,0,13,0
S01011060,597,82,13,69,124,38,80,57,106,106,3,2,1,1
S01011061,678,24,5,19,72,55,61,110,159,169,25,11,14,3
S01011062,736,32,16,16,122,49,127,102,128,163,7,3,4,6
S01011063,766,49,7,42,109,62,63,146,161,143,33,17,16,0
S01011064,754,67,25,42,96,58,85,147,125,152,20,6,14,4
S01011065,567,65,23,42,97,37,121,77,107,51,10,2,8,2
S01011066,364,43,12,31,79,40,75,44,40,37,3,0,3,3
S01011067,395,39,9,30,40,31,72,82,61,53,16,5,11,1
S01011068,425,18,6,12,76,28,68,49,107,71,4,1,3,4
S01011069,441,33,15,18,104,18,66,67,75,63,12,3,9,3
S01011070,493,32,12,20,99,44,81,99,71,66,1,1,0,0
S01011071,624,46,15,31,162,36,112,93,96,63,8,2,6,8
S01011072,839,43,22,21,164,47,134,173,110,127,27,3,24,14
S01011073,544,40,15,25,108,46,66,107,93,80,3,0,3,1
S01011074,478,33,15,18,124,23,64,79,97,47,7,6,1,4
S01011075,562,9,8,1,49,38,64,102,112,164,19,3,16,5
S01011076,564,27,13,14,89,9,50,123,124,112,21,8,13,9
S01011077,613,8,0,8,75,29,23,93,153,187,27,11,16,18
S01011078,829,78,31,47,146,56,108,169,125,125,13,6,7,9
S01011079,822,38,26,12,160,38,79,225,100,168,10,1,9,4
S01011080,711,31,13,18,124,61,52,181,127,101,24,17,7,10
S01011081,664,37,12,25,93,53,62,139,140,122,14,9,5,4
S01011082,339,14,6,8,61,16,33,75,63,64,13,10,3,0
S01011083,585,37,19,18,110,57,68,104,110,86,10,0,10,3
S01011084,579,51,14,37,184,55,100,70,67,44,7,3,4,1
S01011085,687,77,26,51,238,75,71,66,82,72,2,2,0,4
S01011086,475,56,22,34,113,34,46,93,74,59,0,0,0,0
S01011087,443,21,10,11,90,43,46,72,87,73,8,8,0,3
S01011088,763,60,23,37,206,98,79,79,108,116,10,3,7,7
S01011089,474,24,6,18,79,35,39,65,93,100,33,7,26,6
S01011090,528,67,20,47,111,39,118,80,61,48,2,0,2,2
S01011091,510,75,26,49,108,36,101,81,49,57,3,0,3,0
S01011092,438,19,6,13,81,46,35,43,61,96,37,17,20,20
S01011093,501,53,20,33,135,29,110,76,61,31,1,0,1,5
S01011094,422,57,19,38,139,22,78,53,43,27,0,0,0,3
S01011095,644,95,38,57,192,46,134,74,45,42,8,0,8,8
S01011096,484,49,15,34,171,42,55,54,60,42,7,0,7,4
S01011097,604,86,25,61,144,41,103,84,79,58,8,1,7,1
S01011098,593,30,3,27,176,67,54,74,81,102,1,1,0,8
S01011099,730,21,15,6,123,53,52,104,173,154,38,11,27,12
S01011100,320,21,0,21,66,49,35,45,41,55,1,1,0,7
S01011101,535,14,9,5,69,29,25,98,121,163,12,1,11,4
S01011102,528,11,2,9,86,38,20,61,154,129,27,18,9,2
S01011103,432,30,11,19,72,27,20,71,87,101,17,8,9,7
S01011104,417,48,8,40,134,28,40,49,49,40,17,9,8,12
S01011105,607,36,15,21,115,55,47,78,108,144,16,10,6,8
S01011106,942,28,7,21,391,116,21,69,143,139,27,10,17,8
S01011107,917,44,17,27,299,59,56,133,147,135,23,6,17,21
S01011108,470,37,9,28,129,28,44,77,67,77,3,0,3,8
S01011109,613,36,7,29,95,62,61,116,123,112,8,4,4,0
S01011110,620,12,5,7,118,63,29,91,146,133,23,14,9,5
S01011111,751,8,2,6,119,60,49,104,171,194,36,34,2,10
S01011112,822,50,20,30,231,101,52,185,97,97,5,1,4,4
S01011113,673,41,12,29,136,46,71,117,127,120,8,3,5,7
S01011114,591,32,4,28,123,62,62,141,66,83,14,5,9,8
S01011115,749,15,7,8,97,61,72,164,130,173,26,5,21,11
S01011116,540,23,3,20,144,68,23,95,82,89,1,0,1,15
S01011117,539,96,11,85,160,33,58,66,67,39,6,5,1,14
S01011118,657,142,40,102,196,68,60,76,64,39,5,1,4,7
S01011119,690,150,50,100,234,70,48,42,73,60,4,4,0,9
S01011120,426,93,42,51,167,40,36,40,26,24,0,0,0,0
S01011121,411,40,4,36,64,51,26,59,78,79,7,4,3,7
S01011122,521,28,6,22,142,56,52,81,85,74,1,1,0,2
S01011123,870,46,22,24,151,73,43,154,149,234,17,4,13,3
S01011124,558,44,23,21,154,47,51,86,69,98,5,3,2,4
S01011125,450,12,2,10,63,32,31,85,107,96,16,10,6,8
S01011126,433,20,6,14,149,66,35,50,48,51,14,0,14,0
S01011127,528,7,4,3,310,138,19,9,21,6,14,14,0,4
S01011128,593,43,7,36,141,83,39,80,101,89,13,5,8,4
S01011129,846,297,243,54,243,43,68,83,64,48,0,0,0,0
S01011130,451,30,9,21,112,51,31,40,76,84,17,8,9,10
S01011131,515,59,36,23,169,64,23,56,82,44,8,2,6,10
S01011132,718,125,52,73,223,74,69,107,73,37,7,5,2,3
S01011133,336,34,16,18,56,35,31,60,65,50,0,0,0,5
S01011134,536,37,16,21,185,70,67,36,88,42,7,2,5,4
S01011135,574,16,1,15,111,59,52,107,75,127,14,2,12,13
S01011136,486,56,28,28,108,65,23,87,74,61,8,3,5,4
S01011137,447,28,22,6,108,55,46,64,64,55,20,4,16,7
S01011138,554,10,7,3,172,63,48,73,85,89,11,2,9,3
S01011139,724,26,14,12,370,150,52,41,46,28,8,3,5,3
S01011140,473,26,2,24,131,36,49,55,59,103,4,2,2,10
S01011141,500,12,6,6,143,30,34,71,94,102,12,3,9,2
S01011142,684,79,23,56,276,55,76,78,64,48,8,2,6,0
S01011143,737,92,47,45,247,39,63,116,105,64,3,0,3,8
S01011144,623,86,32,54,221,62,51,72,59,62,0,0,0,10
S01011145,514,74,37,37,218,24,49,56,42,40,6,4,2,5
S01011146,639,57,24,33,162,70,67,76,113,63,19,0,19,12
S01011147,815,55,12,43,254,108,76,104,131,80,5,0,5,2
S01011148,609,76,30,46,156,38,133,68,65,61,7,2,5,5
S01011149,602,62,16,46,272,125,72,25,19,15,6,0,6,6
S01011150,470,87,68,19,190,38,17,52,38,44,4,2,2,0
S01011151,536,40,26,14,242,109,35,29,32,40,8,1,7,1
S01011152,507,92,32,60,162,52,60,44,55,30,10,6,4,2
S01011153,631,55,9,46,162,53,83,80,93,75,24,11,13,6
S01011154,386,20,8,12,89,49,33,45,58,63,24,9,15,5
S01011155,453,64,13,51,113,31,60,52,53,46,29,5,24,5
S01011156,447,24,1,23,155,57,40,67,41,52,6,5,1,5
S01011157,423,33,12,21,135,64,41,60,63,22,3,0,3,2
S01011158,336,97,24,73,99,31,43,10,30,26,0,0,0,0
S01011159,369,20,5,15,75,58,18,59,60,66,11,1,10,2
S01011160,752,49,15,34,175,99,79,96,131,98,23,18,5,2
S01011161,514,20,7,13,78,33,42,88,111,119,15,0,15,8
S01011162,432,18,3,15,70,59,28,34,107,80,26,7,19,10
S01011163,627,12,9,3,88,59,51,106,152,133,23,2,21,3
S01011164,628,50,16,34,199,77,41,76,85,78,22,0,22,0
S01011165,582,16,1,15,98,52,55,82,127,119,24,11,13,9
S01011166,361,67,12,55,83,57,38,41,37,27,3,0,3,8
S01011167,488,116,38,78,120,30,99,36,46,39,2,0,2,0
S01011168,658,56,30,26,177,44,163,86,60,57,4,0,4,11
S01011169,901,122,49,73,326,105,49,107,91,76,21,4,17,4
S01011170,722,124,46,78,223,60,106,83,70,30,22,6,16,4
S01011171,582,58,18,40,129,27,146,61,87,61,10,1,9,3
S01011172,503,27,5,22,127,37,125,54,70,58,5,0,5,0
S01011173,332,29,5,24,66,17,121,25,46,25,1,0,1,2
S01011174,263,29,7,22,54,17,71,23,26,40,3,1,2,0
S01011175,377,26,4,22,58,31,70,59,65,59,9,5,4,0
S01011176,312,25,4,21,77,19,95,39,5,45,4,3,1,3
S01011177,576,47,12,35,137,34,126,69,88,67,6,3,3,2
S01011178,429,46,16,30,122,42,56,51,48,43,19,4,15,2
S01011179,466,19,4,15,64,38,41,75,73,128,15,11,4,13
S01011180,532,22,0,22,55,27,40,67,93,165,53,23,30,10
S01011181,358,42,8,34,72,37,119,22,37,25,1,1,0,3
S01011182,308,37,10,27,91,26,64,35,28,26,1,1,0,0
S01011183,453,53,18,35,86,37,65,65,69,46,29,8,21,3
S01011184,685,103,30,73,274,53,87,76,57,30,3,0,3,2
S01011185,496,40,7,33,154,47,51,70,66,54,11,6,5,3
S01011186,648,68,8,60,130,64,50,72,103,116,37,16,21,8
S01011187,525,45,17,28,167,55,42,97,62,49,2,0,2,6
S01011188,763,53,12,41,114,98,64,120,150,100,56,15,41,8
S01011189,632,60,20,40,152,104,65,103,72,55,16,3,13,5
S01011190,497,6,1,5,84,48,72,75,109,71,29,17,12,3
S01011191,436,25,9,16,61,34,23,75,91,97,24,4,20,6
S01011192,618,13,5,8,102,58,35,95,146,111,49,15,34,9
S01011193,645,17,7,10,73,76,22,78,159,158,46,25,21,16
S01011194,652,19,5,14,95,60,55,83,125,147,47,11,36,21
S01011195,702,20,4,16,112,84,44,85,147,127,58,15,43,25
S01011196,777,17,6,11,108,84,45,93,183,158,63,35,28,26
S01011197,764,46,9,37,106,92,62,89,124,157,68,32,36,20
S01011198,550,19,0,19,83,45,41,82,106,135,37,14,23,2
S01011199,682,22,3,19,137,88,52,73,169,93,37,11,26,11
S01011200,619,39,9,30,110,57,56,83,130,98,34,13,21,12
S01011201,472,36,8,28,121,72,40,66,56,67,10,8,2,4
S01011202,701,27,6,21,130,102,40,143,117,102,28,7,21,12
S01011203,650,59,9,50,108,78,55,104,127,93,16,5,11,10
S01011204,447,73,3,70,134,60,58,38,59,21,4,3,1,0
S01011205,709,99,21,78,195,98,77,102,77,44,11,0,11,6
S01011206,686,71,27,44,230,69,74,110,78,43,8,0,8,3
S01011207,629,86,18,68,141,70,42,90,112,60,21,15,6,7
S01011208,820,113,48,65,228,99,76,103,79,100,17,5,12,5
S01011209,522,42,5,37,78,85,29,64,93,80,43,19,24,8
S01011210,649,143,42,101,197,46,113,72,54,17,4,0,4,3
S01011211,633,108,27,81,186,83,46,73,65,47,13,5,8,12
S01011212,469,7,3,4,62,20,55,79,106,105,33,21,12,2
S01011213,905,45,8,37,108,67,61,153,179,187,84,39,45,21
S01011214,693,9,2,7,95,63,44,87,158,163,58,31,27,16
S01011215,500,3,0,3,77,39,32,48,121,93,78,34,44,9
S01011216,406,10,0,10,56,41,37,35,94,94,28,6,22,11
S01011217,662,17,4,13,96,66,51,68,138,110,108,43,65,8
S01011218,607,12,0,12,72,49,23,89,122,116,102,36,66,22
S01011219,644,23,0,23,99,59,56,64,122,140,75,24,51,6
S01011220,710,27,9,18,100,58,62,85,149,132,89,42,47,8
S01011221,784,25,5,20,106,101,40,135,159,165,39,20,19,14
S01011222,507,14,9,5,100,50,43,49,109,113,25,11,14,4
S01011223,639,35,4,31,155,110,46,88,86,88,28,11,17,3
S01011224,494,24,6,18,78,55,60,51,97,91,24,15,9,14
S01011225,561,35,10,25,95,53,34,59,116,103,57,26,31,9
S01011226,643,78,15,63,173,64,60,113,70,57,28,8,20,0
S01011227,572,44,4,40,147,60,37,76,77,76,50,24,26,5
S01011228,560,20,5,15,137,62,46,76,112,61,35,20,15,11
S01011229,378,15,5,10,78,29,33,58,61,54,39,13,26,11
S01011230,726,9,1,8,82,38,40,80,181,173,118,63,55,5
S01011231,455,15,0,15,70,26,24,61,102,112,45,29,16,0
S01011232,734,53,5,48,178,57,92,58,127,108,46,24,22,15
S01011233,302,25,0,25,61,41,13,36,44,40,37,19,18,5
S01011234,905,33,16,17,102,73,43,102,200,191,123,51,72,38
S01011235,315,14,1,13,39,31,28,28,70,64,28,18,10,13
S01011236,411,20,6,14,63,36,29,38,115,77,28,21,7,5
S01011237,639,23,0,23,121,55,38,105,110,109,60,27,33,18
S01011238,557,12,0,12,67,71,34,31,119,109,102,52,50,12
S01011239,528,18,6,12,84,59,51,55,96,78,69,19,50,18
S01011240,533,26,7,19,99,59,37,55,90,70,91,33,58,6
S01011241,752,71,16,55,177,62,78,102,102,97,54,28,26,9
S01011242,564,47,1,46,119,70,57,63,88,78,32,17,15,10
S01011243,679,24,4,20,110,57,46,62,121,117,126,52,74,16
S01011244,564,24,6,18,81,59,14,50,123,108,89,31,58,16
S01011245,662,28,11,17,77,52,33,99,147,142,76,33,43,8
S01011246,660,61,15,46,180,71,101,72,83,52,37,5,32,3
S01011247,534,102,23,79,173,62,36,59,41,45,8,1,7,8
S01011248,609,64,18,46,155,48,44,73,103,103,10,2,8,9
S01011249,561,68,14,54,127,97,46,106,36,66,8,3,5,7
S01011250,965,55,15,40,141,127,55,77,241,159,93,36,57,17
S01011251,726,18,6,12,146,44,55,96,171,146,34,18,16,16
S01011252,719,13,4,9,62,70,27,62,217,190,68,28,40,10
S01011253,714,16,2,14,61,68,24,95,218,178,45,27,18,9
S01011254,827,127,33,94,221,119,69,136,66,71,5,0,5,13
S01011255,722,148,27,121,246,71,57,129,49,20,0,0,0,2
S01011256,464,43,25,18,118,45,69,67,61,56,5,3,2,0
S01011257,255,38,10,28,108,18,16,27,23,21,0,0,0,4
S01011258,432,87,22,65,139,23,40,58,36,32,10,2,8,7
S01011259,549,35,11,24,133,63,61,40,91,81,32,19,13,13
S01011260,514,62,14,48,151,48,50,87,56,38,17,5,12,5
S01011261,671,18,7,11,75,53,67,104,166,116,52,27,25,20
S01011262,404,21,4,17,65,37,46,49,105,59,17,10,7,5
S01011263,953,77,17,60,220,122,48,137,181,117,45,19,26,6
S01011264,600,17,12,5,59,73,34,79,144,137,46,10,36,11
S01011265,949,25,8,17,85,116,78,70,228,185,123,51,72,39
S01011266,687,29,6,23,110,71,47,130,149,113,33,14,19,5
S01011267,438,45,0,45,121,47,33,66,57,52,14,1,13,3
S01011268,265,31,8,23,57,19,17,29,40,59,13,8,5,0
S01011269,372,23,9,14,56,41,24,51,47,90,30,7,23,10
S01011270,560,20,5,15,65,63,37,69,130,107,45,11,34,24
S01011271,578,30,3,27,87,52,38,81,110,122,43,9,34,15
S01011272,574,30,8,22,87,73,36,77,88,109,67,22,45,7
S01011273,794,10,2,8,90,97,45,95,158,165,114,71,43,20
S01011274,784,30,5,25,95,89,41,127,192,116,76,36,40,18
S01011275,632,11,6,5,85,38,35,75,155,117,91,39,52,25
S01011276,821,50,13,37,86,74,49,122,175,155,105,47,58,5
S01011277,540,47,9,38,155,79,47,68,74,54,6,1,5,10
S01011278,442,51,13,38,103,63,32,70,58,53,10,10,0,2
S01011279,499,44,15,29,159,78,35,61,63,42,14,14,0,3
S01011280,463,62,28,34,135,52,45,71,51,44,3,0,3,0
S01011281,575,65,20,45,229,67,54,77,56,19,0,0,0,8
S01011282,835,88,20,68,271,110,77,114,96,57,5,0,5,17
S01011283,704,102,14,88,199,84,58,122,63,69,3,1,2,4
S01011284,596,95,22,73,241,53,60,76,28,38,0,0,0,5
S01011285,641,16,0,16,79,88,39,85,178,99,55,8,47,2
S01011286,641,8,0,8,95,106,43,86,117,99,49,23,26,38
S01011287,707,24,10,14,120,75,42,82,174,130,39,19,20,21
S01011288,621,10,2,8,103,65,28,95,162,90,62,30,32,6
S01011289,778,19,4,15,127,84,55,113,175,137,53,19,34,15
S01011290,847,53,13,40,134,87,110,98,152,121,80,41,39,12
S01011291,649,36,8,28,107,83,36,83,118,123,46,6,40,17
S01011292,574,13,5,8,63,39,52,61,163,92,81,18,63,10
S01011293,586,12,2,10,107,47,32,111,98,120,33,18,15,26
S01011294,576,18,1,17,103,43,41,58,90,131,79,32,47,13
S01011295,701,70,4,66,211,93,72,84,61,61,37,13,24,12
S01011296,417,21,4,17,87,46,59,44,51,70,28,9,19,11
S01011297,726,19,3,16,110,84,60,91,161,143,52,19,33,6
S01011298,573,20,7,13,69,73,50,65,115,110,63,26,37,8
S01011299,385,57,17,40,90,17,124,39,22,32,4,4,0,0
S01011300,772,31,4,27,75,74,58,76,165,206,84,22,62,3
S01011301,558,69,23,46,151,75,52,68,56,69,16,5,11,2
S01011302,579,26,8,18,110,66,46,56,92,113,62,25,37,8
S01011303,818,96,20,76,219,105,81,133,106,65,13,3,10,0
S01011304,601,39,21,18,63,49,37,85,110,150,54,27,27,14
S01011305,725,61,4,57,110,66,80,116,120,111,54,11,43,7
S01011306,453,26,6,20,70,17,19,92,83,84,55,21,34,7
S01011307,376,30,13,17,101,53,98,35,37,21,1,1,0,0
S01011308,336,63,24,39,82,29,88,16,20,29,9,6,3,0
S01011309,494,125,38,87,199,39,56,33,18,20,3,1,2,1
S01011310,527,43,6,37,171,64,68,56,63,29,16,4,12,17
S01011311,446,73,14,59,157,37,83,33,39,13,3,0,3,8
S01011312,760,186,30,156,262,62,100,81,29,25,6,2,4,9
S01011313,562,79,16,63,166,77,79,59,52,33,13,3,10,4
S01011314,888,213,49,164,259,76,99,82,59,54,24,10,14,22
S01011315,328,43,10,33,66,19,35,54,38,46,18,2,16,9
S01011316,615,38,7,31,93,67,69,93,82,104,57,30,27,12
S01011317,445,86,26,60,137,46,79,23,24,44,5,0,5,1
S01011318,529,106,10,96,159,50,80,23,67,32,7,3,4,5
S01011319,556,133,29,104,202,46,52,31,65,24,3,2,1,0
S01011320,339,31,1,30,99,37,30,40,55,29,10,5,5,8
S01011321,513,49,6,43,155,72,42,68,77,40,4,1,3,6
S01011322,545,76,14,62,165,92,49,54,55,38,13,2,11,3
S01011323,797,79,8,71,154,88,65,116,156,85,43,8,35,11
S01011324,350,38,4,34,95,49,41,39,45,34,7,6,1,2
S01011325,547,36,6,30,99,61,73,71,87,81,26,8,18,13
S01011326,487,39,9,30,96,58,55,44,105,62,25,16,9,3
S01011327,407,24,7,17,86,51,63,39,70,59,15,5,10,0
S01011328,475,38,2,36,84,44,108,58,60,61,18,8,10,4
S01011329,589,61,6,55,158,64,55,63,82,64,14,1,13,28
S01011330,551,124,43,81,155,77,50,45,37,53,6,3,3,4
S01011331,487,126,39,87,154,44,54,34,44,25,6,3,3,0
S01011332,581,140,18,122,192,59,57,55,51,20,1,0,1,6
S01011333,405,106,10,96,160,19,59,22,22,14,3,0,3,0
S01011334,529,125,28,97,97,40,145,29,44,33,16,1,15,0
S01011335,611,163,40,123,212,56,78,31,26,34,6,0,6,5
S01011336,498,71,23,48,96,64,40,53,96,56,21,12,9,1
S01011337,504,133,27,106,169,44,88,12,27,24,3,0,3,4
S01011338,577,39,5,34,115,50,38,71,91,132,30,8,22,11
S01011339,472,17,2,15,58,40,32,81,135,68,40,33,7,1
S01011340,546,24,15,9,71,71,47,48,131,103,37,11,26,14
S01011341,612,53,17,36,120,69,41,84,97,89,34,22,12,25
S01011342,562,54,24,30,129,74,50,78,86,56,18,8,10,17
S01011343,641,19,2,17,96,59,54,94,132,114,67,38,29,6
S01011344,729,21,0,21,102,63,39,86,150,167,87,36,51,14
S01011345,696,12,4,8,88,41,46,65,203,160,70,19,51,11
S01011346,516,22,10,12,65,83,52,61,89,107,25,15,10,12
S01011347,788,64,19,45,139,90,77,108,158,100,47,19,28,5
S01011348,756,43,15,28,143,109,35,101,112,117,87,23,64,9
S01011349,836,97,28,69,214,122,105,109,74,100,12,0,12,3
S01011350,506,100,31,69,168,69,62,28,56,20,2,0,2,1
S01011351,569,22,9,13,74,72,38,81,131,106,41,14,27,4
S01011352,497,39,6,33,117,55,52,47,92,65,24,11,13,6
S01011353,483,39,12,27,68,63,41,67,73,99,22,13,9,11
S01011354,561,91,11,80,122,68,76,59,58,69,15,1,14,3
S01011355,696,57,27,30,140,88,79,93,108,107,18,7,11,6
S01011356,782,119,18,101,209,40,226,78,47,37,23,9,14,3
S01011357,646,61,13,48,172,96,68,89,57,88,11,4,7,4
S01011358,524,97,21,76,176,54,32,52,47,54,6,6,0,6
S01011359,525,29,8,21,89,66,35,69,76,112,41,16,25,8
S01011360,703,13,0,13,75,60,32,65,175,190,67,30,37,26
S01011361,467,13,1,12,28,32,22,38,109,136,83,45,38,6
S01011362,482,57,21,36,138,65,84,56,46,36,0,0,0,0
S01011363,683,61,24,37,176,80,84,60,87,82,41,24,17,12
S01011364,531,41,8,33,145,88,38,46,63,86,20,5,15,4
S01011365,603,66,32,34,241,75,46,67,36,70,2,0,2,0
S01011366,305,23,0,23,37,57,16,41,48,69,13,9,4,1
S01011367,660,33,0,33,127,71,46,80,149,132,18,10,8,4
S01011368,821,115,26,89,322,102,85,73,38,61,15,4,11,10
S01011369,627,18,0,18,128,62,45,99,114,104,47,15,32,10
S01011370,716,93,26,67,242,94,39,88,80,75,4,3,1,1
S01011371,771,28,3,25,147,95,41,83,135,152,81,27,54,9
S01011372,529,20,7,13,51,47,14,60,115,111,84,33,51,27
S01011373,571,21,5,16,82,61,51,34,127,107,54,15,39,34
S01011374,653,71,20,51,177,144,40,68,55,67,25,14,11,6
S01011375,523,70,28,42,125,74,40,56,60,66,27,1,26,5
S01011376,315,14,2,12,61,39,18,32,69,56,17,7,10,9
S01011377,469,124,22,102,160,63,58,21,17,18,4,4,0,4
S01011378,524,64,16,48,161,83,38,51,58,57,9,0,9,3
S01011379,777,161,27,134,302,99,61,62,37,50,4,0,4,1
S01011380,517,58,14,44,99,113,36,45,52,83,24,16,8,7
S01011381,492,49,14,35,145,86,46,40,46,57,15,3,12,8
S01011382,480,36,13,23,93,35,37,43,91,111,26,19,7,8
S01011383,549,9,0,9,81,66,12,45,129,137,63,35,28,7
S01011384,664,9,0,9,51,36,32,66,163,178,127,51,76,2
S01011385,780,13,3,10,85,65,52,79,155,231,92,37,55,8
S01011386,535,7,3,4,36,31,29,70,142,97,116,57,59,7
S01011387,680,31,7,24,68,50,28,83,163,178,76,34,42,3
S01011388,1022,120,50,70,316,114,80,131,130,103,20,13,7,8
S01011389,620,30,7,23,119,99,43,53,104,100,44,30,14,28
S01011390,636,30,18,12,80,74,28,92,109,186,29,10,19,8
S01011391,555,22,15,7,66,47,48,63,145,128,28,9,19,8
S01011392,582,17,9,8,66,50,40,92,110,137,62,13,49,8
S01011393,615,31,14,17,128,91,63,69,98,107,22,6,16,6
S01011394,571,150,44,106,173,70,43,61,24,40,7,3,4,3
S01011395,585,25,3,22,116,82,50,60,101,117,28,16,12,6
S01011396,561,38,21,17,132,83,46,33,89,95,37,25,12,8
S01011397,584,23,10,13,139,66,44,66,107,88,36,21,15,15
S01011398,658,16,0,16,103,63,46,77,101,162,86,35,51,4
S01011399,414,14,1,13,50,62,26,41,88,85,39,14,25,9
S01011400,560,66,17,49,151,98,37,42,74,66,26,7,19,0
S01011401,470,60,32,28,147,58,34,44,54,57,11,4,7,5
S01011402,565,52,17,35,108,83,56,100,81,49,27,13,14,9
S01011403,470,43,17,26,118,71,29,39,82,61,18,7,11,9
S01011404,697,50,10,40,152,94,47,59,124,116,42,20,22,13
S01011405,472,47,10,37,119,50,32,50,74,47,53,39,14,0
S01011406,487,12,2,10,117,43,40,56,90,102,16,0,16,11
S01011407,857,65,11,54,231,121,98,72,80,147,22,8,14,21
S01011408,653,13,5,8,95,76,43,64,158,157,41,23,18,6
S01011409,746,30,2,28,117,84,59,94,141,145,70,32,38,6
S01011410,475,13,2,11,67,80,29,79,93,88,23,14,9,3
S01011411,523,26,7,19,78,50,34,99,107,90,32,12,20,7
S01011412,638,97,42,55,217,75,70,81,46,38,8,5,3,6
S01011413,514,41,13,28,131,108,53,57,44,69,9,7,2,2
S01011414,659,33,6,27,113,94,40,96,92,122,62,41,21,7
S01011415,703,55,19,36,164,86,66,105,98,108,20,6,14,1
S01011416,539,61,17,44,147,90,48,93,32,64,4,2,2,0
S01011417,594,39,4,35,108,72,65,61,97,117,24,17,7,11
S01011418,418,11,3,8,62,40,30,74,94,74,18,11,7,15
S01011419,432,45,4,41,72,62,22,50,62,93,26,9,17,0
S01011420,403,6,0,6,47,36,36,17,78,124,44,22,22,15
S01011421,590,54,19,35,168,81,30,85,58,71,38,15,23,5
S01011422,525,28,6,22,75,63,45,61,106,119,24,11,13,4
S01011423,487,39,4,35,61,39,17,52,116,106,55,30,25,2
S01011424,438,13,5,8,73,43,25,64,81,121,14,10,4,4
S01011425,742,36,9,27,157,52,84,78,146,112,61,28,33,16
S01011426,873,144,35,109,297,66,126,88,63,76,7,2,5,6
S01011427,557,32,4,28,116,33,67,58,99,124,28,10,18,0
S01011428,386,33,6,27,56,24,38,63,52,90,29,14,15,1
S01011429,557,97,27,70,183,50,94,54,30,44,3,2,1,2
S01011430,761,72,11,61,171,96,87,97,111,111,11,3,8,5
S01011431,798,36,13,23,143,64,79,112,139,172,36,15,21,17
S01011432,796,24,14,10,140,107,43,95,143,198,39,10,29,7
S01011433,814,20,7,13,67,84,38,81,181,223,101,48,53,19
S01011434,429,21,8,13,88,57,32,56,83,76,12,8,4,4
S01011435,786,87,32,55,264,85,74,95,70,84,17,2,15,10
S01011436,591,14,0,14,81,61,55,69,124,124,54,16,38,9
S01011437,584,23,11,12,93,56,48,71,113,126,49,31,18,5
S01011438,480,5,5,0,39,51,16,48,136,131,52,34,18,2
S01011439,703,33,8,25,101,67,74,96,135,154,36,17,19,7
S01011440,486,18,6,12,46,63,27,57,121,134,18,5,13,2
S01011441,622,23,14,9,81,73,45,80,122,150,48,16,32,0
S01011442,528,12,3,9,68,54,52,86,103,129,20,10,10,4
S01011443,474,23,10,13,82,56,26,52,78,128,20,2,18,9
S01011444,614,20,4,16,62,55,58,81,121,154,57,30,27,6
S01011445,461,39,6,33,109,42,37,53,57,92,27,11,16,5
S01011446,420,23,6,17,72,54,85,50,48,70,12,6,6,6
S01011447,827,18,9,9,120,140,69,88,149,180,58,19,39,5
S01011448,734,58,13,45,186,73,97,83,121,87,19,5,14,10
S01011449,394,26,5,21,80,30,26,67,54,73,37,15,22,1
S01011450,565,76,18,58,162,55,96,63,33,58,12,10,2,10
S01011451,684,120,43,77,214,46,166,44,40,32,22,5,17,0
S01011452,845,100,33,67,192,97,111,105,107,114,15,0,15,4
S01011453,567,31,17,14,109,65,47,72,93,113,34,10,24,3
S01011454,645,18,5,13,112,65,50,106,118,156,16,4,12,4
S01011455,588,12,3,9,68,57,59,56,146,133,51,26,25,6
S01011456,651,19,7,12,88,100,71,99,102,129,39,24,15,4
S01011457,785,26,0,26,98,78,35,83,170,232,55,32,23,8
S01011458,1052,121,25,96,254,163,104,164,101,122,15,9,6,8
S01011459,970,87,16,71,271,164,72,105,114,140,15,4,11,2
S01011460,681,56,13,43,162,42,45,94,71,159,44,25,19,8
S01011461,655,17,7,10,78,93,52,84,135,146,41,17,24,9
S01011462,729,117,34,83,169,86,61,82,101,91,15,8,7,7
S01011463,554,35,2,33,129,68,66,60,82,98,8,3,5,8
S01011464,555,97,19,78,186,41,74,68,37,42,7,6,1,3
S01011465,467,11,0,11,34,30,51,48,109,115,65,37,28,4
S01011466,478,32,10,22,59,46,31,28,85,143,42,24,18,12
S01011467,482,49,13,36,111,60,42,49,70,66,35,17,18,0
S01011468,897,134,45,89,324,108,85,90,63,60,18,14,4,15
S01011469,783,31,6,25,125,85,71,78,159,144,68,29,39,22
S01011470,870,74,24,50,147,101,89,84,167,146,31,13,18,31
S01011471,600,67,33,34,150,72,30,51,103,93,12,3,9,22
S01011472,677,20,5,15,91,106,41,79,117,124,75,30,45,24
S01011473,403,9,0,9,48,85,15,42,100,78,16,8,8,10
S01011474,544,29,13,16,100,70,19,59,108,101,51,25,26,7
S01011475,415,13,1,12,57,59,19,34,96,78,39,16,23,20
S01011476,393,58,7,51,113,79,22,62,31,28,0,0,0,0
S01011477,671,115,29,86,222,143,42,53,40,51,4,4,0,1
S01011478,887,217,71,146,330,98,97,70,43,16,6,1,5,10
S01011479,597,83,22,61,211,85,62,56,43,48,8,7,1,1
S01011480,798,250,50,200,249,69,93,38,51,33,11,8,3,4
S01011481,704,92,8,84,215,83,56,95,60,84,18,12,6,1
S01011482,659,40,5,35,167,87,32,82,92,107,32,8,24,20
S01011483,456,54,12,42,173,56,37,37,48,39,7,4,3,5
S01011484,706,35,4,31,95,80,46,74,185,140,35,10,25,16
S01011485,781,30,13,17,122,97,15,82,157,158,104,54,50,16
S01011486,456,4,3,1,64,30,11,54,95,140,52,33,19,6
S01011487,958,47,11,36,113,125,72,96,231,203,65,43,22,6
S01011488,553,24,7,17,49,55,25,65,146,112,72,27,45,5
S01011489,740,92,43,49,200,101,66,83,77,98,19,8,11,4
S01011490,803,31,11,20,198,106,66,72,135,161,28,14,14,6
S01011491,427,12,0,12,66,41,12,58,75,90,64,43,21,9
S01011492,695,15,0,15,78,51,23,90,126,172,109,66,43,31
S01011493,526,88,33,55,162,62,46,80,31,57,0,0,0,0
S01011494,562,41,10,31,93,77,39,58,90,134,21,10,11,9
S01011495,638,22,3,19,104,80,30,78,144,119,53,23,30,8
S01011496,595,20,10,10,62,45,41,69,153,152,48,27,21,5
S01011497,571,69,20,49,169,61,77,65,48,60,19,8,11,3
S01011498,637,53,11,42,204,119,54,84,69,45,1,0,1,8
S01011499,701,45,15,30,172,146,71,95,70,78,17,6,11,7
S01011500,413,19,11,8,82,43,28,46,77,94,23,1,22,1
S01011501,547,25,3,22,40,39,29,56,97,194,66,32,34,1
S01011502,612,21,9,12,78,86,52,93,110,138,28,15,13,6
S01011503,525,21,8,13,97,48,41,56,92,130,34,11,23,6
S01011504,460,34,4,30,90,49,40,61,68,93,17,3,14,8
S01011505,613,25,1,24,97,64,41,80,113,131,46,11,35,16
S01011506,350,23,9,14,83,37,25,44,53,73,9,3,6,3
S01011507,481,28,14,14,93,50,42,59,70,91,44,28,16,4
S01011508,875,85,28,57,183,95,72,126,113,157,36,18,18,8
S01011509,514,31,10,21,76,56,40,88,100,91,29,18,11,3
S01011510,957,26,5,21,178,65,82,104,241,150,99,38,61,12
S01011511,414,5,0,5,49,52,16,35,106,106,35,11,24,10
S01011512,861,12,0,12,69,128,39,93,181,200,124,69,55,15
S01011513,673,22,4,18,88,64,28,90,141,159,77,47,30,4
S01011514,824,20,0,20,99,72,64,111,168,242,35,20,15,13
S01011515,472,20,4,16,98,86,51,69,56,75,14,8,6,3
S01011516,829,80,24,56,247,117,80,121,93,66,16,7,9,9
S01011517,440,33,11,22,69,68,30,64,72,81,14,1,13,9
S01011518,473,26,9,17,73,17,49,70,68,132,38,26,12,0
S01011519,637,15,3,12,118,53,33,87,138,170,23,16,7,0
S01011520,486,18,0,18,66,38,23,61,80,119,68,40,28,13
S01011521,846,45,25,20,138,113,46,72,175,149,96,46,50,12
S01011522,732,27,4,23,137,98,49,73,190,117,23,11,12,18
S01011523,645,22,4,18,88,44,51,89,133,189,24,12,12,5
S01011524,766,86,25,61,156,103,65,125,99,119,8,2,6,5
S01011525,780,87,25,62,189,71,58,104,112,140,16,12,4,3
S01011526,836,46,5,41,148,112,66,144,146,136,36,21,15,2
S01011527,512,68,45,23,116,40,56,72,67,73,20,5,15,0
S01011528,735,29,9,20,120,96,55,100,142,136,49,16,33,8
S01011529,418,19,8,11,59,46,20,25,96,94,45,21,24,14
S01011530,755,34,2,32,109,81,42,106,150,172,48,22,26,13
S01011531,877,119,20,99,262,122,93,84,76,90,24,6,18,7
S01011532,615,90,30,60,164,46,101,79,44,72,14,7,7,5
S01011533,524,21,13,8,43,59,43,60,122,117,54,32,22,5
S01011534,619,61,4,57,98,99,71,77,96,90,23,5,18,4
S01011535,669,21,2,19,80,73,25,73,124,178,80,44,36,15
S01011536,592,95,24,71,171,105,65,43,50,49,5,0,5,9
S01011537,488,59,14,45,128,114,38,42,39,52,10,9,1,6
S01011538,551,131,26,105,182,47,60,45,41,31,9,5,4,5
S01011539,588,26,7,19,111,58,39,50,134,117,44,15,29,9
S01011540,850,47,8,39,172,97,90,89,128,181,31,14,17,15
S01011541,838,16,5,11,96,65,73,96,204,224,51,15,36,13
S01011542,791,24,11,13,87,95,52,129,180,178,44,10,34,2
S01011543,736,8,1,7,69,68,65,113,174,175,54,21,33,10
S01011544,541,8,3,5,82,54,42,53,144,126,25,10,15,7
S01011545,420,6,0,6,43,48,29,90,71,115,14,4,10,4
S01011546,729,131,54,77,234,89,119,54,55,37,3,0,3,7
S01011547,588,80,18,62,191,66,80,52,46,57,13,6,7,3
S01011548,563,27,9,18,135,84,42,45,110,103,3,2,1,14
S01011549,629,76,20,56,177,81,65,83,64,67,16,2,14,0
S01011550,591,100,14,86,187,120,51,40,28,49,13,7,6,3
S01011551,449,37,10,27,110,52,42,57,69,58,24,8,16,0
S01011552,601,48,8,40,173,92,70,69,91,49,6,4,2,3
S01011553,839,170,18,152,282,53,181,48,45,42,7,0,7,11
S01011554,636,37,7,30,109,104,72,48,91,152,18,11,7,5
S01011555,484,9,1,8,57,71,29,61,107,122,25,12,13,3
S01011556,431,14,10,4,51,59,49,40,114,61,32,13,19,11
S01011557,641,9,4,5,121,83,53,72,147,131,23,11,12,2
S01011558,501,20,8,12,62,59,49,72,100,106,32,12,20,1
S01011559,536,15,4,11,82,35,55,83,103,113,35,21,14,15
S01011560,647,15,6,9,120,74,23,49,145,194,20,7,13,7
S01011561,689,0,0,0,108,63,43,76,171,192,31,10,21,5
S01011562,577,20,0,20,81,58,36,63,101,128,65,35,30,25
S01011563,676,25,8,17,110,76,46,57,130,164,55,30,25,13
S01011564,820,53,8,45,150,118,81,109,111,158,36,17,19,4
S01011565,835,29,13,16,128,127,71,114,134,182,33,11,22,17
S01011566,819,44,19,25,65,90,56,99,170,190,78,30,48,27
S01011567,708,25,5,20,83,113,77,85,148,147,21,15,6,9
S01011568,713,51,13,38,167,109,54,84,120,104,21,11,10,3
S01011569,785,73,23,50,156,93,40,116,132,141,24,14,10,10
S01011570,537,25,11,14,86,69,45,65,96,114,24,13,11,13
S01011571,488,16,0,16,80,54,26,55,122,88,30,13,17,17
S01011572,486,28,8,20,112,62,31,32,115,84,20,5,15,2
S01011573,961,100,22,78,239,124,121,104,97,132,32,8,24,12
S01011574,690,60,26,34,131,96,75,99,101,111,8,4,4,9
S01011575,439,21,4,17,98,35,25,56,73,75,44,12,32,12
S01011576,623,4,4,0,42,59,30,48,180,183,67,18,49,10
S01011577,636,49,12,37,120,91,58,56,118,100,32,19,13,12
S01011578,750,41,11,30,163,102,54,60,138,146,40,15,25,6
S01011579,885,159,39,120,325,98,118,73,57,43,9,5,4,3
S01011580,692,55,9,46,147,79,63,82,105,108,47,25,22,6
S01011581,543,43,5,38,68,67,36,45,103,123,49,29,20,9
S01011582,848,157,48,109,273,106,95,59,92,61,0,0,0,5
S01011583,581,30,6,24,131,61,32,72,112,101,27,10,17,15
S01011584,571,16,3,13,81,84,30,64,129,136,21,15,6,10
S01011585,564,22,7,15,87,94,44,49,109,115,40,22,18,4
S01011586,465,6,0,6,93,67,14,65,80,94,41,8,33,5
S01011587,488,13,0,13,95,46,34,83,96,94,19,8,11,8
S01011588,672,44,22,22,82,99,64,62,139,106,70,25,45,6
S01011589,662,20,5,15,131,69,44,86,172,122,17,10,7,1
S01011590,561,16,4,12,91,60,61,76,96,121,36,15,21,4
S01011591,507,11,0,11,69,37,38,58,72,156,58,27,31,8
S01011592,578,18,4,14,63,75,37,55,108,151,65,29,36,6
S01011593,567,64,24,40,132,85,45,56,69,90,19,8,11,7
S01011594,333,15,8,7,79,37,31,53,51,54,9,2,7,4
S01011595,496,60,9,51,148,70,57,34,37,70,9,1,8,11
S01011596,794,72,26,46,218,118,45,55,112,104,48,29,19,22
S01011597,475,49,12,37,140,55,35,57,77,47,6,4,2,9
S01011598,697,16,5,11,48,77,35,57,168,148,127,51,76,21
S01011599,660,24,1,23,138,107,36,58,94,153,39,21,18,11
S01011600,545,21,6,15,95,76,35,71,114,122,9,7,2,2
S01011601,774,89,22,67,218,96,67,102,77,108,17,14,3,0
S01011602,502,44,8,36,88,39,56,39,95,90,43,20,23,8
S01011603,562,8,2,6,85,76,31,63,137,103,44,23,21,15
S01011604,562,8,2,6,67,62,39,62,110,154,50,22,28,10
S01011605,632,12,1,11,106,90,71,87,121,108,30,13,17,7
S01011606,970,128,21,107,322,162,73,97,82,83,7,3,4,16
S01011607,523,65,14,51,147,47,61,71,60,54,15,0,15,3
S01011608,893,96,38,58,238,114,127,113,88,107,10,7,3,0
S01011609,840,17,0,17,79,67,64,103,168,202,108,56,52,32
S01011610,704,26,4,22,81,64,26,52,178,180,88,48,40,9
S01011611,566,43,20,23,169,67,47,91,55,68,18,10,8,8
S01011612,622,103,16,87,248,77,77,44,23,41,9,5,4,0
S01011613,761,101,23,78,243,93,108,90,37,79,10,0,10,0
S01011614,348,45,13,32,104,58,44,16,18,38,14,2,12,11
S01011615,639,43,17,26,88,72,53,78,127,120,42,16,26,16
S01011616,336,16,0,16,32,39,28,33,64,74,40,26,14,10
S01011617,665,33,16,17,82,74,60,72,126,165,43,27,16,10
S01011618,534,31,6,25,81,52,38,38,129,127,36,24,12,2
S01011619,975,121,34,87,319,144,59,94,121,98,16,6,10,3
S01011620,1042,140,24,116,288,170,106,138,58,128,2,1,1,12
S01011621,675,65,22,43,172,79,53,81,77,122,22,5,17,4
S01011622,606,104,25,79,191,69,97,55,34,51,0,0,0,5
S01011623,556,28,6,22,86,70,62,50,106,109,33,19,14,12
S01011624,655,62,22,40,183,71,65,85,62,100,25,4,21,2
S01011625,479,11,4,7,87,76,37,52,94,93,22,8,14,7
S01011626,764,115,41,74,202,130,89,67,55,73,17,0,17,16
S01011627,701,90,19,71,248,64,67,96,47,75,6,3,3,8
S01011628,864,112,31,81,237,135,110,96,67,95,5,1,4,7
S01011629,525,5,2,3,74,59,47,83,90,104,38,12,26,25
S01011630,524,33,13,20,51,68,60,51,69,135,54,8,46,3
S01011631,573,10,7,3,26,65,30,87,104,159,72,39,33,20
S01011632,661,13,0,13,78,57,56,46,149,210,42,25,17,10
S01011633,584,30,2,28,63,68,43,74,76,175,51,23,28,4
S01011634,476,24,2,22,59,64,10,69,103,89,45,30,15,13
S01011635,601,23,3,20,83,61,47,76,131,121,49,36,13,10
S01011636,602,20,6,14,50,84,45,83,137,131,41,22,19,11
S01011637,570,16,0,16,118,42,45,58,115,119,49,29,20,8
S01011638,351,14,2,12,74,45,33,36,63,68,14,6,8,4
S01011639,475,21,6,15,73,61,13,61,87,93,62,32,30,4
S01011640,567,22,7,15,88,44,45,101,96,133,32,9,23,6
S01011641,372,48,5,43,125,51,47,39,32,28,1,1,0,1
S01011642,665,85,16,69,141,88,51,79,92,89,36,9,27,4
S01011643,496,93,14,79,139,35,65,40,65,53,4,0,4,2
S01011644,520,55,6,49,142,74,44,62,83,54,5,0,5,1
S01011645,362,15,4,11,88,65,46,35,63,45,3,1,2,2
S01011646,567,99,27,72,176,91,44,63,47,47,0,0,0,0
S01011647,796,111,38,73,281,110,62,80,81,60,10,0,10,1
S01011648,650,76,11,65,168,85,55,83,74,65,43,23,20,1
S01011649,420,15,7,8,74,89,32,45,67,67,18,6,12,13
S01011650,582,87,23,64,153,81,67,44,70,63,16,12,4,1
S01011651,715,78,12,66,179,79,44,61,112,103,26,3,23,33
S01011652,654,80,23,57,176,94,43,55,94,73,26,6,20,13
S01011653,734,16,2,14,107,83,71,101,111,171,61,14,47,13
S01011654,764,81,16,65,125,101,72,57,123,113,70,31,39,22
S01011655,674,17,4,13,93,84,42,80,116,135,99,47,52,8
S01011656,525,17,3,14,60,49,23,66,82,145,71,27,44,12
S01011657,450,27,4,23,73,29,26,50,83,96,51,25,26,15
S01011658,531,18,3,15,50,27,62,71,110,124,50,17,33,19
S01011659,599,18,5,13,85,77,49,64,116,142,30,12,18,18
S01011660,752,84,22,62,176,110,72,84,98,102,13,7,6,13
S01011661,391,16,4,12,69,56,48,43,63,77,18,12,6,1
S01011662,592,65,9,56,200,54,99,49,64,55,1,0,1,5
S01011663,892,19,0,19,121,117,62,128,125,205,100,32,68,15
S01011664,825,20,11,9,83,67,69,94,186,241,64,49,15,1
S01011665,664,32,5,27,127,99,38,50,119,126,49,18,31,24
S01011666,640,35,8,27,91,94,24,57,109,128,86,22,64,16
S01011667,582,51,8,43,88,87,60,61,74,117,41,23,18,3
S01011668,938,11,4,7,91,76,37,129,226,271,79,45,34,18
S01011669,441,68,8,60,111,50,72,27,23,69,14,7,7,7
S01011670,473,12,0,12,68,60,37,40,118,107,28,14,14,3
S01011671,492,71,9,62,118,69,59,34,48,80,8,3,5,5
S01011672,460,53,10,43,79,30,42,40,78,87,43,25,18,8
S01011673,552,23,2,21,75,70,36,77,87,128,50,27,23,6
S01011674,842,56,10,46,179,145,42,91,132,152,45,19,26,0
S01011675,704,46,10,36,113,53,42,74,141,158,63,25,38,14
S01011676,560,15,0,15,58,60,22,93,86,181,44,17,27,1
S01011677,585,62,21,41,139,98,47,39,62,88,37,14,23,13
S01011678,363,12,0,12,45,28,27,50,48,103,45,33,12,5
S01011679,528,35,14,21,133,83,47,100,61,54,8,1,7,7
S01011680,860,36,8,28,80,124,77,78,156,219,76,38,38,14
S01011681,709,44,7,37,124,90,69,67,118,148,41,8,33,8
S01011682,355,40,8,32,76,22,99,37,28,38,13,2,11,2
S01011683,639,19,2,17,70,65,98,99,91,165,24,7,17,8
S01011684,426,31,10,21,84,38,59,50,53,91,18,14,4,2
S01011685,739,87,28,59,248,62,98,69,70,89,16,9,7,0
S01011686,695,84,16,68,226,75,75,81,63,87,0,0,0,4
S01011687,708,52,8,44,109,87,48,101,145,116,48,22,26,2
S01011688,736,119,32,87,171,91,112,69,68,70,29,19,10,7
S01011689,584,112,31,81,146,71,93,65,35,49,6,1,5,7
S01011690,899,111,26,85,220,108,143,89,98,88,39,24,15,3
S01011691,562,79,30,49,160,74,53,43,74,65,9,9,0,5
S01011692,870,27,7,20,126,115,54,94,174,215,51,22,29,14
S01011693,675,81,11,70,206,91,62,73,69,67,12,5,7,14
S01011694,511,78,13,65,155,59,50,42,51,47,26,15,11,3
S01011695,856,149,46,103,266,91,111,85,66,78,9,5,4,1
S01011696,1043,279,44,235,362,81,136,59,61,54,6,0,6,5
S01011697,928,158,27,131,271,102,104,72,105,82,25,7,18,9
S01011698,530,10,0,10,102,58,75,80,79,103,21,4,17,2
S01011699,749,106,41,65,215,106,106,70,71,56,10,5,5,9
S01011700,574,62,23,39,147,77,78,59,59,76,9,2,7,7
S01011701,836,169,31,138,251,115,89,68,76,50,15,9,6,3
S01011702,562,105,19,86,151,66,51,46,58,61,17,6,11,7
S01011703,523,115,21,94,145,42,114,47,19,31,10,2,8,0
S01011704,662,108,16,92,210,93,70,66,71,28,11,4,7,5
S01011705,658,50,16,34,113,74,79,68,101,116,43,17,26,14
S01011706,729,69,18,51,163,96,81,77,109,99,24,9,15,11
S01011707,548,72,18,54,196,71,56,57,58,21,8,0,8,9
S01011708,718,42,8,34,152,110,66,72,118,122,29,15,14,7
S01011709,785,84,24,60,235,82,75,75,111,88,24,4,20,11
S01011710,575,10,4,6,71,72,31,55,147,114,71,19,52,4
S01011711,545,11,2,9,77,81,38,59,103,125,43,16,27,8
S01011712,441,31,8,23,88,76,35,57,83,51,18,3,15,2
S01011713,678,59,13,46,164,106,79,65,104,92,9,4,5,0
S01011714,545,89,7,82,131,63,60,76,50,71,2,2,0,3
S01011715,520,24,0,24,87,60,29,67,100,94,44,25,19,15
S01011716,849,69,9,60,248,145,117,85,96,79,7,3,4,3
S01011717,570,52,13,39,152,66,91,47,69,84,6,2,4,3
S01011718,768,106,13,93,263,86,104,82,65,59,1,0,1,2
S01011719,611,98,36,62,203,76,99,55,31,38,0,0,0,11
S01011720,432,82,23,59,161,58,56,21,22,31,1,1,0,0
S01011721,568,29,4,25,107,131,32,71,85,95,12,2,10,6
S01011722,567,42,1,41,116,82,50,72,99,61,31,10,21,14
S01011723,773,68,9,59,166,133,78,95,100,119,11,2,9,3
S01011724,715,86,10,76,205,101,62,57,76,91,25,11,14,12
S01011725,606,120,36,84,198,57,73,38,46,65,4,1,3,5
S01011726,520,84,22,62,164,84,48,48,33,57,1,1,0,1
S01011727,738,142,41,101,292,87,113,41,29,24,3,0,3,7
S01011728,774,41,12,29,165,110,92,94,114,129,18,9,9,11
S01011729,564,36,5,31,94,83,29,81,80,112,35,3,32,14
S01011730,626,56,4,52,162,101,62,69,94,75,2,1,1,5
S01011731,626,28,8,20,140,92,84,50,110,109,13,5,8,0
S01011732,672,104,34,70,212,111,89,68,38,44,6,0,6,0
S01011733,653,35,10,25,129,125,60,72,107,105,16,3,13,4
S01011734,572,63,12,51,141,83,50,62,91,64,10,6,4,8
S01011735,559,72,27,45,163,87,69,33,59,61,11,1,10,4
S01011736,678,36,3,33,137,149,55,69,79,110,20,6,14,23
S01011737,604,34,10,24,135,100,68,39,55,78,72,40,32,23
S01011738,894,70,22,48,179,107,98,81,140,146,57,35,22,16
S01011739,382,16,5,11,47,63,16,53,96,66,14,4,10,11
S01011740,672,20,10,10,135,66,28,84,120,118,61,33,28,40
S01011741,516,25,8,17,60,77,27,73,72,128,39,18,21,15
S01011742,607,53,6,47,122,94,40,63,125,80,24,9,15,6
S01011743,620,34,1,33,112,129,55,85,80,100,11,6,5,14
S01011744,633,37,11,26,150,98,54,54,108,93,33,12,21,6
S01011745,432,14,4,10,73,69,35,67,71,83,11,5,6,9
S01011746,464,0,0,0,78,37,35,41,138,107,19,10,9,9
S01011747,857,14,3,11,92,116,52,102,197,183,86,18,68,15
S01011748,777,6,0,6,85,97,55,116,178,152,55,31,24,33
S01011749,727,17,3,14,75,67,26,70,159,172,115,69,46,26
S01011750,687,38,12,26,117,121,51,66,121,134,31,10,21,8
S01011751,879,33,11,22,96,105,54,96,196,179,83,24,59,37
S01011752,765,26,8,18,184,111,57,112,125,127,17,9,8,6
S01011753,595,49,12,37,140,91,49,74,100,69,22,10,12,1
S01011754,594,39,12,27,91,81,52,94,101,97,28,11,17,11
S01011755,827,41,14,27,161,124,54,81,165,154,36,15,21,11
S01011756,857,34,8,26,159,154,66,91,153,159,31,7,24,10
S01011757,606,11,0,11,114,113,38,71,97,108,38,15,23,16
S01011758,531,31,21,10,101,71,49,75,82,106,13,1,12,3
S01011759,656,56,6,50,78,122,53,78,114,119,20,6,14,16
S01011760,729,44,13,31,112,129,56,69,137,142,30,8,22,10
S01011761,668,43,8,35,119,77,63,61,110,171,17,4,13,7
S01011762,552,37,3,34,85,87,31,44,141,74,38,28,10,15
S01011763,633,31,12,19,132,88,71,89,89,101,22,8,14,10
S01011764,353,23,8,15,86,52,23,54,57,46,7,0,7,5
S01011765,890,115,28,87,274,138,121,69,64,94,9,7,2,6
S01011766,431,75,22,53,131,60,65,12,23,54,4,2,2,7
S01011767,654,25,6,19,120,75,63,62,141,104,50,19,31,14
S01011768,608,17,2,15,122,89,37,48,99,133,44,12,32,19
S01011769,433,26,1,25,55,86,45,39,80,69,23,12,11,10
S01011770,627,26,4,22,104,103,41,76,120,111,34,15,19,12
S01011771,617,132,25,107,192,78,67,60,46,29,10,7,3,3
S01011772,944,237,72,165,356,83,146,43,34,27,16,1,15,2
S01011773,572,104,29,75,182,65,64,77,59,16,3,3,0,2
S01011774,900,128,31,97,253,139,111,92,77,73,12,2,10,15
S01011775,626,176,63,113,203,73,67,52,39,13,3,3,0,0
S01011776,1063,271,65,206,371,94,122,66,72,61,6,0,6,0
S01011777,582,123,24,99,207,115,29,41,25,32,9,3,6,1
S01011778,573,146,43,103,223,57,60,29,32,11,13,0,13,2
S01011779,666,145,23,122,202,93,64,72,50,33,5,0,5,2
S01011780,849,232,73,159,233,63,151,66,47,43,14,5,9,0
S01011781,506,106,38,68,148,44,57,53,43,47,1,0,1,7
S01011782,572,109,36,73,182,82,68,58,36,29,7,1,6,1
S01011783,485,92,20,72,148,74,59,31,47,25,9,2,7,0
S01011784,677,24,3,21,136,93,71,71,121,124,17,6,11,20
S01011785,697,74,10,64,144,146,46,48,133,85,16,13,3,5
S01011786,422,92,29,63,154,45,50,34,19,9,8,0,8,11
S01011787,820,49,14,35,115,62,84,111,177,164,45,22,23,13
S01011788,648,214,81,133,161,45,182,10,20,11,1,0,1,4
S01011789,499,58,17,41,114,34,103,82,34,62,9,7,2,3
S01011790,882,66,9,57,188,80,117,69,151,135,49,33,16,27
S01011791,602,25,6,19,107,79,65,69,99,105,38,27,11,15
S01011792,595,44,13,31,147,62,83,49,68,108,29,16,13,5
S01011793,512,59,19,40,152,48,72,57,61,52,4,2,2,7
S01011794,726,26,13,13,109,113,90,60,140,148,35,19,16,5
S01011795,521,18,7,11,90,49,45,76,98,91,53,19,34,1
S01011796,657,13,0,13,120,59,53,85,126,129,54,30,24,18
S01011797,836,142,53,89,249,81,134,76,68,79,5,0,5,2
S01011798,448,23,4,19,80,31,61,64,75,79,25,11,14,10
S01011799,729,62,24,38,181,74,111,93,95,91,22,9,13,0
S01011800,390,24,6,18,48,36,39,94,54,88,6,0,6,1
S01011801,533,36,15,21,93,56,39,54,117,80,40,18,22,18
S01011802,538,36,16,20,84,51,56,71,105,88,36,7,29,11
S01011803,489,25,5,20,50,39,77,76,116,75,30,11,19,1
S01011804,570,25,8,17,143,36,83,73,89,105,8,4,4,8
S01011805,405,36,1,35,98,14,60,57,61,64,2,0,2,13
S01011806,582,53,16,37,131,29,116,71,97,75,7,0,7,3
S01011807,803,79,18,61,176,39,225,92,105,75,1,1,0,11
S01011808,488,31,8,23,137,34,71,62,76,66,7,2,5,4
S01011809,569,79,21,58,140,40,112,63,58,74,3,0,3,0
S01011810,731,67,14,53,147,62,149,107,67,130,2,0,2,0
S01011811,831,62,18,44,179,30,236,118,88,115,1,0,1,2
S01011812,558,82,11,71,164,30,140,52,48,39,3,0,3,0
S01011813,613,44,6,38,141,33,147,90,53,96,5,1,4,4
S01011814,574,54,16,38,158,20,142,39,75,85,1,0,1,0
S01011815,690,49,10,39,176,49,98,88,105,106,12,5,7,7
S01011816,514,68,35,33,178,44,92,57,34,40,0,0,0,1
S01011817,600,55,22,33,159,26,143,89,56,65,1,0,1,6
S01011818,869,73,28,45,220,67,109,109,154,126,5,2,3,6
S01011819,654,44,8,36,121,56,78,105,102,136,8,5,3,4
S01011820,551,52,8,44,145,49,59,87,58,90,8,3,5,3
S01011821,372,8,4,4,84,32,33,39,74,75,21,8,13,6
S01011822,564,38,7,31,98,45,57,101,130,76,16,10,6,3
S01011823,484,28,4,24,101,54,49,62,84,102,4,3,1,0
S01011824,609,18,4,14,122,50,53,104,103,143,16,10,6,0
S01011825,403,36,4,32,117,29,33,54,72,51,4,2,2,7
S01011826,527,52,22,30,92,48,68,65,105,94,3,2,1,0
S01011827,340,14,7,7,64,26,90,47,50,39,10,5,5,0
S01011828,696,56,16,40,133,32,204,79,117,57,9,8,1,9
S01011829,317,45,19,26,63,27,64,50,35,33,0,0,0,0
S01011830,417,16,5,11,67,40,146,60,44,31,12,3,9,1
S01011831,626,36,9,27,93,29,258,38,112,38,15,2,13,7
S01011832,610,33,7,26,128,31,216,62,88,45,7,2,5,0
S01011833,780,216,65,151,256,67,120,50,35,24,10,10,0,2
S01011834,427,145,39,106,132,33,50,23,20,19,5,2,3,0
S01011835,590,157,28,129,183,44,95,51,26,18,8,5,3,8
S01011836,581,157,33,124,179,58,88,31,57,8,3,0,3,0
S01011837,505,127,29,98,143,34,118,25,23,27,5,0,5,3
S01011838,619,184,38,146,183,83,65,42,32,24,0,0,0,6
S01011839,746,141,42,99,228,88,96,66,67,53,5,5,0,2
S01011840,838,161,49,112,241,73,85,91,104,70,13,6,7,0
S01011841,755,99,33,66,234,82,94,70,81,78,12,9,3,5
S01011842,739,81,14,67,180,58,69,105,127,99,12,0,12,8
S01011843,785,179,53,126,232,48,182,56,45,34,6,6,0,3
S01011844,597,244,40,204,172,32,71,21,30,23,1,0,1,3
S01011845,669,98,35,63,168,68,88,76,75,78,3,2,1,15
S01011846,672,157,33,124,210,62,102,39,40,49,8,8,0,5
S01011847,353,85,27,58,138,11,75,19,7,16,0,0,0,2
S01011848,560,95,13,82,173,38,114,24,68,41,1,0,1,6
S01011849,670,110,33,77,125,67,101,97,105,52,11,1,10,2
S01011850,519,77,28,49,157,62,140,34,26,17,5,1,4,1
S01011851,707,90,20,70,136,43,152,86,87,90,16,1,15,7
S01011852,755,90,16,74,153,72,112,84,100,112,21,11,10,11
S01011853,577,82,16,66,148,48,77,76,68,67,8,4,4,3
S01011854,485,65,10,55,124,35,68,73,53,57,1,0,1,9
S01011855,641,58,11,47,98,41,91,108,87,139,13,3,10,6
S01011856,448,102,24,78,170,52,67,25,18,7,3,0,3,4
S01011857,510,72,16,56,148,30,132,36,58,27,3,0,3,4
S01011858,540,91,15,76,156,39,105,44,52,44,2,0,2,7
S01011859,496,51,10,41,109,31,102,58,75,56,10,8,2,4
S01011860,417,56,14,42,115,33,84,49,29,34,13,7,6,4
S01011861,542,71,17,54,146,44,128,33,45,60,9,1,8,6
S01011862,643,125,38,87,215,30,92,56,76,29,11,2,9,9
S01011863,541,153,53,100,140,30,58,53,61,37,8,3,5,1
S01011864,525,87,28,59,177,52,70,47,50,39,0,0,0,3
S01011865,434,47,13,34,116,58,57,57,27,53,14,1,13,5
S01011866,623,68,7,61,134,54,97,72,86,102,8,1,7,2
S01011867,755,60,16,44,172,59,83,95,137,128,15,8,7,6
S01011868,695,90,16,74,159,65,103,82,110,63,22,12,10,1
S01011869,599,87,12,75,138,41,88,72,78,67,19,11,8,9
S01011870,559,49,10,39,117,47,75,65,90,106,8,6,2,2
S01011871,923,141,43,98,269,44,207,103,81,56,17,8,9,5
S01011872,746,162,27,135,196,54,196,44,49,32,8,0,8,5
S01011873,689,138,22,116,194,83,95,69,59,36,1,1,0,14
S01011874,548,58,15,43,149,78,80,74,62,36,6,2,4,5
S01011875,461,42,8,34,103,58,47,51,62,93,5,5,0,0
S01011876,772,144,35,109,256,53,135,58,72,50,4,2,2,0
S01011877,397,49,6,43,128,24,69,37,35,47,6,3,3,2
S01011878,743,152,40,112,228,59,122,64,68,41,7,0,7,2
S01011879,458,98,36,62,126,36,88,45,27,21,4,2,2,13
S01011880,469,125,40,85,120,23,87,38,42,32,2,1,1,0
S01011881,662,82,11,71,172,66,87,63,73,91,18,7,11,10
S01011882,660,74,16,58,144,94,90,76,81,87,10,5,5,4
S01011883,849,161,41,120,263,96,108,81,59,57,14,3,11,10
S01011884,332,71,12,59,83,37,73,19,18,27,4,0,4,0
S01011885,581,144,12,132,214,37,79,33,44,23,2,0,2,5
S01011886,705,147,20,127,178,58,80,80,77,66,6,2,4,13
S01011887,475,60,6,54,100,80,64,50,81,34,4,4,0,2
S01011888,739,34,6,28,165,110,48,104,120,116,34,13,21,8
S01011889,653,136,37,99,183,81,85,53,62,38,9,7,2,6
S01011890,571,125,30,95,136,73,43,64,46,71,8,5,3,5
S01011891,599,28,6,22,97,93,40,122,61,114,31,15,16,13
S01011892,882,131,25,106,279,108,81,74,94,89,6,2,4,20
S01011893,749,95,16,79,183,133,47,77,107,78,18,8,10,11
S01011894,539,47,9,38,121,86,55,37,106,71,4,0,4,12
S01011895,436,146,8,138,107,38,76,27,20,10,0,0,0,12
S01011896,668,133,12,121,196,105,54,61,55,55,2,0,2,7
S01011897,803,191,42,149,241,82,78,67,62,60,18,18,0,4
S01011898,581,178,22,156,207,72,67,19,26,12,0,0,0,0
S01011899,565,92,29,63,166,95,33,72,47,55,5,5,0,0
S01011900,565,177,18,159,169,82,41,35,43,13,4,4,0,1
S01011901,711,161,53,108,206,92,83,46,74,30,1,0,1,18
S01011902,748,170,19,151,270,101,74,40,53,30,0,0,0,10
S01011903,552,77,24,53,208,81,56,57,30,33,0,0,0,10
S01011904,571,109,24,85,210,78,50,44,57,18,3,1,2,2
S01011905,655,181,50,131,190,75,93,39,46,20,2,0,2,9
S01011906,326,37,8,29,127,43,27,34,25,27,2,0,2,4
S01011907,628,66,3,63,177,90,53,103,83,53,3,0,3,0
S01011908,338,52,14,38,108,50,28,42,41,14,1,0,1,2
S01011909,1007,125,27,98,299,148,89,143,122,66,5,2,3,10
S01011910,779,35,9,26,90,66,59,99,173,193,52,21,31,12
S01011911,476,25,13,12,98,73,51,69,56,88,12,8,4,4
S01011912,604,24,2,22,111,66,38,72,131,132,18,6,12,12
S01011913,627,21,1,20,89,77,39,80,134,150,35,14,21,2
S01011914,781,20,3,17,91,83,70,104,214,155,32,6,26,12
S01011915,676,36,8,28,98,61,48,90,139,169,17,11,6,18
S01011916,491,12,6,6,65,50,22,80,105,116,37,21,16,4
S01011917,407,7,1,6,65,36,22,57,107,98,6,1,5,9
S01011918,695,22,3,19,87,53,46,61,144,186,75,36,39,21
S01011919,702,43,10,33,122,89,50,77,127,126,33,21,12,35
S01011920,503,18,2,16,71,72,42,51,88,136,12,7,5,13
S01011921,489,18,1,17,56,57,29,51,119,110,28,9,19,21
S01011922,648,18,5,13,95,64,26,75,156,171,37,16,21,6
S01011923,783,22,5,17,125,97,46,101,161,172,46,28,18,13
S01011924,376,12,4,8,52,49,28,37,79,87,13,2,11,19
S01011925,732,124,45,79,217,76,96,92,47,60,15,9,6,5
S01011926,553,33,8,25,86,66,43,75,136,98,12,7,5,4
S01011927,507,14,5,9,86,86,46,43,116,90,18,9,9,8
S01011928,555,48,11,37,103,68,64,86,67,101,13,6,7,5
S01011929,547,15,3,12,98,99,24,82,108,105,14,12,2,2
S01011930,520,22,11,11,91,71,41,57,79,138,12,7,5,9
S01011931,568,13,2,11,90,42,25,74,111,147,55,41,14,11
S01011932,569,42,1,41,127,81,33,52,81,102,26,14,12,25
S01011933,532,26,4,22,95,65,40,72,80,106,20,11,9,28
S01011934,872,87,24,63,193,82,69,84,122,136,29,12,17,70
S01011935,671,40,6,34,99,66,54,80,109,144,25,10,15,54
S01011936,569,97,5,92,143,62,40,48,76,58,18,8,10,27
S01011937,536,72,6,66,103,61,39,57,84,72,19,13,6,29
S01011938,513,76,17,59,128,52,68,42,59,65,13,3,10,10
S01011939,646,46,9,37,135,67,40,79,115,87,34,12,22,43
S01011940,381,28,6,22,69,42,22,48,72,56,25,14,11,19
S01011941,637,59,7,52,114,75,35,64,154,93,12,4,8,31
S01011942,678,39,5,34,133,65,36,70,125,122,24,12,12,64
S01011943,918,54,4,50,150,102,60,101,188,156,53,24,29,54
S01011944,324,90,14,76,110,12,46,19,37,8,2,0,2,0
S01011945,532,203,52,151,164,45,65,27,12,7,1,0,1,8
S01011946,551,117,20,97,112,41,44,72,83,62,13,5,8,7
S01011947,325,43,1,42,105,43,23,61,29,21,0,0,0,0
S01011948,745,182,19,163,213,61,71,68,63,57,29,11,18,1
S01011949,491,102,32,70,189,55,49,32,37,24,3,0,3,0
S01011950,482,84,24,60,116,63,46,41,90,39,0,0,0,3
S01011951,484,60,11,49,159,57,58,42,42,51,6,3,3,9
S01011952,395,96,25,71,133,45,44,39,27,11,0,0,0,0
S01011953,587,158,33,125,169,62,80,50,28,28,9,0,9,3
S01011954,361,32,14,18,94,68,23,53,34,53,4,0,4,0
S01011955,696,69,5,64,166,78,107,77,83,95,18,9,9,3
S01011956,850,195,41,154,285,83,97,60,68,45,7,7,0,10
S01011957,580,112,33,79,142,68,94,67,45,40,10,4,6,2
S01011958,805,98,19,79,236,45,190,64,78,85,6,2,4,3
S01011959,664,99,37,62,188,55,146,46,61,57,5,0,5,7
S01011960,687,199,36,163,225,57,64,77,34,22,5,4,1,4
S01011961,627,111,23,88,184,69,49,82,52,71,1,0,1,8
S01011962,573,167,43,124,144,63,104,44,24,25,2,2,0,0
S01011963,413,79,19,60,116,59,21,38,51,40,8,1,7,1
S01011964,767,154,22,132,199,89,92,98,57,63,11,2,9,4
S01011965,548,124,37,87,139,82,39,68,48,33,10,4,6,5
S01011966,644,183,36,147,163,99,67,40,52,30,5,4,1,5
S01011967,794,192,34,158,222,58,176,43,57,36,10,9,1,0
S01011968,793,149,24,125,208,119,82,82,78,58,8,0,8,9
S01011969,792,54,15,39,182,78,70,107,125,157,17,3,14,2
S01011970,850,27,10,17,66,72,91,117,189,227,41,28,13,20
S01011971,459,95,34,61,99,43,59,52,38,64,9,1,8,0
S01011972,832,92,30,62,228,62,177,73,121,65,10,7,3,4
S01011973,466,75,29,46,127,25,76,44,61,49,6,4,2,3
S01011974,559,82,20,62,168,43,107,59,39,50,11,9,2,0
S01011975,338,53,6,47,78,22,63,48,41,24,5,0,5,4
S01011976,587,57,21,36,137,70,99,88,60,54,12,9,3,10
S01011977,853,98,16,82,213,49,130,102,108,121,20,9,11,12
S01011978,473,28,6,22,120,32,57,51,80,93,9,4,5,3
S01011979,750,102,22,80,238,57,154,46,76,65,0,0,0,12
S01011980,318,46,20,26,70,23,76,36,30,33,4,2,2,0
S01011981,684,100,22,78,125,44,161,126,86,37,0,0,0,5
S01011982,730,93,32,61,195,28,172,93,83,50,11,11,0,5
S01011983,463,49,0,49,75,44,106,88,56,33,6,4,2,6
S01011984,540,18,0,18,105,42,58,48,89,140,32,19,13,8
S01011985,516,38,8,30,138,40,119,53,53,61,12,7,5,2
S01011986,538,18,3,15,82,40,62,61,128,111,28,11,17,8
S01011987,739,43,16,27,181,99,98,57,161,88,9,4,5,3
S01011988,411,59,11,48,157,27,74,37,18,32,1,1,0,6
S01011989,636,58,16,42,154,92,101,84,58,83,6,3,3,0
S01011990,477,55,10,45,97,73,63,64,40,72,10,4,6,3
S01011991,549,30,12,18,116,42,87,65,96,81,32,11,21,0
S01011992,661,112,15,97,162,58,116,44,89,67,9,3,6,4
S01011993,627,31,12,19,98,74,53,94,112,111,38,15,23,16
S01011994,404,124,27,97,101,38,75,37,14,15,0,0,0,0
S01011995,649,110,25,85,186,39,151,54,48,60,1,1,0,0
S01011996,436,35,17,18,130,33,36,71,58,46,21,21,0,6
S01011997,702,81,15,66,172,44,104,91,77,101,14,6,8,18
S01011998,416,79,26,53,141,45,78,33,21,18,1,0,1,0
S01011999,480,50,7,43,107,52,104,57,46,52,8,0,8,4
S01012000,359,27,4,23,114,56,45,56,22,35,0,0,0,4
S01012001,497,60,26,34,100,49,78,77,39,86,3,0,3,5
S01012002,372,36,8,28,63,56,68,63,46,31,5,5,0,4
S01012003,418,27,7,20,118,51,53,41,40,77,11,0,11,0
S01012004,630,106,27,79,167,81,70,63,61,61,11,5,6,10
S01012005,758,141,38,103,238,91,78,67,74,60,5,2,3,4
S01012006,510,89,16,73,189,33,86,45,18,32,6,2,4,12
S01012007,558,66,10,56,159,44,94,67,87,34,2,1,1,5
S01012008,697,108,22,86,206,45,92,92,83,54,6,5,1,11
S01012009,505,73,13,60,111,18,96,58,66,67,11,5,6,5
S01012010,737,123,26,97,186,51,118,115,61,75,5,5,0,3
S01012011,800,51,8,43,182,50,109,112,185,75,19,6,13,17
S01012012,387,66,17,49,105,20,87,25,43,34,7,2,5,0
S01012013,525,56,12,44,90,36,151,66,70,51,5,1,4,0
S01012014,638,54,25,29,113,21,92,109,132,97,9,4,5,11
S01012015,732,60,23,37,152,64,121,118,101,82,17,6,11,17
S01012016,592,80,14,66,138,50,131,52,76,55,7,1,6,3
S01012017,365,62,5,57,85,7,117,28,36,23,7,5,2,0
S01012018,642,75,16,59,136,26,126,103,107,53,13,3,10,3
S01012019,719,123,12,111,283,79,53,60,58,40,17,4,13,6
S01012020,540,125,11,114,129,59,48,47,47,63,12,6,6,10
S01012021,467,126,26,100,95,47,46,41,58,43,11,5,6,0
S01012022,563,69,27,42,109,75,84,57,77,73,10,5,5,9
S01012023,420,113,31,82,106,31,107,31,6,13,6,1,5,7
S01012024,755,134,15,119,219,90,73,58,83,79,9,0,9,10
S01012025,570,59,9,50,135,81,62,91,70,66,2,0,2,4
S01012026,608,179,56,123,177,73,68,33,56,14,7,7,0,1
S01012027,717,151,38,113,207,92,107,49,49,47,7,1,6,8
S01012028,741,195,45,150,289,73,89,26,21,26,8,2,6,14
S01012029,812,148,54,94,207,71,142,90,72,66,8,8,0,8
S01012030,538,100,22,78,159,45,136,19,33,40,2,1,1,4
S01012031,395,120,19,101,142,31,49,19,16,12,6,4,2,0
S01012032,269,49,8,41,68,26,85,26,6,4,5,5,0,0
S01012033,612,82,16,66,198,76,44,51,58,75,26,7,19,2
S01012034,669,101,19,82,181,69,81,41,80,80,26,6,20,10
S01012035,712,142,23,119,219,66,67,62,83,43,16,9,7,14
S01012036,658,111,24,87,240,69,54,71,41,60,9,7,2,3
S01012037,799,31,8,23,127,117,28,81,161,165,65,18,47,24
S01012038,855,15,1,14,85,75,36,86,220,217,99,44,55,22
S01012039,737,20,7,13,98,86,72,115,129,158,47,28,19,12
S01012040,605,91,34,57,184,92,50,82,45,38,11,3,8,12
S01012041,730,50,14,36,174,83,60,72,118,108,36,3,33,29
S01012042,695,23,2,21,122,77,75,95,147,113,31,16,15,12
S01012043,802,37,13,24,124,93,41,90,166,168,71,46,25,12
S01012044,641,26,11,15,122,57,32,47,154,144,46,19,27,13
S01012045,887,75,29,46,150,112,55,110,131,142,87,34,53,25
S01012046,526,18,1,17,71,61,23,71,118,92,58,34,24,14
S01012047,668,29,9,20,119,79,63,77,109,126,53,28,25,13
S01012048,582,35,2,33,81,96,27,72,126,91,42,28,14,12
S01012049,520,47,14,33,105,87,54,57,70,73,12,5,7,15
S01012050,916,89,38,51,213,132,89,112,102,124,39,13,26,16
S01012051,365,57,4,53,115,54,29,25,28,28,19,9,10,10
S01012052,646,61,13,48,152,73,56,65,112,98,24,12,12,5
S01012053,715,34,3,31,130,81,34,121,150,113,39,19,20,13
S01012054,750,35,2,33,82,66,43,71,173,152,100,39,61,28
S01012055,688,31,4,27,122,80,52,88,123,148,32,10,22,12
S01012056,599,73,9,64,126,114,62,74,67,53,14,9,5,16
S01012057,592,91,20,71,183,102,54,63,36,47,13,3,10,3
S01012058,551,76,19,57,174,88,66,33,61,40,9,6,3,4
S01012059,706,36,7,29,94,102,68,76,149,127,42,17,25,12
S01012060,654,55,17,38,168,61,58,59,100,114,34,20,14,5
S01012061,776,147,45,102,254,86,54,72,64,61,25,7,18,13
S01012062,733,83,29,54,221,106,100,82,69,66,4,4,0,2
S01012063,519,41,5,36,123,67,45,69,103,53,9,7,2,9
S01012064,598,27,4,23,48,43,15,56,92,156,130,78,52,31
S01012065,590,9,4,5,29,33,10,46,134,170,136,104,32,23
S01012066,798,28,9,19,107,62,59,67,182,182,82,46,36,29
S01012067,485,7,0,7,55,29,16,46,136,96,88,47,41,12
S01012068,457,2,0,2,14,52,17,42,101,123,100,75,25,6
S01012069,426,17,8,9,65,46,22,26,111,77,50,25,25,12
S01012070,573,16,11,5,53,48,26,55,111,150,86,44,42,28
S01012071,891,52,2,50,127,99,47,95,157,191,85,49,36,38
S01012072,915,58,12,46,144,86,53,62,172,161,130,89,41,49
S01012073,637,75,12,63,210,63,40,59,93,41,35,16,19,21
S01012074,627,79,24,55,207,101,75,60,43,36,11,7,4,15
S01012075,692,138,44,94,212,83,84,83,36,50,1,1,0,5
S01012076,565,63,18,45,168,78,48,44,88,47,26,16,10,3
S01012077,676,41,4,37,119,70,17,52,166,144,42,19,23,25
S01012078,803,81,34,47,206,101,62,72,87,136,43,24,19,15
S01012079,704,41,16,25,86,108,65,70,137,158,34,13,21,5
S01012080,763,35,3,32,99,76,39,63,170,167,95,57,38,19
S01012081,641,18,1,17,98,70,35,65,117,140,81,42,39,17
S01012082,497,15,0,15,72,54,30,45,124,108,48,24,24,1
S01012083,542,20,7,13,101,83,19,55,117,106,38,6,32,3
S01012084,459,34,8,26,126,57,46,62,57,61,4,4,0,12
S01012085,515,86,23,63,123,67,36,58,66,65,8,4,4,6
S01012086,718,22,4,18,123,103,41,68,152,134,57,31,26,18
S01012087,537,33,15,18,127,88,25,53,79,104,20,4,16,8
S01012088,685,107,36,71,219,58,59,94,78,48,17,12,5,5
S01012089,686,91,18,73,270,112,57,68,43,30,14,12,2,1
S01012090,686,138,27,111,241,94,70,64,34,26,19,12,7,0
S01012091,432,49,21,28,121,66,34,44,57,50,8,6,2,3
S01012092,404,80,32,48,110,59,49,33,33,34,3,3,0,3
S01012093,410,65,15,50,117,58,39,46,36,41,5,3,2,3
S01012094,583,119,30,89,248,60,69,28,31,11,9,1,8,8
S01012095,985,82,28,54,247,107,85,132,114,147,44,24,20,27
S01012096,654,27,8,19,143,67,57,60,135,115,30,14,16,20
S01012097,564,16,2,14,81,67,31,63,126,129,51,21,30,0
S01012098,513,17,9,8,98,55,27,52,106,111,35,14,21,12
S01012099,618,22,15,7,81,65,28,78,144,158,28,6,22,14
S01012100,824,31,12,19,175,100,68,75,198,107,62,52,10,8
S01012101,609,115,10,105,204,56,43,77,72,32,6,5,1,4
S01012102,591,28,10,18,115,55,19,52,154,110,37,22,15,21
S01012103,804,61,15,46,194,143,63,87,128,100,22,1,21,6
S01012104,843,274,133,141,255,41,65,73,78,42,8,8,0,7
S01012105,921,183,52,131,291,110,73,74,103,65,9,5,4,13
S01012106,958,170,28,142,359,127,114,71,45,55,9,0,9,8
S01012107,538,120,28,92,195,45,90,26,28,12,17,6,11,5
S01012108,499,35,4,31,105,70,26,49,86,78,34,11,23,16
S01012109,825,43,5,38,151,97,47,99,144,111,92,46,46,41
S01012110,507,57,13,44,106,80,26,56,86,56,26,11,15,14
S01012111,477,25,12,13,66,61,31,37,92,87,56,27,29,22
S01012112,469,66,16,50,78,82,53,49,64,59,16,7,9,2
S01012113,712,77,14,63,166,123,75,63,96,82,14,1,13,16
S01012114,642,139,22,117,249,54,62,38,66,22,5,3,2,7
S01012115,371,20,7,13,68,54,17,40,81,66,15,12,3,10
S01012116,437,18,6,12,102,51,31,47,98,74,7,2,5,9
S01012117,764,119,49,70,276,106,63,99,44,48,0,0,0,9
S01012118,619,96,21,75,197,89,65,61,58,36,5,0,5,12
S01012119,706,89,21,68,219,82,75,73,63,84,9,4,5,12
S01012120,488,38,9,29,75,52,14,66,71,112,45,28,17,15
S01012121,717,28,6,22,160,93,36,95,133,91,66,39,27,15
S01012122,585,22,0,22,76,87,37,71,109,177,6,3,3,0
S01012123,431,50,11,39,93,55,50,43,71,52,13,3,10,4
S01012124,450,38,2,36,110,69,29,34,76,76,5,1,4,13
S01012125,668,20,6,14,131,66,28,57,145,108,71,23,48,42
S01012126,704,113,15,98,205,99,64,86,46,47,20,8,12,24
S01012127,779,55,13,42,112,112,56,53,122,98,90,52,38,81
S01012128,478,51,8,43,84,68,21,55,91,46,37,20,17,25
S01012129,573,36,5,31,114,90,32,65,86,75,61,40,21,14
S01012130,708,62,17,45,147,98,46,60,99,117,54,32,22,25
S01012131,826,35,1,34,131,120,33,87,139,136,83,48,35,62
S01012132,603,37,6,31,98,57,39,36,110,86,55,36,19,85
S01012133,695,83,17,66,179,61,49,63,117,73,39,21,18,31
S01012134,786,107,25,82,278,105,60,54,66,50,35,18,17,31
S01012135,770,31,10,21,80,108,32,70,196,135,74,46,28,44
S01012136,781,28,2,26,118,108,36,65,144,142,52,23,29,88
S01012137,507,8,1,7,132,68,18,48,82,61,46,23,23,44
S01012138,703,136,24,112,209,104,47,65,54,54,11,4,7,23
S01012139,690,117,28,89,146,100,63,64,87,82,23,13,10,8
S01012140,402,73,3,70,186,37,28,19,21,31,5,0,5,2
S01012141,813,132,36,96,265,163,75,84,57,35,2,1,1,0
S01012142,697,137,54,83,237,70,98,67,43,38,2,1,1,5
S01012143,617,167,26,141,207,49,93,33,41,16,5,2,3,6
S01012144,784,190,52,138,183,101,106,72,79,34,11,11,0,8
S01012145,788,227,42,185,268,106,60,43,55,22,7,2,5,0
S01012146,746,28,1,27,120,76,29,59,194,152,43,24,19,45
S01012147,613,19,9,10,83,92,20,66,143,105,66,36,30,19
S01012148,642,23,10,13,83,79,15,80,133,113,105,71,34,11
S01012149,704,73,10,63,159,74,83,79,113,74,35,30,5,14
S01012150,592,18,3,15,84,90,36,70,141,79,58,28,30,16
S01012151,555,17,9,8,118,54,30,53,126,115,34,17,17,8
S01012152,637,27,5,22,70,87,40,76,129,110,93,47,46,5
S01012153,494,22,1,21,78,61,32,71,86,82,42,28,14,20
S01012154,658,33,2,31,82,79,24,99,123,121,62,39,23,35
S01012155,465,12,1,11,101,45,29,52,71,82,39,16,23,34
S01012156,472,9,5,4,91,45,22,49,91,100,52,31,21,13
S01012157,823,51,11,40,221,98,45,82,135,147,22,8,14,22
S01012158,954,75,9,66,294,141,103,99,107,85,30,24,6,20
S01012159,364,34,3,31,90,59,35,60,42,42,2,0,2,0
S01012160,514,74,17,57,130,81,55,66,45,57,1,1,0,5
S01012161,399,15,4,11,84,24,14,34,100,97,28,19,9,3
S01012162,813,46,7,39,161,91,38,134,152,131,42,20,22,18
S01012163,684,63,4,59,125,104,38,69,113,99,54,26,28,19
S01012164,1059,130,38,92,352,142,90,144,96,90,15,14,1,0
S01012165,811,36,9,27,101,83,46,111,176,173,72,34,38,13
S01012166,542,6,1,5,92,65,42,91,115,102,18,7,11,11
S01012167,613,24,6,18,127,96,39,108,97,84,22,7,15,16
S01012168,638,56,22,34,190,114,48,78,75,66,6,6,0,5
S01012169,644,38,25,13,132,125,40,67,131,78,27,20,7,6
S01012170,669,49,10,39,124,114,43,109,122,90,14,7,7,4
S01012171,761,44,11,33,149,115,22,84,189,127,18,15,3,13
S01012172,546,15,5,10,86,103,36,52,102,106,37,27,10,9
S01012173,445,64,15,49,137,60,49,43,39,49,4,4,0,0
S01012174,859,145,33,112,279,108,91,68,75,82,5,0,5,6
S01012175,697,110,18,92,202,111,39,65,97,61,5,4,1,7
S01012176,729,59,22,37,181,108,66,119,86,90,6,1,5,14
S01012177,499,84,14,70,121,73,64,54,49,49,4,1,3,1
S01012178,419,52,8,44,97,77,40,63,29,61,0,0,0,0
S01012179,431,42,9,33,113,49,30,52,50,42,38,30,8,15
S01012180,390,37,6,31,112,53,46,39,49,40,10,8,2,4
S01012181,558,63,21,42,159,65,42,59,86,54,29,16,13,1
S01012182,980,163,36,127,293,127,89,146,93,42,11,6,5,16
S01012183,619,44,11,33,137,71,53,72,106,85,39,27,12,12
S01012184,468,98,14,84,123,66,34,31,43,48,6,0,6,19
S01012185,646,31,3,28,115,88,43,67,76,121,87,57,30,18
S01012186,504,47,28,19,118,64,37,47,71,82,30,8,22,8
S01012187,521,7,3,4,85,60,25,68,134,78,37,21,16,27
S01012188,386,34,14,20,121,81,19,26,50,48,2,2,0,5
S01012189,485,70,17,53,143,81,32,64,58,21,13,8,5,3
S01012190,514,106,22,84,159,72,32,43,48,45,1,1,0,8
S01012191,757,130,39,91,245,125,68,80,81,19,7,1,6,2
S01012192,403,64,25,39,150,44,60,32,22,19,8,4,4,4
S01012193,544,129,42,87,175,63,70,66,26,15,0,0,0,0
S01012194,535,122,17,105,197,91,23,46,24,23,7,1,6,2
S01012195,961,136,28,108,321,165,63,113,83,57,20,14,6,3
S01012196,546,110,34,76,187,68,44,18,58,51,7,7,0,3
S01012197,584,51,9,42,143,99,44,72,92,69,8,2,6,6
S01012198,745,81,26,55,223,111,39,61,86,101,19,15,4,24
S01012199,581,48,17,31,109,102,38,83,99,80,8,5,3,14
S01012200,522,50,12,38,125,82,43,46,90,73,9,1,8,4
S01012201,618,37,9,28,167,82,25,98,98,83,16,2,14,12
S01012202,488,63,17,46,140,68,22,72,70,48,0,0,0,5
S01012203,596,85,35,50,218,86,65,54,44,34,4,2,2,6
S01012204,726,96,26,70,254,128,57,98,50,35,3,1,2,5
S01012205,588,102,25,77,184,81,78,55,52,23,7,6,1,6
S01012206,742,87,21,66,234,83,68,85,108,68,7,0,7,2
S01012207,725,39,17,22,160,98,58,85,158,88,19,15,4,20
S01012208,822,39,3,36,208,127,77,110,123,101,22,6,16,15
S01012209,603,53,11,42,144,101,41,69,110,62,12,4,8,11
S01012210,550,30,8,22,119,107,45,92,62,72,10,9,1,13
S01012211,739,93,29,64,213,110,75,69,88,59,13,6,7,19
S01012212,583,120,36,84,226,101,15,51,46,21,3,0,3,0
S01012213,659,107,26,81,209,113,58,59,66,43,4,0,4,0
S01012214,525,101,29,72,211,86,48,24,39,12,2,0,2,2
S01012215,704,158,32,126,290,76,38,71,45,18,6,3,3,2
S01012216,589,168,44,124,177,66,74,34,32,27,8,5,3,3
S01012217,492,9,0,9,61,68,17,54,87,116,48,30,18,32
S01012218,428,8,0,8,74,23,18,52,97,90,47,21,26,19
S01012219,579,33,15,18,78,83,34,59,120,113,42,25,17,17
S01012220,460,7,0,7,50,55,31,54,98,99,63,32,31,3
S01012221,419,9,5,4,58,47,36,67,50,108,40,17,23,4
S01012222,568,15,8,7,84,72,27,92,86,143,27,17,10,22
S01012223,529,29,15,14,80,65,37,56,100,108,39,19,20,15
S01012224,648,48,12,36,108,94,42,80,117,105,33,26,7,21
S01012225,878,31,5,26,155,91,58,116,173,201,45,33,12,8
S01012226,585,35,14,21,117,103,41,87,101,93,5,1,4,3
S01012227,551,24,6,18,123,90,28,65,100,94,21,6,15,6
S01012228,582,61,10,51,108,97,46,71,70,97,15,7,8,17
S01012229,587,108,25,83,187,92,57,61,24,38,9,2,7,11
S01012230,777,180,41,139,239,155,68,54,48,19,6,1,5,8
S01012231,742,213,54,159,259,68,86,45,37,25,5,1,4,4
S01012232,763,200,31,169,268,94,51,57,50,40,3,0,3,0
S01012233,789,220,55,165,283,86,49,52,46,41,8,5,3,4
S01012234,957,270,75,195,359,75,97,56,44,52,1,1,0,3
S01012235,307,94,38,56,114,40,24,13,10,11,0,0,0,1
S01012236,477,85,22,63,131,83,23,58,39,48,4,1,3,6
S01012237,630,216,58,158,246,48,67,17,8,12,2,0,2,14
S01012238,474,79,23,56,126,45,47,47,36,73,15,7,8,6
S01012239,476,33,9,24,70,46,53,52,97,94,24,13,11,7
S01012240,622,104,14,90,156,49,53,74,76,74,28,10,18,8
S01012241,470,190,27,163,130,36,47,27,16,18,3,0,3,3
S01012242,641,183,24,159,239,65,60,41,19,20,1,0,1,13
S01012243,515,142,34,108,144,67,45,31,36,40,4,4,0,6
S01012244,764,265,44,221,240,37,130,25,36,23,6,1,5,2
S01012245,554,179,29,150,149,42,80,35,30,29,6,1,5,4
S01012246,700,224,50,174,243,39,85,35,46,23,5,0,5,0
S01012247,582,147,27,120,179,43,64,64,55,25,4,2,2,1
S01012248,695,171,34,137,157,51,158,53,56,24,16,9,7,9
S01012249,706,169,32,137,161,31,155,57,90,28,11,4,7,4
S01012250,537,87,31,56,155,52,131,20,53,30,4,0,4,5
S01012251,755,72,7,65,157,71,69,106,145,107,22,5,17,6
S01012252,583,60,13,47,129,56,83,54,95,76,25,5,20,5
S01012253,644,90,1,89,152,57,83,52,84,104,15,5,10,7
S01012254,673,95,16,79,217,40,81,86,90,53,6,2,4,5
S01012255,578,124,17,107,141,45,79,53,63,51,8,3,5,14
S01012256,731,155,43,112,240,96,59,41,59,57,17,2,15,7
S01012257,705,93,23,70,183,61,56,69,101,125,16,6,10,1
S01012258,593,209,26,183,239,46,48,15,18,14,3,0,3,1
S01012259,388,122,18,104,132,21,55,9,23,22,4,0,4,0
S01012260,642,136,38,98,150,49,107,54,67,64,15,5,10,0
S01012261,767,187,45,142,274,79,73,41,60,35,13,4,9,5
S01012262,663,154,35,119,151,57,160,47,55,28,10,1,9,1
S01012263,570,18,6,12,111,41,125,49,109,100,14,2,12,3
S01012264,355,88,11,77,100,20,47,16,49,32,3,0,3,0
S01012265,640,36,9,27,96,49,82,105,126,134,9,2,7,3
S01012266,769,98,20,78,203,97,116,79,83,67,22,8,14,4
S01012267,537,133,31,102,154,44,87,42,41,34,2,0,2,0
S01012268,516,88,8,80,132,16,159,21,51,36,9,2,7,4
S01012269,732,104,17,87,182,83,112,75,80,88,8,2,6,0
S01012270,616,52,22,30,139,65,83,52,105,97,16,11,5,7
S01012271,871,135,25,110,235,57,238,68,82,33,17,8,9,6
S01012272,602,143,29,114,203,65,67,37,57,21,9,1,8,0
S01012273,529,100,24,76,160,65,87,36,52,17,5,2,3,7
S01012274,793,87,18,69,203,88,91,78,105,103,24,15,9,14
S01012275,699,48,12,36,132,64,47,71,101,100,32,14,18,104
S01012276,770,84,24,60,218,81,84,83,97,90,16,6,10,17
S01012277,897,59,20,39,203,118,106,93,118,138,38,10,28,24
S01012278,530,45,16,29,107,52,66,41,79,69,15,6,9,56
S01012279,679,37,9,28,156,76,37,106,110,96,28,19,9,33
S01012280,799,40,6,34,141,103,67,82,145,150,53,11,42,18
S01012281,551,24,16,8,122,62,52,70,116,77,13,11,2,15
S01012282,646,113,33,80,192,67,92,48,55,47,15,4,11,17
S01012283,709,122,48,74,193,69,92,47,52,95,23,1,22,16
S01012284,590,56,12,44,85,55,57,47,106,90,60,25,35,34
S01012285,374,46,11,35,132,37,40,27,42,43,5,4,1,2
S01012286,858,46,8,38,132,65,76,98,156,162,44,14,30,79
S01012287,829,18,7,11,120,55,58,50,216,229,69,29,40,14
S01012288,633,20,9,11,65,56,59,46,140,162,59,20,39,26
S01012289,567,169,22,147,154,47,89,27,31,16,19,14,5,15
S01012290,425,52,13,39,103,42,57,30,57,69,10,6,4,5
S01012291,830,166,41,125,262,88,100,57,63,77,17,10,7,0
S01012292,458,145,28,117,133,37,85,16,31,8,1,1,0,2
S01012293,381,44,10,34,103,44,45,47,44,46,6,2,4,2
S01012294,751,52,19,33,189,122,70,71,107,111,23,14,9,6
S01012295,688,68,15,53,218,95,102,57,64,58,25,12,13,1
S01012296,813,160,34,126,290,59,111,89,63,31,2,2,0,8
S01012297,472,102,28,74,111,29,174,12,26,12,5,0,5,1
S01012298,614,121,22,99,175,50,119,36,57,51,5,0,5,0
S01012299,521,108,15,93,132,29,108,61,58,24,1,1,0,0
S01012300,506,39,16,23,103,23,102,56,106,56,11,4,7,10
S01012301,765,100,22,78,188,50,161,69,107,64,26,9,17,0
S01012302,470,63,15,48,106,17,103,59,70,43,9,0,9,0
S01012303,708,115,25,90,182,42,175,55,100,34,5,2,3,0
S01012304,762,106,21,85,182,53,154,49,90,112,9,0,9,7
S01012305,501,49,17,32,131,49,100,33,74,45,19,17,2,1
S01012306,413,23,17,6,74,17,60,55,97,69,16,5,11,2
S01012307,460,58,17,41,88,32,40,51,80,97,14,8,6,0
S01012308,693,50,21,29,139,58,101,95,124,123,1,1,0,2
S01012309,383,47,20,27,97,32,74,34,45,46,8,2,6,0
S01012310,640,77,13,64,162,27,195,29,89,48,9,3,6,4
S01012311,380,47,14,33,110,29,55,41,59,36,3,1,2,0
S01012312,763,61,10,51,185,59,204,65,113,56,10,6,4,10
S01012313,599,88,31,57,116,34,116,81,88,66,4,0,4,6
S01012314,649,36,12,24,84,33,106,75,135,154,26,11,15,0
S01012315,479,15,6,9,84,37,73,70,86,75,22,15,7,17
S01012316,448,18,13,5,64,29,59,63,100,101,14,1,13,0
S01012317,466,19,10,9,125,45,76,48,83,47,10,0,10,13
S01012318,676,16,8,8,110,26,74,108,146,169,25,21,4,2
S01012319,604,86,19,67,98,38,148,48,105,68,6,0,6,7
S01012320,552,22,12,10,95,26,84,69,135,87,34,22,12,0
S01012321,594,83,28,55,120,44,74,76,117,55,11,2,9,14
S01012322,726,88,26,62,177,70,188,58,70,60,15,6,9,0
S01012323,613,108,33,75,130,44,157,51,61,47,15,6,9,0
S01012324,590,85,33,52,126,27,162,58,62,67,3,3,0,0
S01012325,330,39,15,24,38,47,30,30,57,75,13,2,11,1
S01012326,382,13,1,12,51,41,59,49,85,56,27,2,25,1
S01012327,586,33,10,23,103,43,95,75,95,129,10,7,3,3
S01012328,320,50,19,31,75,26,44,27,40,49,9,1,8,0
S01012329,599,73,24,49,93,29,174,79,99,38,11,8,3,3
S01012330,409,52,25,27,99,32,55,48,52,62,0,0,0,9
S01012331,538,84,33,51,162,57,66,51,53,60,4,1,3,1
S01012332,750,95,21,74,169,43,196,103,88,44,11,2,9,1
S01012333,743,71,19,52,166,52,179,60,117,74,22,10,12,2
S01012334,586,24,4,20,100,51,85,95,114,100,17,3,14,0
S01012335,833,63,41,22,180,86,86,114,139,132,30,7,23,3
S01012336,407,10,4,6,71,33,51,67,73,91,7,4,3,4
S01012337,606,26,10,16,97,40,64,118,125,88,38,20,18,10
S01012338,472,48,7,41,130,29,67,59,74,47,12,2,10,6
S01012339,401,42,9,33,66,41,40,59,70,56,16,5,11,11
S01012340,780,67,27,40,180,71,108,116,123,100,15,8,7,0
S01012341,753,89,30,59,160,46,246,47,91,65,9,2,7,0
S01012342,661,64,24,40,153,63,142,63,89,80,3,3,0,4
S01012343,757,73,24,49,200,36,200,59,102,62,22,6,16,3
S01012344,462,17,2,15,82,55,50,44,90,102,14,7,7,8
S01012345,547,47,14,33,142,35,97,88,45,69,5,4,1,19
S01012346,598,89,13,76,108,27,179,38,69,65,8,5,3,15
S01012347,571,83,35,48,139,73,89,49,60,63,15,1,14,0
S01012348,523,91,27,64,155,68,75,37,29,54,8,5,3,6
S01012349,688,32,13,19,94,37,62,102,136,199,22,9,13,4
S01012350,575,56,28,28,94,40,88,58,106,113,14,2,12,6
S01012351,689,42,14,28,110,54,89,102,143,125,13,3,10,11
S01012352,558,57,22,35,113,33,104,61,88,86,10,4,6,6
S01012353,554,41,13,28,94,68,76,78,79,83,22,11,11,13
S01012354,505,23,3,20,109,29,104,55,58,111,10,3,7,6
S01012355,679,97,37,60,141,29,227,37,84,63,0,0,0,1
S01012356,461,48,10,38,93,47,92,60,54,63,4,2,2,0
S01012357,605,77,17,60,146,36,226,25,63,27,4,0,4,1
S01012358,566,76,14,62,98,15,224,25,38,81,9,5,4,0
S01012359,623,16,11,5,64,50,50,72,117,183,60,37,23,11
S01012360,712,22,3,19,65,60,38,60,228,165,66,41,25,8
S01012361,545,8,4,4,67,20,63,69,124,141,47,8,39,6
S01012362,758,15,8,7,93,42,68,74,166,220,68,35,33,12
S01012363,710,30,10,20,100,55,95,85,116,133,54,31,23,42
S01012364,503,22,9,13,107,57,69,55,78,91,15,7,8,9
S01012365,693,48,23,25,156,78,100,87,85,126,11,7,4,2
S01012366,613,37,13,24,117,56,61,58,107,152,21,10,11,4
S01012367,650,61,19,42,147,65,77,62,88,129,14,4,10,7
S01012368,414,64,24,40,106,43,61,35,41,56,4,1,3,4
S01012369,659,65,29,36,164,53,114,66,82,101,12,5,7,2
S01012370,691,67,18,49,107,65,94,49,96,184,11,3,8,18
S01012371,667,29,11,18,111,58,52,73,131,179,29,17,12,5
S01012372,528,19,2,17,85,46,61,51,106,115,35,19,16,10
S01012373,743,67,20,47,148,76,83,52,93,184,34,18,16,6
S01012374,736,30,17,13,124,71,120,75,152,152,5,3,2,7
S01012375,732,30,8,22,116,66,56,88,121,220,33,7,26,2
S01012376,758,150,37,113,186,62,160,56,59,69,10,0,10,6
S01012377,524,110,39,71,122,36,114,28,55,39,8,6,2,12
S01012378,435,45,4,41,97,22,133,39,53,41,4,2,2,1
S01012379,404,47,18,29,114,35,74,50,48,23,4,0,4,9
S01012380,749,33,13,20,178,94,110,94,99,124,13,1,12,4
S01012381,578,41,10,31,106,58,85,47,114,107,13,4,9,7
S01012382,749,73,29,44,207,117,128,72,60,79,6,6,0,7
S01012383,582,56,12,44,127,56,75,70,72,110,8,3,5,8
S01012384,398,43,13,30,99,42,40,39,57,65,10,5,5,3
S01012385,578,58,10,48,185,73,80,56,70,38,9,4,5,9
S01012386,819,54,9,45,95,100,74,77,170,194,49,20,29,6
S01012387,754,41,17,24,178,77,107,154,105,78,10,1,9,4
S01012388,573,84,26,58,182,34,66,77,58,66,0,0,0,6
S01012389,785,89,43,46,232,66,99,86,109,94,8,3,5,2
S01012390,643,89,21,68,168,44,67,71,99,105,0,0,0,0
S01012391,987,123,47,76,312,112,108,130,101,86,8,5,3,7
S01012392,688,75,25,50,195,71,50,93,111,83,8,5,3,2
S01012393,764,71,21,50,216,50,90,104,91,135,5,2,3,2
S01012394,549,34,5,29,111,51,29,77,106,111,20,6,14,10
S01012395,473,28,7,21,113,48,50,57,89,84,4,0,4,0
S01012396,504,23,6,17,109,36,53,100,86,85,11,9,2,1
S01012397,604,65,15,50,172,49,48,79,95,85,5,4,1,6
S01012398,706,81,16,65,163,80,47,84,105,135,8,5,3,3
S01012399,486,33,8,25,88,48,28,72,103,108,3,2,1,3
S01012400,493,15,9,6,80,27,68,88,84,116,10,3,7,5
S01012401,642,33,7,26,125,46,54,115,113,133,17,7,10,6
S01012402,416,29,7,22,105,31,77,60,50,54,5,0,5,5
S01012403,851,83,25,58,206,88,137,101,105,123,4,4,0,4
S01012404,793,37,9,28,225,57,83,113,127,133,10,3,7,8
S01012405,638,93,37,56,174,50,90,94,57,77,0,0,0,3
S01012406,519,64,11,53,126,23,80,82,44,87,9,0,9,4
S01012407,684,86,8,78,150,49,123,93,84,87,10,3,7,2
S01012408,539,44,19,25,118,31,128,89,68,54,0,0,0,7
S01012409,545,50,22,28,118,19,87,53,83,126,7,5,2,2
S01012410,908,86,19,67,266,68,82,168,141,87,7,0,7,3
S01012411,841,54,14,40,147,81,79,165,137,157,12,8,4,9
S01012412,519,41,4,37,102,34,77,103,85,70,7,1,6,0
S01012413,708,44,9,35,213,22,83,119,111,107,3,3,0,6
S01012414,509,30,9,21,112,28,93,74,91,71,3,1,2,7
S01012415,443,6,0,6,69,16,199,40,50,58,0,0,0,5
S01012416,416,13,2,11,94,11,137,35,60,64,2,0,2,0
S01012417,429,17,3,14,79,26,87,55,97,55,10,6,4,3
S01012418,555,36,16,20,105,46,161,59,78,51,11,4,7,8
S01012419,560,42,13,29,70,30,220,75,65,35,23,4,19,0
S01012420,671,38,20,18,90,47,70,101,160,134,26,13,13,5
S01012421,508,26,4,22,116,31,111,69,65,77,11,6,5,2
S01012422,653,80,27,53,132,43,127,56,108,72,24,5,19,11
S01012423,633,58,12,46,152,49,128,63,69,96,13,2,11,5
S01012424,780,39,9,30,72,72,58,148,179,161,40,16,24,11
S01012425,472,3,1,2,42,30,28,56,119,139,41,29,12,14
S01012426,401,0,0,0,31,41,40,73,88,86,33,15,18,9
S01012427,543,10,0,10,59,25,28,60,156,152,39,20,19,14
S01012428,500,21,6,15,46,60,46,67,115,130,12,9,3,3
S01012429,406,18,2,16,72,46,37,51,100,64,13,9,4,5
S01012430,403,27,9,18,90,35,41,66,67,65,12,11,1,0
S01012431,614,66,16,50,140,45,115,72,89,57,23,12,11,7
S01012432,479,22,0,22,106,47,51,41,80,103,13,5,8,16
S01012433,351,11,0,11,59,32,32,53,69,77,16,9,7,2
S01012434,556,22,3,19,106,61,37,59,119,107,36,9,27,9
S01012435,539,21,2,19,80,74,50,67,114,107,22,4,18,4
S01012436,613,25,8,17,73,49,54,93,148,107,53,19,34,11
S01012437,569,26,13,13,92,66,52,107,91,106,24,17,7,5
S01012438,610,28,6,22,150,57,75,97,87,92,22,6,16,2
S01012439,613,32,6,26,135,58,56,92,87,95,37,14,23,21
S01012440,410,43,11,32,115,34,65,62,36,50,2,0,2,3
S01012441,706,78,8,70,160,32,185,85,88,64,14,7,7,0
S01012442,771,102,31,71,249,57,140,46,100,51,21,13,8,5
S01012443,606,68,22,46,156,61,123,75,52,46,21,6,15,4
S01012444,517,87,16,71,197,42,85,38,36,24,7,5,2,1
S01012445,484,161,24,137,147,23,51,25,29,34,9,6,3,5
S01012446,369,27,12,15,72,49,38,33,62,74,12,6,6,2
S01012447,665,84,19,65,238,80,75,78,58,49,3,0,3,0
S01012448,788,93,24,69,249,120,102,95,61,28,27,10,17,13
S01012449,466,57,9,48,102,66,45,56,56,79,5,0,5,0
S01012450,676,87,5,82,208,38,132,55,64,60,26,21,5,6
S01012451,529,142,27,115,212,40,59,15,38,13,10,5,5,0
S01012452,398,48,9,39,155,63,29,38,44,14,1,1,0,6
S01012453,638,184,58,126,274,19,95,16,32,18,0,0,0,0
S01012454,422,84,14,70,174,52,37,24,30,16,5,3,2,0
S01012455,440,151,20,131,138,38,57,19,9,16,7,0,7,5
S01012456,533,179,71,108,211,25,59,39,10,3,7,4,3,0
S01012457,522,157,42,115,205,37,51,26,25,11,5,0,5,5
S01012458,575,171,41,130,217,35,83,13,29,11,10,3,7,6
S01012459,622,106,23,83,206,78,85,43,51,50,3,0,3,0
S01012460,360,54,6,48,157,50,39,25,15,16,0,0,0,4
S01012461,406,36,1,35,128,42,41,33,48,59,13,11,2,6
S01012462,572,15,1,14,141,47,42,61,114,100,39,23,16,13
S01012463,474,24,4,20,92,34,50,47,101,84,42,13,29,0
S01012464,564,23,5,18,107,54,43,60,103,104,47,17,30,23
S01012465,594,17,5,12,110,49,52,79,137,115,22,5,17,13
S01012466,576,47,11,36,196,59,95,34,45,49,32,25,7,19
S01012467,555,23,2,21,150,88,67,61,83,59,3,0,3,21
S01012468,596,41,7,34,158,79,64,92,75,61,23,1,22,3
S01012469,562,164,35,129,225,54,60,27,21,10,0,0,0,1
S01012470,688,61,18,43,175,73,43,80,123,92,35,21,14,6
S01012471,552,152,36,116,190,48,88,33,25,12,0,0,0,4
S01012472,461,72,13,59,177,68,40,45,39,15,5,5,0,0
S01012473,416,101,21,80,123,31,33,54,37,29,3,0,3,5
S01012474,492,67,9,58,155,44,40,62,60,48,11,6,5,5
S01012475,418,70,15,55,139,49,24,67,41,24,3,0,3,1
S01012476,727,21,5,16,164,100,73,107,125,97,27,17,10,13
S01012477,536,82,20,62,166,76,46,54,45,58,4,2,2,5
S01012478,659,33,11,22,151,98,56,71,143,93,10,7,3,4
S01012479,599,101,16,85,169,68,65,93,56,47,0,0,0,0
S01012480,427,54,15,39,116,47,38,36,40,60,13,6,7,23
S01012481,640,53,8,45,160,73,56,68,103,63,27,17,10,37
S01012482,458,85,11,74,124,59,56,29,47,27,22,7,15,9
S01012483,669,51,9,42,153,31,50,91,133,91,39,21,18,30
S01012484,600,204,64,140,193,30,62,39,29,20,16,10,6,7
S01012485,587,155,34,121,201,59,82,30,30,16,9,6,3,5
S01012486,292,81,20,61,119,12,39,7,16,11,0,0,0,7
S01012487,495,41,2,39,133,50,54,56,67,77,16,2,14,1
S01012488,669,54,13,41,161,86,55,70,123,65,43,26,17,12
S01012489,908,31,4,27,118,62,52,116,186,211,102,61,41,30
S01012490,787,35,9,26,133,82,51,94,157,145,64,33,31,26
S01012491,387,4,1,3,25,27,20,29,101,115,57,27,30,9
S01012492,616,13,6,7,87,59,36,79,123,108,81,41,40,30
S01012493,392,53,7,46,113,38,30,37,49,53,13,8,5,6
S01012494,652,16,2,14,161,53,61,97,151,89,18,11,7,6
S01012495,818,26,10,16,121,107,57,92,178,162,48,21,27,27
S01012496,601,29,10,19,60,52,35,84,153,126,42,23,19,20
S01012497,383,7,5,2,31,30,28,91,77,90,24,19,5,5
S01012498,738,12,5,7,75,31,26,106,175,204,91,52,39,18
S01012499,631,30,12,18,58,78,52,65,124,157,41,25,16,26
S01012500,399,3,0,3,46,51,34,47,84,90,36,25,11,8
S01012501,556,9,2,7,56,21,2,71,164,140,80,49,31,13
S01012502,752,8,0,8,80,46,63,66,177,174,110,70,40,28
S01012503,504,18,1,17,52,34,36,81,127,99,50,21,29,7
S01012504,525,16,7,9,75,31,32,79,131,99,54,9,45,8
S01012505,805,33,20,13,134,100,85,98,150,136,62,28,34,7
S01012506,334,34,10,24,96,27,37,40,48,33,12,5,7,7
S01012507,716,48,10,38,144,113,67,70,135,97,36,17,19,6
S01012508,594,55,14,41,138,60,48,83,111,51,39,19,20,9
S01012509,410,46,4,42,118,41,82,47,38,30,8,6,2,0
S01012510,721,49,6,43,189,101,49,109,98,88,27,5,22,11
S01012511,499,39,6,33,139,71,27,65,103,43,6,5,1,6
S01012512,575,74,29,45,127,37,43,72,98,66,52,21,31,6
S01012513,465,77,25,52,145,66,36,43,67,26,4,2,2,1
S01012514,930,132,35,97,296,145,55,120,95,66,3,0,3,18
S01012515,442,24,9,15,74,50,48,49,99,73,17,7,10,8
S01012516,509,66,20,46,144,50,52,64,56,44,33,15,18,0
S01012517,716,70,19,51,187,66,69,78,128,76,26,16,10,16
S01012518,414,70,11,59,124,48,52,49,28,23,13,3,10,7
S01012519,365,33,9,24,66,53,62,53,33,48,12,4,8,5
S01012520,561,155,38,117,196,49,37,49,38,22,15,5,10,0
S01012521,400,59,8,51,123,49,51,29,37,37,12,7,5,3
S01012522,626,116,15,101,210,53,117,63,31,23,11,2,9,2
S01012523,645,106,16,90,211,87,65,67,35,59,11,3,8,4
S01012524,537,67,18,49,182,76,64,54,57,33,2,1,1,2
S01012525,551,71,18,53,198,68,42,65,52,42,8,2,6,5
S01012526,557,106,16,90,248,45,62,50,29,13,4,0,4,0
S01012527,429,53,9,44,126,42,70,41,51,38,7,4,3,1
S01012528,673,63,18,45,111,73,54,109,121,109,20,13,7,13
S01012529,557,64,15,49,159,49,49,81,67,64,14,9,5,10
S01012530,568,63,10,53,189,66,50,106,28,57,6,2,4,3
S01012531,615,111,22,89,145,81,60,66,50,78,12,9,3,12
S01012532,625,70,26,44,161,54,96,61,95,64,18,4,14,6
S01012533,386,41,13,28,118,47,43,50,38,24,14,7,7,11
S01012534,432,21,9,12,103,81,24,58,77,46,19,9,10,3
S01012535,658,31,10,21,135,64,72,106,118,118,5,2,3,9
S01012536,618,25,3,22,109,49,60,63,94,170,24,15,9,24
S01012537,530,16,3,13,77,36,45,88,100,110,27,8,19,31
S01012538,860,50,31,19,150,111,87,124,169,123,33,12,21,13
S01012539,551,34,15,19,115,33,113,75,98,68,8,2,6,7
S01012540,581,25,2,23,66,40,63,99,133,110,39,12,27,6
S01012541,869,80,15,65,177,70,197,92,147,78,17,5,12,11
S01012542,645,102,24,78,199,39,89,80,64,60,8,2,6,4
S01012543,582,115,14,101,156,59,118,39,49,38,6,0,6,2
S01012544,674,89,23,66,200,61,91,64,82,55,21,11,10,11
S01012545,377,26,14,12,87,25,46,49,56,68,17,0,17,3
S01012546,670,56,7,49,145,79,77,96,114,79,16,3,13,8
S01012547,545,114,20,94,142,59,69,48,52,21,31,19,12,9
S01012548,590,132,38,94,180,57,58,61,51,40,6,2,4,5
S01012549,455,27,2,25,99,52,24,48,84,92,29,14,15,0
S01012550,657,62,19,43,201,61,58,76,71,89,36,4,32,3
S01012551,646,89,18,71,232,91,74,72,41,34,12,4,8,1
S01012552,723,155,26,129,251,87,69,71,49,35,0,0,0,6
S01012553,766,155,18,137,257,111,63,63,74,37,6,3,3,0
S01012554,373,57,15,42,118,37,43,52,46,9,8,3,5,3
S01012555,462,77,18,59,164,56,32,61,44,17,4,2,2,7
S01012556,422,89,26,63,154,43,42,37,27,27,3,0,3,0
S01012557,458,100,12,88,144,44,32,42,38,45,10,10,0,3
S01012558,481,26,4,22,110,61,40,73,78,69,24,9,15,0
S01012559,540,30,11,19,115,59,41,90,102,68,27,10,17,8
S01012560,390,52,10,42,98,53,23,48,52,52,12,7,5,0
S01012561,592,70,17,53,193,64,47,62,75,53,21,11,10,7
S01012562,590,40,6,34,135,73,41,106,77,72,24,12,12,22
S01012563,405,108,27,81,169,29,54,16,16,6,0,0,0,7
S01012564,575,132,38,94,214,39,79,41,49,12,2,2,0,7
S01012565,527,143,29,114,173,44,57,37,41,28,2,2,0,2
S01012566,524,67,16,51,150,35,66,46,71,53,24,9,15,12
S01012567,803,92,28,64,182,80,92,103,112,85,47,18,29,10
S01012568,431,107,27,80,157,25,74,16,23,13,14,8,6,2
S01012569,498,170,23,147,144,28,107,11,20,11,5,0,5,2
S01012570,382,59,6,53,76,21,71,67,35,42,9,1,8,2
S01012571,666,50,5,45,132,39,156,79,93,96,14,5,9,7
S01012572,422,52,10,42,83,20,91,31,63,56,15,3,12,11
S01012573,687,165,29,136,156,29,191,59,47,34,6,4,2,0
S01012574,694,120,37,83,224,53,127,75,35,47,3,0,3,10
S01012575,506,86,13,73,121,48,71,47,89,38,3,0,3,3
S01012576,544,111,25,86,164,40,81,48,41,49,3,0,3,7
S01012577,611,73,13,60,141,42,130,63,69,77,11,3,8,5
S01012578,660,107,29,78,198,31,105,59,61,85,11,3,8,3
S01012579,614,106,21,85,119,38,104,62,88,56,33,5,28,8
S01012580,644,122,32,90,173,30,131,59,49,60,20,8,12,0
S01012581,638,27,2,25,93,83,59,75,103,122,66,22,44,10
S01012582,783,114,33,81,241,74,149,50,83,52,10,6,4,10
S01012583,553,51,18,33,103,38,57,74,103,106,19,9,10,2
S01012584,575,60,5,55,154,61,94,50,51,77,15,12,3,13
S01012585,676,34,11,23,141,43,71,102,87,149,42,11,31,7
S01012586,708,103,24,79,205,33,129,95,46,81,8,3,5,8
S01012587,735,108,25,83,224,54,168,76,29,68,3,3,0,5
S01012588,535,101,31,70,119,61,94,41,47,62,6,1,5,4
S01012589,556,26,8,18,95,58,44,94,79,140,17,11,6,3
S01012590,623,53,10,43,94,60,39,75,106,150,46,28,18,0
S01012591,543,23,8,15,72,62,21,55,118,137,53,26,27,2
S01012592,488,99,23,76,182,67,65,23,25,15,12,2,10,0
S01012593,732,121,18,103,243,81,56,77,53,93,8,2,6,0
S01012594,379,31,10,21,99,46,30,42,48,72,8,3,5,3
S01012595,492,32,6,26,117,41,63,69,69,82,16,6,10,3
S01012596,670,44,16,28,133,77,51,68,89,157,42,20,22,9
S01012597,430,52,0,52,126,46,40,71,32,44,19,12,7,0
S01012598,543,110,23,87,164,67,51,60,46,35,9,4,5,1
S01012599,501,97,22,75,138,64,46,38,35,55,21,10,11,7
S01012600,601,79,29,50,213,114,43,46,58,44,3,2,1,1
S01012601,769,124,19,105,254,106,66,84,62,63,10,4,6,0
S01012602,413,42,5,37,101,44,23,56,38,78,27,17,10,4
S01012603,486,23,6,17,110,60,38,40,71,107,31,13,18,6
S01012604,524,46,14,32,115,33,29,54,71,141,33,14,19,2
S01012605,373,28,10,18,79,44,32,53,63,58,11,4,7,5
S01012606,760,172,24,148,319,80,50,56,49,30,4,0,4,0
S01012607,620,57,9,48,182,59,72,62,85,67,33,6,27,3
S01012608,649,32,5,27,136,61,52,75,88,179,21,10,11,5
S01012609,677,14,3,11,111,69,37,85,137,181,39,16,23,4
S01012610,788,61,21,40,138,83,58,106,129,141,67,45,22,5
S01012611,640,82,12,70,186,67,55,68,78,93,8,5,3,3
S01012612,611,38,11,27,112,78,57,80,72,122,44,21,23,8
S01012613,563,29,3,26,124,57,40,57,93,127,25,10,15,11
S01012614,802,76,21,55,220,103,53,76,137,89,30,12,18,18
S01012615,509,132,34,98,156,42,66,27,39,31,13,6,7,3
S01012616,745,144,42,102,172,70,128,69,77,71,14,10,4,0
S01012617,322,40,15,25,102,31,65,36,16,24,4,4,0,4
S01012618,465,51,8,43,125,41,57,49,51,71,17,12,5,3
S01012619,381,34,7,27,72,47,39,40,45,62,35,23,12,7
S01012620,557,139,22,117,197,60,63,43,27,19,9,5,4,0
S01012621,390,63,18,45,129,50,40,23,40,35,10,1,9,0
S01012622,581,52,7,45,135,64,56,76,106,74,17,4,13,1
S01012623,509,41,8,33,84,55,50,58,110,91,20,11,9,0
S01012624,567,44,11,33,101,81,65,62,92,92,21,10,11,9
S01012625,413,17,3,14,103,49,51,56,56,66,15,13,2,0
S01012626,355,48,9,39,99,49,34,33,45,37,6,5,1,4
S01012627,442,64,16,48,91,56,42,38,57,61,31,15,16,2
S01012628,795,199,41,158,273,61,83,55,65,52,7,2,5,0
S01012629,382,98,39,59,134,53,45,25,17,7,3,2,1,0
S01012630,524,69,12,57,122,50,59,47,65,72,30,16,14,10
S01012631,801,52,10,42,220,67,47,79,132,139,58,35,23,7
S01012632,594,67,6,61,142,67,164,56,38,55,3,3,0,2
S01012633,546,88,22,66,142,12,145,62,59,21,17,9,8,0
S01012634,529,45,11,34,103,54,54,43,96,97,28,16,12,9
S01012635,865,125,20,105,262,82,104,101,107,64,18,0,18,2
S01012636,491,47,9,38,143,28,98,38,72,56,7,4,3,2
S01012637,715,29,5,24,62,88,68,86,140,197,43,17,26,2
S01012638,662,46,20,26,109,54,64,79,128,143,31,13,18,8
S01012639,682,50,10,40,115,53,80,71,122,165,26,12,14,0
S01012640,740,9,2,7,92,58,98,78,129,167,94,38,56,15
S01012641,713,33,18,15,136,63,78,107,145,113,31,8,23,7
S01012642,644,16,4,12,52,37,44,84,153,178,77,39,38,3
S01012643,379,4,0,4,74,36,19,48,69,100,25,11,14,4
S01012644,568,36,5,31,105,48,45,70,127,100,37,25,12,0
S01012645,624,78,20,58,137,67,87,63,63,106,22,7,15,1
S01012646,816,101,22,79,235,62,128,99,78,85,21,15,6,7
S01012647,718,112,24,88,203,82,70,64,70,97,14,4,10,6
S01012648,443,12,2,10,69,24,27,28,128,123,24,11,13,8
S01012649,521,68,20,48,90,48,53,63,91,81,19,12,7,8
S01012650,471,71,19,52,114,56,80,41,43,61,5,3,2,0
S01012651,508,12,0,12,56,47,37,63,97,132,50,30,20,14
S01012652,875,162,51,111,257,111,61,93,62,112,8,0,8,9
S01012653,776,43,9,34,159,51,104,73,131,146,64,35,29,5
S01012654,638,100,47,53,154,101,90,35,61,75,17,3,14,5
S01012655,834,53,26,27,148,99,135,66,145,136,49,38,11,3
S01012656,618,28,0,28,118,51,60,87,76,143,49,30,19,6
S01012657,403,19,0,19,71,69,28,37,73,85,15,6,9,6
S01012658,726,92,22,70,238,100,82,80,65,56,7,5,2,6
S01012659,993,160,32,128,398,102,89,101,58,60,13,0,13,12
S01012660,584,79,10,69,113,56,45,68,110,91,20,4,16,2
S01012661,576,80,20,60,126,79,77,79,55,57,18,8,10,5
S01012662,540,28,9,19,90,56,61,64,109,104,21,17,4,7
S01012663,513,56,15,41,140,69,62,52,50,68,15,4,11,1
S01012664,706,66,11,55,137,65,91,108,108,111,17,3,14,3
S01012665,563,8,2,6,79,51,53,65,129,112,55,33,22,11
S01012666,483,11,8,3,72,42,34,49,110,125,32,9,23,8
S01012667,452,20,2,18,49,42,59,50,99,78,50,16,34,5
S01012668,645,16,5,11,103,71,73,76,94,150,58,27,31,4
S01012669,559,54,15,39,167,94,40,59,59,86,0,0,0,0
S01012670,498,64,13,51,139,80,39,68,46,56,4,1,3,2
S01012671,749,23,2,21,111,69,68,131,148,168,30,6,24,1
S01012672,584,10,5,5,57,63,35,87,121,166,39,14,25,6
S01012673,493,9,0,9,47,50,27,61,137,123,32,7,25,7
S01012674,496,8,2,6,68,60,20,80,76,104,74,36,38,6
S01012675,633,16,2,14,94,62,37,55,157,154,44,21,23,14
S01012676,731,34,10,24,119,114,73,89,123,147,23,3,20,9
S01012677,471,18,7,11,79,60,46,62,79,103,24,16,8,0
S01012678,633,58,13,45,204,100,64,63,41,99,4,0,4,0
S01012679,605,60,9,51,123,56,78,82,89,101,13,5,8,3
S01012680,471,109,10,99,137,52,36,33,26,54,11,3,8,13
S01012681,568,43,9,34,144,45,114,52,50,93,27,6,21,0
S01012682,515,102,35,67,140,65,72,31,35,57,9,3,6,4
S01012683,663,68,14,54,111,74,60,90,133,90,30,15,15,7
S01012684,462,88,21,67,125,65,56,28,40,45,6,4,2,9
S01012685,662,49,10,39,141,69,61,84,108,110,28,7,21,12
S01012686,755,178,28,150,243,74,90,65,48,32,24,13,11,1
S01012687,331,119,21,98,109,34,34,19,9,4,0,0,0,3
S01012688,577,127,30,97,168,75,41,30,49,56,22,4,18,9
S01012689,387,108,34,74,126,20,54,33,20,26,0,0,0,0
S01012690,428,85,11,74,105,59,28,50,38,59,4,1,3,0
S01012691,625,211,51,160,235,30,72,29,24,14,7,5,2,3
S01012692,558,82,15,67,167,56,65,56,74,43,11,8,3,4
S01012693,811,271,54,217,277,76,81,44,39,20,3,1,2,0
S01012694,390,57,8,49,124,48,33,61,37,23,7,4,3,0
S01012695,702,108,18,90,166,66,150,42,58,94,14,8,6,4
S01012696,575,136,24,112,118,42,178,34,34,31,2,2,0,0
S01012697,399,98,21,77,114,23,81,24,17,33,5,2,3,4
S01012698,575,105,22,83,166,64,120,38,44,24,10,9,1,4
S01012699,874,178,38,140,203,85,189,72,69,52,15,14,1,11
S01012700,668,112,32,80,166,52,122,74,57,73,6,3,3,6
S01012701,409,73,11,62,118,58,59,48,22,26,0,0,0,5
S01012702,481,116,25,91,136,39,55,47,35,42,10,2,8,1
S01012703,569,97,25,72,170,65,68,60,57,39,9,0,9,4
S01012704,669,21,13,8,86,83,70,94,125,129,53,26,27,8
S01012705,737,173,39,134,237,77,88,80,42,40,0,0,0,0
S01012706,576,31,10,21,73,50,46,67,128,146,28,12,16,7
S01012707,772,171,32,139,292,74,89,65,38,23,13,4,9,7
S01012708,590,32,3,29,113,83,49,51,95,119,48,12,36,0
S01012709,375,37,6,31,74,66,18,46,61,54,17,7,10,2
S01012710,537,49,22,27,116,58,56,57,90,84,27,16,11,0
S01012711,597,40,16,24,94,74,40,52,103,136,50,22,28,8
S01012712,637,137,20,117,216,78,80,57,44,10,10,0,10,5
S01012713,521,86,26,60,191,60,60,37,45,40,2,1,1,0
S01012714,391,99,22,77,119,48,30,34,33,20,5,5,0,3
S01012715,508,65,14,51,132,68,45,47,51,66,23,5,18,11
S01012716,569,189,33,156,175,37,82,30,18,14,9,2,7,15
S01012717,655,97,12,85,177,86,63,49,66,72,41,17,24,4
S01012718,723,141,36,105,235,66,72,67,60,64,13,4,9,5
S01012719,627,90,14,76,155,61,59,41,115,61,16,3,13,29
S01012720,452,80,11,69,117,47,39,38,53,43,18,4,14,17
S01012721,487,44,8,36,138,52,36,54,68,83,9,4,5,3
S01012722,570,24,4,20,80,80,30,71,123,113,39,18,21,10
S01012723,532,20,6,14,75,65,55,53,97,106,46,34,12,15
S01012724,540,54,9,45,122,70,63,54,93,66,12,6,6,6
S01012725,726,101,23,78,183,100,73,62,78,88,28,14,14,13
S01012726,442,30,3,27,72,52,62,47,97,55,22,1,21,5
S01012727,587,11,0,11,117,43,30,79,118,122,60,33,27,7
S01012728,730,18,5,13,86,69,37,75,179,168,83,38,45,15
S01012729,716,105,16,89,160,96,66,115,84,66,18,10,8,6
S01012730,463,16,6,10,68,46,24,45,107,136,18,7,11,3
S01012731,650,31,4,27,114,66,50,60,123,174,30,19,11,2
S01012732,539,51,16,35,79,79,38,42,112,102,33,19,14,3
S01012733,1051,218,59,159,365,150,121,81,51,44,7,3,4,14
S01012734,624,181,36,145,233,41,64,51,42,12,0,0,0,0
S01012735,355,18,2,16,61,48,18,62,57,68,20,1,19,3
S01012736,836,84,13,71,222,103,75,104,130,98,18,14,4,2
S01012737,707,79,9,70,176,101,82,80,74,86,15,9,6,14
S01012738,508,10,0,10,90,44,49,65,109,115,23,11,12,3
S01012739,830,200,38,162,281,103,118,54,22,39,7,6,1,6
S01012740,871,153,44,109,288,83,133,69,62,56,15,0,15,12
S01012741,502,89,22,67,164,77,51,33,46,38,1,1,0,3
S01012742,562,104,26,78,185,69,69,49,42,34,6,6,0,4
S01012743,438,73,14,59,116,70,42,64,30,43,0,0,0,0
S01012744,610,133,29,104,173,85,62,52,53,46,6,0,6,0
S01012745,533,100,30,70,147,66,69,51,46,41,9,9,0,4
S01012746,685,96,20,76,184,89,78,71,74,72,12,11,1,9
S01012747,690,63,7,56,118,83,57,76,146,92,43,20,23,12
S01012748,695,14,3,11,76,56,49,80,144,163,94,53,41,19
S01012749,792,4,1,3,114,83,63,97,163,162,95,52,43,11
S01012750,704,24,6,18,59,64,32,74,190,174,69,22,47,18
S01012751,573,31,7,24,96,58,54,89,92,102,40,20,20,11
S01012752,708,60,21,39,137,80,78,81,112,109,34,12,22,17
S01012753,422,20,10,10,64,40,28,44,83,107,33,13,20,3
S01012754,431,28,4,24,84,44,46,45,52,98,21,6,15,13
S01012755,398,19,6,13,67,48,17,38,117,47,40,27,13,5
S01012756,301,19,12,7,66,28,29,38,62,47,12,12,0,0
S01012757,342,12,8,4,47,36,34,39,68,88,13,3,10,5
S01012758,502,38,5,33,127,64,77,36,84,53,20,4,16,3
S01012759,583,20,0,20,84,71,42,73,105,127,48,28,20,13
S01012760,820,41,24,17,145,82,45,77,166,184,67,17,50,13
S01012761,591,46,16,30,94,86,69,67,86,102,38,13,25,3
S01012762,525,38,11,27,90,89,48,79,81,81,10,0,10,9
S01012763,325,21,11,10,64,34,21,23,86,63,11,8,3,2
S01012764,611,44,16,28,88,94,45,74,87,144,29,18,11,6
S01012765,584,43,9,34,142,51,53,66,105,102,18,12,6,4
S01012766,803,62,26,36,120,88,62,130,145,155,34,5,29,7
S01012767,466,40,9,31,113,81,59,50,60,57,6,0,6,0
S01012768,605,60,5,55,146,121,46,94,74,56,8,3,5,0
S01012769,416,93,16,77,153,38,66,30,16,16,4,1,3,0
S01012770,666,30,5,25,166,112,67,89,85,83,24,13,11,10
S01012771,570,73,16,57,138,45,52,44,92,82,37,14,23,7
S01012772,570,3,0,3,67,49,55,68,160,115,49,17,32,4
S01012773,667,56,6,50,123,83,64,69,105,125,34,21,13,8
S01012774,712,51,15,36,155,88,70,71,107,125,37,16,21,8
S01012775,312,21,1,20,69,38,47,42,51,24,19,11,8,1
S01012776,612,25,0,25,92,58,39,73,116,153,48,16,32,8
S01012777,929,82,20,62,267,126,92,158,100,75,18,12,6,11
S01012778,670,42,12,30,140,96,38,74,105,99,54,29,25,22
S01012779,427,21,6,15,82,45,35,51,68,87,30,16,14,8
S01012780,621,25,3,22,80,66,37,57,149,119,74,44,30,14
S01012781,538,40,3,37,156,63,61,54,84,57,13,4,9,10
S01012782,492,8,0,8,42,66,24,53,128,123,41,24,17,7
S01012783,600,8,3,5,87,67,35,73,122,141,59,27,32,8
S01012784,627,27,5,22,97,104,39,70,126,120,30,13,17,14
S01012785,553,3,3,0,56,56,35,68,161,108,62,27,35,4
S01012786,593,13,2,11,67,67,34,67,134,99,82,34,48,30
S01012787,501,55,21,34,153,71,29,34,64,57,15,6,9,23
S01012788,538,24,4,20,75,62,36,89,66,138,41,23,18,7
S01012789,602,78,10,68,102,80,82,78,76,79,21,9,12,6
S01012790,500,132,16,116,144,63,42,32,23,42,6,4,2,16
S01012791,506,107,21,86,178,76,45,32,37,24,2,0,2,5
S01012792,617,58,13,45,160,101,51,49,77,83,22,8,14,16
S01012793,507,19,8,11,94,72,37,39,101,96,31,17,14,18
S01012794,461,90,11,79,158,48,40,31,37,39,12,1,11,6
S01012795,832,30,15,15,106,107,82,59,188,190,50,28,22,20
S01012796,697,49,6,43,154,102,60,64,125,97,35,18,17,11
S01012797,619,35,13,22,125,43,39,55,123,127,59,32,27,13
S01012798,573,211,61,150,148,30,87,24,30,28,6,2,4,9
S01012799,572,192,53,139,170,53,87,28,18,18,5,1,4,1
S01012800,720,211,35,176,264,52,90,20,45,21,7,0,7,10
S01012801,261,89,9,80,81,26,21,7,12,12,5,2,3,8
S01012802,540,216,48,168,137,44,86,35,10,10,1,1,0,1
S01012803,572,142,27,115,200,84,45,43,30,27,1,0,1,0
S01012804,608,57,2,55,137,84,56,67,115,64,18,8,10,10
S01012805,737,48,17,31,132,108,61,47,170,120,34,17,17,17
S01012806,620,85,21,64,199,78,42,49,78,70,16,2,14,3
S01012807,502,155,35,120,167,43,97,26,4,1,5,0,5,4
S01012808,824,210,50,160,226,93,107,46,76,42,16,10,6,8
S01012809,509,101,17,84,135,49,45,42,51,50,22,10,12,14
S01012810,674,71,19,52,116,105,64,51,123,113,15,6,9,16
S01012811,539,81,6,75,159,77,33,67,61,31,19,11,8,11
S01012812,582,79,23,56,142,68,59,64,77,81,9,6,3,3
S01012813,655,220,41,179,207,65,66,51,27,14,1,1,0,4
S01012814,773,86,4,82,247,108,80,73,95,70,12,0,12,2
S01012815,851,137,30,107,231,119,100,94,95,58,10,0,10,7
S01012816,543,53,17,36,152,73,69,51,61,57,27,14,13,0
S01012817,552,131,22,109,136,122,63,31,18,40,11,3,8,0
S01012818,772,113,14,99,260,101,100,87,51,38,15,7,8,7
S01012819,575,29,3,26,79,71,29,70,139,102,53,41,12,3
S01012820,999,132,29,103,268,152,155,100,105,71,10,2,8,6
S01012821,740,110,21,89,209,97,105,79,61,53,26,18,8,0
S01012822,430,18,2,16,50,51,17,53,109,90,33,9,24,9
S01012823,809,90,24,66,181,80,88,157,110,75,28,8,20,0
S01012824,578,43,9,34,163,65,59,39,95,90,13,7,6,11
S01012825,382,29,5,24,59,44,27,34,69,77,28,7,21,15
S01012826,576,18,3,15,84,65,43,35,138,142,32,16,16,19
S01012827,678,88,29,59,208,85,69,81,38,91,18,11,7,0
S01012828,558,67,17,50,208,72,51,50,65,35,3,1,2,7
S01012829,737,36,0,36,83,89,59,60,163,178,67,46,21,2
S01012830,559,36,12,24,105,64,68,84,70,91,40,22,18,1
S01012831,423,16,9,7,89,51,37,43,57,96,18,13,5,16
S01012832,446,44,12,32,76,58,52,47,74,67,26,14,12,2
S01012833,577,30,0,30,56,62,26,55,150,118,71,38,33,9
S01012834,517,46,5,41,87,50,53,46,97,79,49,24,25,10
S01012835,634,73,14,59,174,90,45,59,80,92,19,8,11,2
S01012836,663,110,8,102,180,78,126,76,54,35,1,1,0,3
S01012837,668,9,4,5,48,85,47,64,174,142,90,36,54,9
S01012838,856,31,4,27,92,78,56,86,216,173,112,37,75,12
S01012839,576,53,16,37,153,77,71,84,74,62,2,2,0,0
S01012840,752,139,39,100,238,106,106,50,66,39,6,4,2,2
S01012841,506,74,20,54,129,65,60,81,55,37,0,0,0,5
S01012842,419,54,6,48,123,49,34,47,58,46,4,2,2,4
S01012843,786,207,27,180,279,75,97,28,45,33,16,9,7,6
S01012844,606,190,49,141,215,44,84,20,35,15,3,3,0,0
S01012845,576,151,33,118,179,29,69,37,37,36,38,21,17,0
S01012846,664,37,2,35,100,104,44,59,114,135,52,33,19,19
S01012847,437,44,5,39,113,53,67,58,48,43,7,4,3,4
S01012848,671,113,17,96,213,60,98,58,50,61,14,3,11,4
S01012849,584,62,16,46,140,65,30,69,94,92,22,9,13,10
S01012850,502,15,0,15,85,65,43,55,95,122,17,7,10,5
S01012851,610,72,14,58,141,87,70,63,83,78,8,5,3,8
S01012852,561,112,23,89,175,91,64,42,29,24,2,1,1,22
S01012853,551,71,24,47,180,42,94,54,50,46,6,0,6,8
S01012854,673,128,16,112,229,108,63,38,67,31,4,2,2,5
S01012855,593,93,19,74,191,71,61,50,74,36,15,9,6,2
S01012856,472,20,5,15,103,87,36,26,78,80,27,18,9,15
S01012857,545,23,7,16,99,83,35,73,115,78,36,25,11,3
S01012858,564,32,9,23,89,100,30,58,105,100,36,24,12,14
S01012859,900,46,6,40,172,123,75,85,153,163,35,20,15,48
S01012860,609,87,25,62,161,90,80,36,62,64,24,12,12,5
S01012861,548,75,18,57,145,75,94,30,67,44,12,5,7,6
S01012862,461,5,1,4,70,57,28,43,115,82,47,20,27,14
S01012863,543,22,2,20,98,78,9,55,86,104,78,31,47,13
S01012864,673,12,1,11,116,100,55,53,113,109,93,55,38,22
S01012865,537,59,6,53,115,89,61,43,76,56,30,22,8,8
S01012866,627,48,19,29,144,76,46,63,93,110,31,11,20,16
S01012867,504,5,3,2,60,62,22,63,112,143,31,23,8,6
S01012868,417,13,2,11,71,65,32,45,89,88,13,8,5,1
S01012869,481,9,0,9,30,41,18,70,115,120,65,26,39,13
S01012870,695,56,14,42,155,99,103,75,102,92,7,5,2,6
S01012871,637,45,12,33,177,96,87,55,83,64,26,14,12,4
S01012872,641,49,6,43,130,141,54,44,116,83,21,0,21,3
S01012873,711,55,14,41,159,178,51,59,81,95,22,16,6,11
S01012874,635,34,7,27,113,91,57,51,140,96,49,17,32,4
S01012875,478,22,0,22,95,66,47,58,53,77,37,12,25,23
S01012876,577,23,12,11,100,81,55,50,148,91,25,12,13,4
S01012877,528,8,2,6,75,118,43,80,87,98,19,2,17,0
S01012878,777,179,44,135,228,98,88,76,50,41,5,0,5,12
S01012879,571,118,8,110,152,85,60,44,51,43,13,2,11,5
S01012880,670,214,32,182,201,54,72,46,48,26,5,5,0,4
S01012881,555,121,23,98,177,59,72,29,49,33,13,5,8,2
S01012882,492,16,5,11,69,67,41,51,112,90,32,23,9,14
S01012883,482,20,1,19,71,50,31,35,96,120,56,21,35,3
S01012884,387,72,23,49,92,26,57,24,48,37,25,10,15,6
S01012885,356,2,1,1,35,56,25,27,86,73,45,25,20,7
S01012886,575,92,5,87,188,81,72,54,42,35,3,3,0,8
S01012887,528,133,34,99,149,81,42,42,36,33,11,6,5,1
S01012888,620,211,33,178,192,42,76,42,23,28,4,4,0,2
S01012889,814,110,29,81,245,82,105,90,98,68,12,12,0,4
S01012890,622,40,15,25,86,54,53,60,141,110,46,29,17,32
S01012891,413,20,4,16,58,46,58,33,85,93,11,4,7,9
S01012892,878,48,11,37,96,110,63,88,190,200,80,26,54,3
S01012893,577,10,1,9,56,70,36,75,163,97,60,29,31,10
S01012894,747,132,26,106,253,72,80,50,65,68,17,13,4,10
S01012895,473,91,18,73,136,41,89,24,44,40,7,2,5,1
S01012896,591,44,8,36,120,109,41,61,112,74,23,9,14,7
S01012897,534,92,17,75,158,69,46,53,66,41,2,2,0,7
S01012898,558,135,27,108,185,66,71,51,30,17,3,1,2,0
S01012899,410,21,5,16,75,61,32,39,70,82,25,6,19,5
S01012900,474,87,8,79,131,52,76,47,30,39,8,5,3,4
S01012901,558,48,14,34,130,121,34,55,65,85,14,2,12,6
S01012902,616,55,17,38,161,96,27,68,91,90,19,4,15,9
S01012903,656,33,3,30,159,102,54,71,103,100,20,5,15,14
S01012904,679,36,2,34,124,141,54,70,132,79,27,14,13,16
S01012905,554,17,2,15,108,103,35,43,122,87,25,8,17,14
S01012906,728,73,14,59,232,102,59,86,90,60,11,2,9,15
S01012907,620,28,7,21,141,112,59,76,79,90,15,7,8,20
S01012908,518,28,7,21,115,100,39,42,84,70,30,10,20,10
S01012909,439,25,6,19,116,82,22,52,64,61,17,9,8,0
S01012910,655,36,11,25,143,97,65,61,112,99,27,7,20,15
S01012911,537,55,12,43,136,68,47,83,83,45,6,4,2,14
S01012912,477,33,19,14,102,87,64,34,66,72,16,9,7,3
S01012913,673,72,12,60,144,95,52,88,99,92,23,7,16,8
S01012914,701,105,13,92,176,87,48,95,93,55,26,11,15,16
S01012915,905,141,44,97,267,108,85,119,68,76,30,5,25,11
S01012916,473,71,19,52,135,64,20,57,58,49,6,3,3,13
S01012917,570,113,12,101,198,57,68,43,54,24,3,3,0,10
S01012918,377,45,16,29,82,66,26,46,38,54,15,1,14,5
S01012919,301,20,9,11,70,58,24,45,58,15,8,0,8,3
S01012920,381,68,14,54,148,42,57,29,13,17,5,1,4,2
S01012921,529,42,14,28,123,87,20,53,92,80,23,3,20,9
S01012922,849,94,21,73,231,123,72,60,127,121,15,4,11,6
S01012923,569,74,17,57,138,81,58,33,92,73,5,4,1,15
S01012924,407,65,20,45,81,78,46,41,44,33,16,7,9,3
S01012925,384,58,19,39,162,35,33,23,26,32,5,0,5,10
S01012926,572,62,19,43,126,83,58,70,76,65,25,5,20,7
S01012927,613,63,6,57,165,69,67,67,76,78,14,9,5,14
S01012928,629,81,22,59,175,79,88,62,51,69,15,6,9,9
S01012929,528,72,18,54,124,90,51,59,66,59,4,0,4,3
S01012930,552,83,9,74,163,81,50,26,65,62,15,2,13,7
S01012931,702,80,20,60,184,126,55,59,84,79,26,15,11,9
S01012932,410,83,27,56,114,36,90,30,18,27,3,3,0,9
S01012933,635,64,21,43,139,105,56,69,100,67,31,18,13,4
S01012934,486,43,5,38,128,76,38,70,66,37,26,11,15,2
S01012935,717,100,28,72,181,145,49,51,89,74,27,4,23,1
S01012936,555,70,18,52,125,51,70,78,86,45,24,17,7,6
S01012937,575,119,25,94,142,79,23,53,74,48,28,13,15,9
S01012938,521,184,30,154,176,43,54,25,16,18,1,0,1,4
S01012939,584,143,20,123,190,81,52,41,53,6,4,0,4,14
S01012940,618,121,13,108,199,104,93,40,31,21,4,4,0,5
S01012941,735,216,55,161,255,81,81,45,21,25,8,1,7,3
S01012942,653,45,5,40,95,107,32,91,152,94,22,1,21,15
S01012943,665,123,36,87,221,104,62,58,54,34,7,1,6,2
S01012944,423,96,14,82,190,61,22,26,11,13,1,0,1,3
S01012945,679,167,64,103,251,63,90,55,30,16,3,0,3,4
S01012946,778,133,24,109,295,117,81,66,30,44,2,2,0,10
S01012947,421,123,16,107,148,33,71,20,6,14,3,0,3,3
S01012948,595,109,39,70,184,74,106,33,34,51,0,0,0,4
S01012949,567,98,18,80,191,75,75,36,48,34,6,6,0,4
S01012950,813,232,70,162,303,76,74,45,37,38,7,1,6,1
S01012951,896,268,60,208,352,74,115,39,33,15,0,0,0,0
S01012952,486,149,40,109,145,13,131,19,7,19,0,0,0,3
S01012953,592,93,24,69,167,139,57,20,48,58,10,9,1,0
S01012954,445,44,2,42,123,95,52,40,43,44,4,0,4,0
S01012955,793,208,53,155,274,107,68,61,30,29,8,2,6,8
S01012956,674,74,6,68,129,117,51,88,81,89,27,17,10,18
S01012957,481,42,12,30,92,73,59,52,67,68,20,5,15,8
S01012958,431,40,7,33,118,57,59,34,76,39,3,3,0,5
S01012959,534,76,24,52,133,109,49,36,68,48,8,6,2,7
S01012960,524,69,7,62,150,83,44,40,68,57,13,7,6,0
S01012961,463,81,23,58,141,51,82,25,43,38,2,0,2,0
S01012962,530,107,10,97,151,88,68,48,43,23,0,0,0,2
S01012963,755,190,41,149,242,78,90,67,51,35,2,2,0,0
S01012964,629,129,37,92,190,78,108,75,10,37,0,0,0,2
S01012965,612,135,16,119,150,68,56,51,65,53,15,2,13,19
S01012966,618,60,13,47,202,72,67,61,79,64,5,5,0,8
S01012967,448,24,2,22,90,63,35,53,79,92,2,2,0,10
S01012968,591,28,1,27,130,83,59,49,110,108,13,7,6,11
S01012969,547,35,3,32,123,71,34,52,86,120,17,5,12,9
S01012970,479,27,8,19,112,70,45,67,74,71,13,7,6,0
S01012971,770,50,13,37,118,84,65,87,151,146,56,23,33,13
S01012972,681,34,8,26,108,87,67,91,111,152,27,16,11,4
S01012973,625,61,20,41,150,72,54,79,118,76,13,2,11,2
S01012974,707,63,6,57,157,76,63,56,137,122,25,5,20,8
S01012975,479,24,14,10,58,69,32,62,111,102,21,12,9,0
S01012976,419,33,9,24,81,72,29,21,93,71,10,5,5,9
S01012977,636,21,3,18,104,56,42,77,163,136,28,5,23,9
S01012978,696,40,11,29,115,114,61,92,101,133,19,13,6,21
S01012979,578,46,8,38,136,67,66,71,91,85,9,5,4,7
S01012980,573,41,6,35,103,89,31,63,96,93,39,9,30,18
S01012981,645,44,17,27,138,86,42,73,104,120,15,2,13,23
S01012982,681,27,6,21,148,113,35,101,101,123,12,4,8,21
S01012983,581,87,16,71,170,90,50,44,55,69,6,0,6,10
S01012984,514,44,10,34,174,72,34,80,48,44,13,3,10,5
S01012985,630,40,10,30,171,78,55,107,70,96,12,10,2,1
S01012986,602,32,5,27,153,95,36,56,87,104,25,9,16,14
S01012987,547,38,4,34,124,77,62,52,69,106,15,9,6,4
S01012988,633,47,11,36,152,70,54,81,114,75,21,8,13,19
S01012989,716,55,9,46,194,114,53,86,97,95,10,3,7,12
S01012990,457,42,15,27,90,92,34,30,73,78,11,5,6,7
S01012991,637,50,5,45,128,123,55,63,78,113,18,1,17,9
S01012992,593,56,12,44,139,95,34,61,101,77,21,12,9,9
S01012993,523,23,1,22,121,92,46,63,79,65,24,12,12,10
S01012994,693,56,11,45,123,105,56,85,136,96,25,9,16,11
S01012995,685,84,21,63,173,126,52,86,67,87,3,0,3,7
S01012996,590,20,0,20,177,87,56,81,93,47,19,3,16,10
S01012997,365,38,5,33,99,53,10,43,70,32,19,7,12,1
S01012998,919,126,28,98,253,124,99,79,92,115,16,4,12,15
S01012999,376,35,12,23,70,49,29,57,47,76,9,1,8,4
S01013000,473,40,4,36,84,68,46,56,84,81,10,3,7,4
S01013001,289,94,33,61,67,11,62,23,20,6,1,0,1,5
S01013002,372,120,16,104,80,14,84,20,22,17,1,1,0,14
S01013003,468,221,32,189,149,22,34,16,13,12,0,0,0,1
S01013004,540,137,18,119,226,27,76,36,14,12,10,6,4,2
S01013005,543,144,25,119,187,29,89,34,35,15,3,0,3,7
S01013006,481,199,31,168,136,15,59,22,23,16,5,0,5,6
S01013007,640,192,44,148,220,32,67,58,45,19,5,1,4,2
S01013008,597,190,46,144,140,43,90,32,36,43,17,3,14,6
S01013009,437,61,3,58,147,55,76,31,45,18,1,0,1,3
S01013010,455,136,24,112,114,23,103,18,34,11,6,1,5,10
S01013011,616,145,27,118,191,45,110,40,52,27,5,0,5,1
S01013012,524,95,15,80,139,54,52,57,48,62,13,6,7,4
S01013013,583,134,39,95,181,53,90,25,53,38,6,3,3,3
S01013014,550,64,9,55,158,46,124,34,59,53,9,2,7,3
S01013015,599,130,30,100,172,46,130,51,24,33,7,2,5,6
S01013016,494,160,26,134,122,15,130,16,24,23,4,0,4,0
S01013017,651,167,44,123,163,54,79,57,68,46,16,3,13,1
S01013018,756,230,44,186,229,55,121,53,14,40,9,2,7,5
S01013019,768,240,53,187,259,81,107,24,33,11,2,0,2,11
S01013020,326,48,6,42,83,20,22,28,46,66,10,6,4,3
S01013021,376,35,1,34,98,40,43,38,61,55,2,2,0,4
S01013022,380,42,14,28,104,55,11,34,72,41,17,6,11,4
S01013023,662,187,46,141,291,36,53,28,32,29,6,3,3,0
S01013024,404,92,26,66,133,40,39,50,17,23,0,0,0,10
S01013025,416,70,23,47,117,22,124,30,20,28,5,2,3,0
S01013026,829,79,9,70,180,115,50,95,129,128,46,23,23,7
S01013027,845,42,17,25,82,49,69,79,168,263,79,28,51,14
S01013028,379,50,16,34,61,14,61,54,56,66,7,5,2,10
S01013029,426,23,8,15,71,32,18,53,89,118,15,8,7,7
S01013030,551,13,0,13,65,46,49,86,101,136,44,24,20,11
S01013031,546,4,0,4,44,56,49,84,112,169,18,3,15,10
S01013032,776,78,17,61,196,80,95,95,101,111,6,5,1,14
S01013033,619,29,4,25,123,70,63,91,79,133,18,7,11,13
S01013034,581,23,6,17,72,40,30,107,125,153,27,17,10,4
S01013035,554,6,2,4,71,27,35,99,104,179,30,18,12,3
S01013036,676,4,0,4,71,59,55,78,167,210,25,14,11,7
S01013037,615,75,28,47,196,80,62,79,57,46,14,7,7,6
S01013038,790,54,12,42,153,98,66,114,136,134,26,22,4,9
S01013039,492,111,25,86,159,62,34,53,37,25,2,2,0,9
S01013040,448,46,0,46,93,63,48,71,68,39,19,10,9,1
S01013041,502,51,16,35,138,79,53,58,46,57,14,9,5,6
S01013042,704,66,21,45,173,64,109,80,60,131,12,7,5,9
S01013043,591,19,9,10,94,60,50,57,110,143,55,26,29,3
S01013044,684,16,4,12,121,66,37,82,167,149,29,8,21,17
S01013045,614,62,7,55,127,78,68,78,93,79,13,6,7,16
S01013046,392,16,9,7,60,52,28,47,109,69,9,8,1,2
S01013047,861,145,39,106,286,98,72,87,86,80,3,3,0,4
S01013048,687,69,17,52,217,123,28,74,83,63,9,2,7,21
S01013049,666,107,10,97,222,93,48,69,84,29,9,3,6,5
S01013050,565,44,5,39,112,94,47,61,88,79,38,19,19,2
S01013051,731,47,6,41,114,103,71,77,116,149,46,21,25,8
S01013052,536,50,6,44,78,63,46,56,108,92,35,26,9,8
S01013053,475,29,6,23,55,60,46,53,91,101,34,22,12,6
S01013054,502,54,13,41,137,43,42,54,75,71,23,16,7,3
S01013055,532,30,8,22,105,38,67,62,95,103,22,9,13,10
S01013056,676,35,6,29,107,78,77,81,91,163,33,29,4,11
S01013057,767,35,8,27,88,76,55,88,154,169,88,41,47,14
S01013058,605,117,38,79,179,77,52,36,63,47,20,10,10,14
S01013059,498,142,31,111,135,49,42,19,29,45,23,9,14,14
S01013060,364,129,34,95,106,39,17,29,13,12,13,4,9,6
S01013061,514,143,26,117,198,41,32,28,30,18,1,1,0,23
S01013062,599,190,37,153,209,28,77,28,21,7,3,1,2,36
S01013063,614,280,43,237,170,38,49,11,9,10,8,2,6,39
S01013064,622,42,12,30,143,62,65,60,104,114,18,11,7,14
S01013065,665,43,16,27,135,82,53,75,88,109,41,26,15,39
S01013066,587,68,18,50,165,57,66,45,70,60,28,9,19,28
S01013067,783,60,4,56,129,29,25,59,58,50,30,15,15,343
S01013068,715,53,6,47,90,59,52,55,105,92,65,32,33,144
S01013069,692,57,19,38,83,45,28,46,65,55,35,17,18,278
S01013070,516,25,5,20,55,46,37,42,68,51,36,25,11,156
S01013071,730,32,8,24,99,41,23,47,57,75,22,15,7,334
S01013072,421,10,5,5,46,23,24,58,99,118,35,15,20,8
S01013073,687,21,5,16,142,55,18,50,144,125,63,35,28,69
S01013074,626,16,0,16,37,23,67,82,140,152,85,47,38,24
S01013075,630,31,6,25,83,33,44,39,126,162,68,36,32,44
S01013076,437,79,17,62,119,41,66,30,19,23,8,6,2,52
S01013077,582,31,10,21,77,64,24,61,108,119,74,34,40,24
S01013078,507,12,1,11,74,48,25,70,105,112,49,26,23,12
S01013079,961,240,19,221,300,89,71,52,94,52,20,1,19,43
S01013080,685,181,53,128,192,42,68,52,23,24,5,4,1,98
S01013081,492,150,16,134,125,48,49,34,42,25,5,5,0,14
S01013082,628,81,14,67,197,96,65,52,68,51,6,4,2,12
S01013083,369,102,21,81,138,39,38,21,7,15,0,0,0,9
S01013084,541,150,37,113,183,74,53,29,21,20,3,3,0,8
S01013085,368,75,29,46,79,38,40,23,37,50,21,19,2,5
S01013086,689,187,17,170,151,49,51,51,57,31,21,6,15,91
S01013087,618,253,71,182,173,32,74,12,8,7,17,3,14,42
S01013088,676,234,33,201,259,32,89,19,14,10,3,0,3,16
S01013089,554,83,15,68,148,56,46,41,52,72,15,6,9,41
S01013090,712,139,19,120,162,49,61,50,54,24,14,10,4,159
S01013091,437,57,7,50,108,42,16,22,21,37,11,10,1,123
S01013092,762,138,18,120,213,75,54,56,61,72,28,16,12,65
S01013093,327,102,33,69,84,20,67,26,12,10,0,0,0,6
S01013094,464,137,22,115,216,38,28,21,17,7,0,0,0,0
S01013095,797,393,126,267,249,40,64,20,19,7,0,0,0,5
S01013096,388,52,20,32,121,30,34,34,66,43,6,1,5,2
S01013097,536,171,32,139,196,16,66,33,16,26,5,2,3,7
S01013098,690,325,95,230,253,15,58,11,16,12,0,0,0,0
S01013099,636,157,21,136,235,30,68,48,47,29,9,4,5,13
S01013100,432,155,38,117,208,17,21,11,7,3,1,1,0,9
S01013101,748,96,22,74,161,82,64,92,114,88,36,15,21,15
S01013102,415,119,31,88,179,35,11,21,32,10,3,1,2,5
S01013103,761,204,57,147,336,63,65,55,25,9,4,0,4,0
S01013104,764,226,55,171,286,67,87,40,33,20,5,1,4,0
S01013105,686,224,52,172,272,44,69,16,22,31,2,2,0,6
S01013106,620,83,13,70,161,63,116,58,47,74,10,2,8,8
S01013107,501,135,29,106,164,46,84,20,17,29,0,0,0,6
S01013108,460,70,16,54,119,24,55,41,75,68,2,0,2,6
S01013109,842,198,43,155,185,58,214,55,79,37,8,0,8,8
S01013110,465,82,9,73,144,17,125,25,31,31,9,5,4,1
S01013111,333,52,2,50,131,23,72,17,23,10,0,0,0,5
S01013112,554,87,18,69,134,55,64,57,69,67,14,5,9,7
S01013113,595,40,19,21,117,45,93,70,109,103,12,5,7,6
S01013114,603,110,23,87,154,46,143,28,66,44,7,5,2,5
S01013115,400,45,7,38,85,37,85,41,57,38,9,2,7,3
S01013116,468,102,27,75,192,31,71,16,38,12,3,3,0,3
S01013117,535,44,5,39,147,51,72,92,72,42,2,2,0,13
S01013118,346,74,12,62,121,21,62,22,18,28,0,0,0,0
S01013119,569,95,29,66,159,26,139,31,53,56,8,3,5,2
S01013120,684,78,21,57,141,32,163,86,95,67,12,4,8,10
S01013121,288,17,5,12,41,15,80,41,46,31,17,9,8,0
S01013122,516,7,3,4,63,68,17,35,130,110,74,40,34,12
S01013123,650,29,10,19,131,108,21,67,123,88,64,27,37,19
S01013124,575,28,17,11,129,99,27,60,132,84,14,5,9,2
S01013125,567,50,24,26,129,83,69,37,82,77,35,25,10,5
S01013126,670,21,3,18,78,94,33,56,184,108,73,35,38,23
S01013127,716,9,3,6,88,91,30,53,176,157,95,53,42,17
S01013128,544,23,10,13,111,96,8,51,103,92,45,17,28,15
S01013129,911,50,22,28,230,154,43,114,136,107,65,40,25,12
S01013130,649,29,6,23,121,81,42,50,140,92,89,42,47,5
S01013131,591,44,12,32,93,75,30,62,123,121,25,4,21,18
S01013132,493,16,0,16,86,65,33,53,122,71,35,13,22,12
S01013133,648,40,7,33,135,83,30,56,137,89,64,27,37,14
S01013134,676,86,30,56,165,79,79,60,92,75,32,19,13,8
S01013135,672,21,2,19,91,90,51,58,151,142,52,31,21,16
S01013136,666,18,7,11,151,93,44,67,111,134,33,20,13,15
S01013137,553,6,1,5,94,77,61,60,116,130,9,0,9,0
S01013138,635,13,3,10,93,75,30,64,167,106,65,30,35,22
S01013139,691,19,12,7,94,112,40,67,158,138,51,30,21,12
S01013140,642,32,7,25,107,85,43,85,110,117,48,42,6,15
S01013141,469,13,9,4,70,79,30,35,96,95,44,33,11,7
S01013142,578,16,8,8,83,95,26,60,125,105,47,27,20,21
S01013143,646,38,6,32,149,100,38,52,118,113,26,12,14,12
S01013144,633,31,10,21,126,85,52,55,154,96,21,11,10,13
S01013145,526,47,10,37,114,71,48,80,82,60,20,15,5,4
S01013146,345,19,2,17,54,52,49,33,71,61,6,6,0,0
S01013147,561,53,10,43,102,93,77,59,98,57,11,9,2,11
S01013148,574,40,11,29,155,112,54,48,75,61,25,12,13,4
S01013149,677,63,17,46,174,114,29,63,86,102,28,21,7,18
S01013150,611,34,3,31,103,120,34,67,115,93,18,12,6,27
S01013151,459,56,11,45,132,70,55,52,31,45,13,7,6,5
S01013152,713,87,19,68,152,99,68,66,102,108,31,19,12,0
S01013153,762,32,13,19,106,105,47,70,195,132,60,44,16,15
S01013154,818,27,8,19,139,130,43,94,155,153,54,20,34,23
S01013155,865,28,7,21,85,97,54,55,271,153,99,45,54,23
S01013156,779,17,4,13,103,88,26,109,183,156,91,41,50,6
S01013157,884,30,4,26,88,108,31,128,203,147,121,55,66,28
S01013158,465,51,14,37,154,64,60,51,45,29,11,3,8,0
S01013159,555,53,25,28,151,79,84,44,73,64,0,0,0,7
S01013160,607,89,25,64,186,87,99,46,49,38,10,3,7,3
S01013161,844,47,0,47,183,150,82,93,121,124,38,24,14,6
S01013162,575,37,11,26,106,70,44,71,110,92,38,19,19,7
S01013163,605,52,14,38,144,98,59,113,63,66,7,2,5,3
S01013164,850,105,21,84,204,119,86,82,75,132,32,16,16,15
S01013165,654,83,14,69,157,109,71,76,66,73,15,8,7,4
S01013166,564,13,8,5,59,86,34,58,123,111,63,29,34,17
S01013167,601,13,4,9,59,75,36,49,128,122,103,34,69,16
S01013168,685,10,0,10,85,103,49,126,128,106,64,26,38,14
S01013169,603,15,1,14,120,91,45,93,119,85,33,25,8,2
S01013170,424,6,0,6,65,65,20,51,66,75,72,42,30,4
S01013171,599,95,20,75,167,98,53,39,47,71,29,13,16,0
S01013172,612,54,17,37,125,119,40,58,119,69,23,8,15,5
S01013173,699,71,27,44,172,107,59,53,121,89,22,10,12,5
S01013174,726,137,37,100,245,77,52,98,66,45,0,0,0,6
S01013175,766,127,15,112,243,114,51,86,68,56,12,6,6,9
S01013176,551,78,18,60,150,124,42,46,43,52,12,6,6,4
S01013177,501,53,16,37,159,82,25,48,47,72,5,4,1,10
S01013178,568,73,16,57,135,100,55,67,57,64,5,3,2,12
S01013179,626,47,14,33,160,87,67,65,117,60,15,11,4,8
S01013180,391,37,4,33,151,51,33,52,30,33,2,0,2,2
S01013181,564,40,13,27,153,83,35,116,54,76,4,2,2,3
S01013182,543,40,10,30,102,86,38,35,119,96,27,11,16,0
S01013183,702,97,15,82,239,110,40,82,81,45,6,0,6,2
S01013184,515,9,0,9,49,62,13,48,161,84,75,43,32,14
S01013185,666,25,9,16,152,93,35,76,131,112,38,8,30,4
S01013186,592,7,7,0,76,73,28,86,171,92,57,12,45,2
S01013187,698,34,4,30,134,94,43,77,158,88,61,24,37,9
S01013188,729,72,17,55,179,108,38,80,127,104,17,7,10,4
S01013189,474,58,7,51,144,48,60,52,53,50,9,0,9,0
S01013190,653,61,8,53,188,83,41,59,102,94,20,11,9,5
S01013191,940,171,35,136,324,112,69,103,88,67,6,3,3,0
S01013192,710,87,9,78,201,125,54,70,107,49,9,4,5,8
S01013193,530,46,16,30,126,95,39,62,72,75,7,4,3,8
S01013194,488,55,12,43,112,68,32,57,93,49,13,4,9,9
S01013195,773,65,3,62,211,131,47,70,126,86,14,5,9,23
S01013196,513,45,19,26,165,76,42,59,54,53,5,2,3,14
S01013197,393,62,23,39,123,50,17,45,53,25,10,3,7,8
S01013198,592,53,17,36,122,66,80,59,94,79,39,24,15,0
S01013199,642,101,13,88,182,76,85,38,87,56,13,4,9,4
S01013200,572,38,9,29,159,60,30,44,113,71,54,45,9,3
S01013201,620,37,6,31,61,65,34,41,169,121,84,45,39,8
S01013202,467,19,6,13,71,48,22,38,97,95,67,26,41,10
S01013203,609,34,5,29,105,55,26,90,128,115,51,28,23,5
S01013204,701,67,11,56,215,110,10,100,101,75,16,8,8,7
S01013205,539,13,4,9,44,41,37,61,125,120,94,69,25,4
S01013206,516,17,4,13,80,54,27,41,122,121,49,14,35,5
S01013207,621,28,8,20,119,102,73,54,124,86,26,18,8,9
S01013208,812,44,12,32,158,54,53,98,167,142,80,57,23,16
S01013209,627,23,0,23,158,77,77,76,91,88,33,19,14,4
S01013210,468,68,20,48,96,80,67,55,43,39,16,10,6,4
S01013211,722,65,20,45,120,125,45,97,134,109,23,11,12,4
S01013212,563,81,21,60,144,99,62,78,63,35,0,0,0,1
S01013213,512,75,18,57,135,81,73,67,54,24,3,0,3,0
S01013214,407,24,3,21,133,62,52,59,40,37,0,0,0,0
S01013215,668,29,9,20,142,102,52,101,114,102,18,2,16,8
S01013216,528,18,7,11,70,77,23,66,117,103,35,17,18,19
S01013217,582,39,4,35,91,91,41,57,133,94,31,12,19,5
S01013218,539,7,5,2,69,45,20,50,138,131,66,41,25,13
S01013219,470,15,0,15,78,41,26,53,125,95,22,9,13,15
S01013220,561,14,2,12,72,55,29,46,164,115,57,24,33,9
S01013221,752,50,14,36,94,84,81,101,174,117,38,22,16,13
S01013222,487,24,7,17,55,56,36,47,121,100,35,25,10,13
S01013223,839,56,10,46,178,118,70,93,129,102,80,46,34,13
S01013224,705,47,18,29,131,97,52,76,157,95,43,20,23,7
S01013225,694,32,6,26,130,66,29,108,143,138,35,23,12,13
S01013226,469,37,14,23,148,51,32,66,90,38,5,4,1,2
S01013227,564,17,3,14,104,54,22,117,112,84,37,23,14,17
S01013228,600,43,18,25,107,72,52,51,137,85,47,13,34,6
S01013229,641,32,3,29,105,112,31,92,115,108,41,17,24,5
S01013230,457,17,4,13,93,73,13,84,79,91,7,6,1,0
S01013231,589,26,6,20,139,79,34,73,122,92,19,11,8,5
S01013232,507,39,22,17,101,93,45,46,87,81,15,11,4,0
S01013233,435,34,10,24,101,76,44,52,83,34,5,0,5,6
S01013234,346,34,9,25,168,49,53,29,9,2,2,0,2,0
S01013235,563,52,6,46,128,70,51,84,112,58,7,6,1,1
S01013236,615,76,16,60,158,56,105,95,55,51,9,8,1,10
S01013237,720,73,30,43,189,120,61,62,110,55,22,16,6,28
S01013238,623,17,1,16,89,62,39,72,155,109,65,39,26,15
S01013239,736,20,0,20,137,46,26,103,159,157,79,49,30,9
S01013240,457,15,13,2,68,35,20,53,96,92,62,32,30,16
S01013241,631,92,29,63,237,109,48,69,35,34,7,6,1,0
S01013242,448,62,8,54,94,36,160,38,31,19,3,3,0,5
S01013243,611,45,10,35,86,66,39,62,141,140,30,19,11,2
S01013244,557,21,0,21,89,75,49,50,108,112,51,21,30,2
S01013245,843,106,30,76,172,85,118,116,106,122,15,4,11,3
S01013246,401,38,9,29,74,37,57,34,60,87,9,7,2,5
S01013247,645,22,3,19,83,72,59,57,165,146,35,22,13,6
S01013248,511,17,4,13,55,76,35,28,133,130,33,3,30,4
S01013249,382,12,0,12,74,47,31,42,64,84,24,10,14,4
S01013250,733,107,15,92,179,60,151,46,63,92,24,14,10,11
S01013251,698,27,12,15,105,86,25,65,126,184,64,25,39,16
S01013252,568,37,16,21,117,48,57,68,71,129,23,9,14,18
S01013253,564,56,12,44,107,64,48,73,91,97,25,7,18,3
S01013254,523,23,6,17,67,51,42,67,78,159,27,19,8,9
S01013255,680,44,20,24,134,60,73,111,122,113,16,7,9,7
S01013256,578,95,25,70,141,58,77,55,89,52,9,3,6,2
S01013257,589,45,15,30,142,57,73,56,87,102,12,1,11,15
S01013258,624,109,36,73,190,81,56,59,58,55,8,2,6,8
S01013259,672,47,9,38,144,102,51,64,96,148,14,4,10,6
S01013260,764,39,15,24,82,104,37,77,164,182,66,39,27,13
S01013261,699,28,4,24,68,79,53,95,131,186,43,17,26,16
S01013262,528,41,11,30,70,62,62,65,96,114,14,3,11,4
S01013263,494,162,30,132,171,40,47,30,21,10,9,0,9,4
S01013264,502,137,26,111,195,68,32,38,11,18,3,3,0,0
S01013265,650,199,29,170,223,82,77,14,16,35,0,0,0,4
S01013266,530,165,33,132,131,79,38,43,48,24,0,0,0,2
S01013267,469,48,17,31,107,77,32,25,101,41,27,18,9,11
S01013268,729,55,11,44,189,95,62,81,112,112,17,1,16,6
S01013269,871,180,39,141,330,121,66,60,46,58,2,0,2,8
S01013270,773,285,72,213,266,83,79,37,8,15,0,0,0,0
S01013271,473,185,46,139,163,59,15,29,6,13,0,0,0,3
S01013272,741,207,51,156,314,79,60,23,22,27,9,0,9,0
S01013273,904,285,44,241,280,105,102,63,29,40,0,0,0,0
S01013274,685,121,47,74,209,98,59,40,66,70,15,5,10,7
S01013275,627,104,29,75,176,86,107,30,56,50,16,16,0,2
S01013276,560,68,16,52,179,91,41,74,46,51,2,0,2,8
S01013277,764,45,16,29,146,93,47,107,143,147,25,14,11,11
S01013278,679,30,18,12,105,81,56,60,157,124,42,13,29,24
S01013279,661,40,9,31,105,84,35,77,135,130,40,31,9,15
S01013280,478,39,4,35,131,92,39,25,58,79,13,1,12,2
S01013281,777,36,5,31,129,93,75,86,159,160,19,15,4,20
S01013282,776,30,3,27,106,101,33,96,176,170,52,22,30,12
S01013283,606,76,3,73,104,93,37,57,126,88,14,8,6,11
S01013284,580,56,6,50,164,116,46,50,59,78,4,1,3,7
S01013285,585,77,8,69,173,119,24,69,69,50,2,0,2,2
S01013286,595,66,12,54,188,119,52,74,57,31,4,3,1,4
S01013287,730,171,25,146,283,106,56,55,37,14,2,0,2,6
S01013288,520,114,22,92,131,78,35,45,62,39,9,7,2,7
S01013289,631,136,27,109,196,73,107,29,48,39,1,1,0,2
S01013290,817,126,30,96,231,113,70,65,102,95,13,0,13,2
S01013291,683,94,22,72,165,100,73,70,71,98,12,0,12,0
S01013292,633,75,14,61,161,104,52,69,68,102,2,0,2,0
S01013293,630,125,13,112,160,114,76,41,57,49,0,0,0,8
S01013294,650,79,8,71,144,127,59,79,75,74,3,1,2,10
S01013295,663,76,12,64,142,130,68,89,83,64,9,8,1,2
S01013296,564,29,8,21,70,58,49,68,100,141,35,15,20,14
S01013297,544,61,18,43,93,81,58,60,80,98,7,5,2,6
S01013298,483,54,13,41,132,62,64,46,54,62,8,4,4,1
S01013299,848,68,23,45,211,130,53,99,122,124,32,14,18,9
S01013300,427,45,10,35,87,42,45,38,79,77,12,6,6,2
S01013301,376,27,14,13,55,49,29,71,55,73,14,7,7,3
S01013302,521,59,5,54,127,71,89,72,50,47,6,1,5,0
S01013303,647,80,24,56,170,62,47,71,85,119,3,2,1,10
S01013304,820,24,2,22,101,95,28,93,205,198,59,14,45,17
S01013305,790,37,19,18,117,120,39,71,160,226,15,6,9,5
S01013306,832,15,9,6,74,97,32,75,216,206,101,54,47,16
S01013307,960,28,10,18,88,69,43,130,216,276,94,38,56,16
S01013308,876,24,3,21,57,129,50,109,211,219,44,16,28,33
S01013309,566,129,22,107,174,86,26,32,54,54,10,8,2,1
S01013310,563,39,8,31,107,80,16,79,103,115,16,9,7,8
S01013311,705,34,6,28,124,115,64,73,148,117,17,8,9,13
S01013312,881,37,2,35,142,135,54,92,141,222,47,11,36,11
S01013313,583,29,11,18,106,62,35,61,123,131,30,22,8,6
S01013314,530,25,12,13,110,81,31,63,119,80,12,9,3,9
S01013315,551,153,37,116,197,46,66,31,18,36,0,0,0,4
S01013316,511,88,12,76,157,68,48,40,60,39,9,9,0,2
S01013317,421,41,8,33,110,80,33,37,54,60,6,1,5,0
S01013318,560,107,32,75,171,62,25,50,80,58,4,2,2,3
S01013319,525,106,25,81,155,82,38,62,52,17,13,7,6,0
S01013320,1018,201,29,172,332,124,86,101,81,71,12,6,6,10
S01013321,337,14,4,10,90,55,22,35,25,65,22,11,11,9
S01013322,659,68,20,48,143,110,45,76,93,109,6,0,6,9
S01013323,819,73,18,55,162,104,45,77,146,160,35,15,20,17
S01013324,578,24,10,14,104,58,26,62,141,108,46,18,28,9
S01013325,799,62,20,42,144,83,32,69,154,143,80,52,28,32
S01013326,467,29,5,24,45,45,30,35,126,118,23,13,10,16
S01013327,624,18,4,14,68,72,53,87,125,160,34,23,11,7
S01013328,590,27,7,20,73,78,44,79,142,126,14,8,6,7
S01013329,449,21,3,18,86,63,27,39,126,77,7,6,1,3
S01013330,1003,173,31,142,291,172,72,88,91,80,24,12,12,12
S01013331,629,98,15,83,171,87,66,62,68,65,7,3,4,5
S01013332,562,39,7,32,90,99,62,53,76,122,9,4,5,12
S01013333,738,92,12,80,206,104,71,95,54,103,8,4,4,5
S01013334,724,34,5,29,106,102,37,82,138,181,39,12,27,5
S01013335,774,17,6,11,82,85,68,81,182,177,63,27,36,19
S01013336,794,28,10,18,115,56,74,80,164,182,86,42,44,9
S01013337,786,83,29,54,186,75,92,107,92,132,13,5,8,6
S01013338,572,140,27,113,215,55,70,36,21,31,4,0,4,0
S01013339,521,117,22,95,160,59,32,62,50,29,5,0,5,7
S01013340,666,144,29,115,207,96,64,81,49,20,1,0,1,4
S01013341,806,169,44,125,312,74,90,40,60,50,9,0,9,2
S01013342,516,6,2,4,76,66,24,46,119,125,46,22,24,8
S01013343,598,35,7,28,104,107,45,57,97,141,6,2,4,6
S01013344,620,19,5,14,97,41,38,105,134,152,25,14,11,9
S01013345,680,26,2,24,101,66,37,102,104,193,34,9,25,17
S01013346,843,196,68,128,267,113,56,81,57,61,6,6,0,6
S01013347,628,78,11,67,187,113,50,54,60,63,11,3,8,12
S01013348,453,89,21,68,127,71,58,34,32,32,0,0,0,10
S01013349,769,132,23,109,172,100,28,67,91,125,29,23,6,25
S01013350,555,35,11,24,120,82,34,57,92,107,11,1,10,17
S01013351,691,60,12,48,115,115,54,111,109,97,22,13,9,8
S01013352,766,40,12,28,133,137,48,105,119,164,18,2,16,2
S01013353,600,20,1,19,95,85,61,100,89,121,26,12,14,3
S01013354,582,62,34,28,152,78,67,66,67,79,5,3,2,6
S01013355,534,66,10,56,112,45,54,55,91,102,9,3,6,0
S01013356,646,27,4,23,91,65,74,71,107,134,65,24,41,12
S01013357,706,72,30,42,164,85,62,85,77,130,25,10,15,6
S01013358,621,54,15,39,123,63,68,92,91,94,19,7,12,17
S01013359,503,13,5,8,65,45,33,54,94,151,35,28,7,13
S01013360,537,17,5,12,97,62,53,65,125,90,26,9,17,2
S01013361,445,15,11,4,61,76,11,52,105,107,15,7,8,3
S01013362,393,19,9,10,70,18,26,45,87,95,24,11,13,9
S01013363,612,30,10,20,59,83,31,56,146,135,51,24,27,21
S01013364,766,98,20,78,150,72,51,111,90,176,12,11,1,6
S01013365,653,58,11,47,141,124,82,77,49,112,7,2,5,3
S01013366,803,99,22,77,200,122,78,120,68,91,15,8,7,10
S01013367,533,95,35,60,145,58,74,51,48,60,2,2,0,0
S01013368,598,70,21,49,75,55,94,62,101,126,12,3,9,3
S01013369,719,27,3,24,97,111,24,87,153,183,37,22,15,0
S01013370,489,21,4,17,83,62,21,37,94,133,30,16,14,8
S01013371,424,35,16,19,79,53,22,60,87,71,16,5,11,1
S01013372,951,12,5,7,98,115,54,91,237,239,83,21,62,22
S01013373,710,35,14,21,104,80,41,79,150,146,56,24,32,19
S01013374,778,20,5,15,76,82,56,96,139,218,83,25,58,8
S01013375,449,21,4,17,35,61,28,57,105,116,23,12,11,3
S01013376,450,27,5,22,44,52,53,47,66,129,31,19,12,1
S01013377,567,21,6,15,103,57,23,72,112,151,27,17,10,1
S01013378,834,70,20,50,181,133,52,73,119,129,57,26,31,20
S01013379,679,39,5,34,130,75,51,77,137,141,27,19,8,2
S01013380,80,11,8,3,41,6,11,5,6,0,0,0,0,0
S01013381,381,19,2,17,69,36,35,63,46,92,18,9,9,3
S01013382,479,44,23,21,65,45,42,81,74,105,15,6,9,8
S01013383,489,27,3,24,92,52,30,76,87,84,30,14,16,11
S01013384,568,39,9,30,70,78,58,93,51,151,22,11,11,6
S01013385,387,26,8,18,105,63,25,37,48,72,4,2,2,7
S01013386,724,106,7,99,216,103,67,65,45,104,13,2,11,5
S01013387,487,36,12,24,53,61,41,65,72,126,29,4,25,4
S01013388,516,44,10,34,95,62,53,34,55,139,27,16,11,7
S01013389,650,29,7,22,120,59,43,110,103,138,25,7,18,23
S01013390,380,17,0,17,45,59,39,47,77,89,7,3,4,0
S01013391,351,33,17,16,80,25,61,31,64,43,6,1,5,8
S01013392,738,125,31,94,174,132,81,99,47,64,6,6,0,10
S01013393,575,63,16,47,75,47,55,80,91,121,38,10,28,5
S01013394,565,15,7,8,81,67,28,68,129,121,51,33,18,5
S01013395,668,22,2,20,64,39,22,66,165,180,104,61,43,6
S01013396,680,90,16,74,191,108,102,67,38,72,5,0,5,7
S01013397,716,67,13,54,111,85,90,75,93,147,44,25,19,4
S01013398,590,122,33,89,123,108,57,78,41,57,0,0,0,4
S01013399,939,98,29,69,291,121,75,110,131,91,10,5,5,12
S01013400,535,30,11,19,94,66,38,79,112,88,26,13,13,2
S01013401,787,125,29,96,285,94,67,55,68,60,25,14,11,8
S01013402,1045,243,41,202,349,131,52,81,73,97,10,4,6,9
S01013403,867,188,39,149,281,125,70,45,88,64,0,0,0,6
S01013404,574,109,17,92,175,55,32,54,62,70,15,11,4,2
S01013405,479,34,7,27,86,65,39,58,65,109,16,1,15,7
S01013406,492,14,8,6,70,47,15,52,107,148,37,13,24,2
S01013407,422,19,10,9,57,46,15,40,112,105,18,8,10,10
S01013408,509,18,0,18,75,77,30,64,79,126,35,15,20,5
S01013409,931,128,50,78,184,113,80,64,131,182,35,7,28,14
S01013410,638,17,13,4,56,80,37,70,151,157,59,17,42,11
S01013411,609,64,6,58,180,66,42,50,74,104,27,18,9,2
S01013412,694,61,22,39,173,100,49,71,66,130,28,11,17,16
S01013413,602,151,58,93,221,32,37,60,45,49,6,5,1,1
S01013414,598,52,11,41,179,57,39,50,84,96,31,10,21,10
S01013415,483,11,3,8,75,90,38,59,88,91,31,17,14,0
S01013416,471,16,1,15,75,51,22,22,115,126,35,19,16,9
S01013417,657,68,15,53,156,88,37,60,104,114,21,8,13,9
S01013418,552,55,17,38,126,78,50,52,75,97,19,7,12,0
S01013419,382,65,1,64,141,57,31,33,14,30,4,0,4,7
S01013420,464,38,10,28,128,80,21,35,67,75,18,5,13,2
S01013421,769,149,30,119,238,96,68,89,58,64,3,2,1,4
S01013422,604,22,0,22,136,82,46,79,112,93,15,7,8,19
S01013423,682,87,14,73,172,81,67,50,81,120,24,6,18,0
S01013424,421,80,22,58,132,46,55,29,43,34,0,0,0,2
S01013425,349,54,10,44,108,49,16,35,33,40,8,1,7,6
S01013426,659,40,23,17,78,92,69,56,103,185,34,20,14,2
S01013427,418,84,32,52,190,36,55,12,14,18,1,0,1,8
S01013428,834,39,9,30,150,97,78,93,116,200,50,22,28,11
S01013429,590,42,2,40,136,72,48,96,93,86,14,12,2,3
S01013430,588,54,12,42,108,79,55,88,81,102,21,10,11,0
S01013431,542,56,20,36,77,53,49,60,105,114,25,7,18,3
S01013432,606,76,19,57,118,75,77,55,68,102,21,0,21,14
S01013433,605,133,42,91,189,57,77,60,31,44,8,1,7,6
S01013434,471,104,15,89,167,21,114,23,17,22,2,2,0,1
S01013435,631,253,66,187,237,47,35,22,15,21,1,1,0,0
S01013436,752,152,28,124,164,87,65,73,92,99,12,7,5,8
S01013437,541,88,8,80,136,72,27,59,75,67,6,5,1,11
S01013438,473,45,16,29,107,70,60,53,54,61,16,8,8,7
S01013439,687,222,28,194,283,49,42,38,21,29,3,0,3,0
S01013440,809,322,31,291,270,70,60,34,27,20,0,0,0,6
S01013441,596,220,40,180,192,61,53,34,17,13,3,3,0,3
S01013442,683,151,18,133,210,76,51,63,61,63,8,4,4,0
S01013443,516,119,20,99,203,32,38,26,47,40,7,0,7,4
S01013444,733,157,22,135,176,69,71,69,88,62,29,10,19,12
S01013445,496,233,53,180,144,45,27,25,13,6,1,1,0,2
S01013446,561,81,19,62,140,80,34,47,89,81,3,0,3,6
S01013447,631,225,56,169,255,55,46,19,16,7,5,0,5,3
S01013448,578,181,51,130,204,53,53,43,20,10,8,7,1,6
S01013449,536,144,32,112,185,96,46,26,18,17,1,0,1,3
S01013450,520,127,17,110,162,95,23,45,29,34,5,2,3,0
S01013451,832,278,58,220,326,68,63,28,45,15,9,0,9,0
S01013452,688,190,47,143,266,41,49,65,27,34,4,4,0,12
S01013453,642,45,11,34,93,57,27,74,141,167,25,2,23,13
S01013454,627,147,26,121,194,52,67,57,44,56,6,3,3,4
S01013455,433,94,28,66,111,50,49,28,35,47,14,1,13,5
S01013456,607,68,14,54,143,61,67,78,68,101,13,8,5,8
S01013457,740,9,0,9,90,83,59,86,138,222,38,11,27,15
S01013458,606,64,15,49,138,65,65,44,91,109,22,6,16,8
S01013459,637,48,12,36,109,81,66,49,129,126,15,5,10,14
S01013460,682,30,11,19,173,101,56,53,112,134,20,12,8,3
S01013461,991,123,22,101,207,128,73,94,124,197,42,17,25,3
S01013462,755,134,34,100,172,85,68,80,89,119,6,1,5,2
S01013463,566,49,7,42,89,109,39,56,118,70,27,10,17,9
S01013464,518,58,23,35,155,70,36,69,70,52,2,0,2,6
S01013465,476,37,9,28,95,95,45,53,69,61,15,8,7,6
S01013466,242,34,5,29,61,12,45,12,34,35,9,0,9,0
S01013467,807,167,30,137,233,96,66,97,77,60,6,5,1,5
S01013468,453,41,8,33,139,61,56,23,69,53,10,6,4,1
S01013469,542,78,24,54,116,80,51,84,62,61,5,5,0,5
S01013470,644,21,7,14,83,59,32,91,157,175,23,9,14,3
S01013471,789,37,18,19,123,116,52,122,151,152,28,12,16,8
S01013472,594,144,41,103,176,73,76,48,23,46,3,1,2,5
S01013473,659,175,38,137,193,87,88,44,34,33,0,0,0,5
S01013474,588,97,19,78,196,73,65,39,42,68,2,0,2,6
S01013475,518,47,2,45,158,72,60,48,79,37,17,12,5,0
S01013476,475,54,22,32,75,76,54,62,70,64,12,6,6,8
S01013477,484,23,6,17,69,67,51,65,61,124,16,1,15,8
S01013478,795,76,9,67,229,86,83,73,101,115,28,11,17,4
S01013479,591,32,2,30,103,65,34,75,102,144,29,9,20,7
S01013480,490,20,2,18,65,52,43,70,107,114,14,7,7,5
S01013481,319,38,13,25,82,33,49,34,39,40,4,2,2,0
